schedule_id,nationality,number,name,position,attackpoints,blockpoints,servepoints,efficency,totalabs,attack_pt,attack_err,attack_att,attack_tot,attack_eff,block_pt,block_err,block_touches,block_tot,block_eff,serve_pt,serve_err,serve_attempts,serve_tot,serve_eff,reception_successful,reception_err,reception_attempts,reception_tot,reception_eff,dig_digs,dig_err,dig_tot,dig_eff,set_pt,set_err,set_attempts,set_tot,set_eff
11830,NED,1,Knip Kirsten ,L,0,0,0, ,0,0,0,0,0, ,0,0,0,0, ,0,0,0,0, ,0,0,0,0, ,0,0,0, ,0,0,0,0, 
11830,NED,2,Savelkoel Fleur ,OH,0,0,0, ,0,0,0,0,0, ,0,0,0,0, ,0,0,0,0, ,0,0,0,0, ,0,0,0, ,0,0,0,0, 
11830,NED,8,Korevaar Demi ,MB,0,0,0,0.00,0,0,0,0,0, ,0,0,0,0, ,0,0,5,5,0.00,0,0,0,0, ,0,0,0, ,0,0,0,0, 
11830,NED,9,Schoot Myrthe ,L,0,0,0, ,0,0,0,0,0, ,0,0,0,0, ,0,0,0,0, ,4,0,6,10,40.00,15,2,18,72.22,0,0,2,2,0.00
11830,NED,10,van Aalen Sarah ,S,0,0,0, ,0,0,0,0,0, ,0,0,0,0, ,0,0,0,0, ,0,0,0,0, ,0,0,0, ,0,0,0,0, 
11830,NED,11,Buijs Anne ,OH,12,0,0,8.89,12,12,4,11,27,29.63,0,3,4,7,-42.86,0,1,10,11,-9.09,13,2,12,27,40.74,10,0,10,100.00,0,0,1,1,0.00
11830,NED,12,Bongaerts Britt ,S,2,1,0,5.26,3,2,0,3,5,40.00,1,1,3,5,0.00,0,1,8,9,-11.11,0,0,0,0, ,2,1,3,33.33,36,0,62,98,36.73
11830,NED,16,Baijens Indy ,MB,9,0,1,0.00,10,9,2,6,17,41.18,0,5,6,11,-45.45,1,3,3,7,-28.57,0,0,0,0, ,1,0,1,100.00,0,0,0,0, 
11830,NED,18,Jasper Marrit ,OH,0,0,0, ,0,0,0,0,0, ,0,0,0,0, ,0,0,0,0, ,0,0,0,0, ,0,0,0, ,0,0,0,0, 
11830,NED,19,Daalderop Nika ,OH,7,2,1,6.82,10,7,3,11,21,19.05,2,3,2,7,-14.29,1,1,14,16,0.00,6,0,5,11,54.55,8,6,15,13.33,0,0,0,0, 
11830,NED,23,Timmerman Eline ,MB,7,1,2,3.03,10,7,2,2,11,45.45,1,4,4,9,-33.33,2,3,8,13,-7.69,0,0,0,0, ,4,0,5,80.00,0,0,1,1,0.00
11830,NED,24,de Zwart Laura ,MB,0,0,0, ,0,0,0,0,0, ,0,0,0,0, ,0,0,0,0, ,0,0,0,0, ,0,0,0, ,0,0,0,0, 
11830,NED,26,Dambrink Elles ,O,10,2,1,28.57,13,10,1,15,26,34.62,2,0,2,4,50.00,1,0,11,12,8.33,1,0,0,1,100.00,5,0,5,100.00,0,0,0,0, 
11830,NED,27,Scholten Iris ,O,0,0,0, ,0,0,0,0,0, ,0,0,0,0, ,0,0,0,0, ,0,0,0,0, ,0,0,0, ,0,0,0,0, 
11830,BEL,2,Van Sas Elise ,S,0,0,0, ,0,0,0,0,0, ,0,0,0,0, ,0,0,0,0, ,0,0,0,0, ,0,0,0, ,0,0,0,0, 
11830,BEL,3,Herbots Britt ,OH,13,0,0,11.76,13,13,3,20,36,27.78,0,2,6,8,-25.00,0,2,5,7,-28.57,10,1,7,18,50.00,2,0,3,66.67,0,0,0,0, 
11830,BEL,5,Guilliams Jodie ,OH,5,0,0,3.57,5,5,2,10,17,17.65,0,0,2,2,0.00,0,2,7,9,-22.22,1,1,4,6,0.00,1,2,3,-33.33,0,0,0,0, 
11830,BEL,6,Gilson Helena ,OH,0,0,0, ,0,0,0,0,0, ,0,0,0,0, ,0,0,0,0, ,0,0,0,0, ,0,0,0, ,0,0,0,0, 
11830,BEL,7,Van Gestel Celine ,OH,4,0,1,-8.57,5,4,1,12,17,17.65,0,5,2,7,-71.43,1,2,8,11,-9.09,7,1,10,18,33.33,3,1,4,50.00,0,0,2,2,0.00
11830,BEL,9,Demeyer Nel ,L,0,0,0, ,0,0,0,0,0, ,0,0,0,0, ,0,0,0,0, ,0,0,0,0, ,0,0,0, ,0,0,0,0, 
11830,BEL,10,Sobolska Dominika ,MB,2,0,0,-28.57,2,2,1,4,7,14.29,0,5,4,9,-55.56,0,2,3,5,-40.00,1,0,0,1,100.00,0,0,1,0.00,0,0,0,0, 
11830,BEL,13,Janssens Marlies ,MB,10,1,0,8.33,11,10,1,5,16,56.25,1,5,2,8,-50.00,0,2,10,12,-16.67,0,0,0,0, ,3,0,3,100.00,0,0,0,0, 
11830,BEL,14,De Valkeneer Lise ,OH,0,0,0, ,0,0,0,0,0, ,0,0,0,0, ,0,0,0,0, ,0,0,0,0, ,0,0,0, ,0,0,0,0, 
11830,BEL,15,Van De Vyver Jutta ,S,0,0,0, ,0,0,0,0,0, ,0,0,0,0, ,0,0,0,0, ,0,0,0,0, ,0,0,0, ,0,0,0,0, 
11830,BEL,17,Van De Vyver Ilka ,S,1,1,1,0.00,3,1,0,1,2,50.00,1,3,0,4,-50.00,1,0,10,11,9.09,0,1,0,1,-100.00,3,1,4,50.00,32,0,59,91,35.16
11830,BEL,18,Rampelberg Britt ,L,0,0,0, ,0,0,0,0,0, ,0,0,0,0, ,0,0,0,0, ,11,1,8,20,50.00,5,3,8,25.00,0,0,4,4,0.00
11830,BEL,19,Van Avermaet Silke ,MB,0,0,0,0.00,0,0,0,1,1,0.00,0,0,0,0, ,0,0,1,1,0.00,0,0,0,0, ,0,0,0, ,0,0,0,0, 
11830,BEL,21,Stragier Manon ,OH,0,0,0,-25.00,0,0,0,0,0, ,0,0,0,0, ,0,1,3,4,-25.00,0,0,0,0, ,0,0,0, ,0,0,0,0, 
11831,TUR,2,Akoz Simge Sebnem ,L,0,0,0, ,0,0,0,0,0, ,0,0,0,0, ,0,0,0,0, ,11,2,8,21,42.86,25,5,33,60.61,0,0,3,3,0.00
11831,TUR,3,Ãzbay Cansu ,S,0,1,0,0.00,1,0,0,2,2,0.00,1,0,1,2,50.00,0,1,6,7,-14.29,0,0,0,0, ,5,0,7,71.43,8,1,46,55,12.73
11831,TUR,4,Senoglu Tugba ,OH,3,0,1,-5.88,4,3,3,4,10,0.00,0,1,1,2,-50.00,1,1,3,5,0.00,1,1,5,7,0.00,5,0,5,100.00,0,0,0,0, 
11831,TUR,5,Ercan Seyma ,OH,1,0,0,0.00,1,1,1,7,9,0.00,0,0,0,0, ,0,0,3,3,0.00,1,1,8,10,0.00,8,0,9,88.89,0,0,0,0, 
11831,TUR,6,Caliskan Kubra ,MB,0,0,0, ,0,0,0,0,0, ,0,0,0,0, ,0,0,0,0, ,0,0,0,0, ,0,0,0, ,0,0,0,0, 
11831,TUR,7,Baladin Hande ,OH,6,0,0,0.00,6,6,4,6,16,12.50,0,2,0,2,-100.00,0,0,8,8,0.00,5,5,17,27,0.00,10,0,11,90.91,0,0,0,0, 
11831,TUR,8,Guveli Yasemin ,MB,0,0,1,-17.65,1,0,1,2,3,-33.33,0,3,1,4,-75.00,1,0,9,10,10.00,0,0,0,0, ,2,0,2,100.00,0,0,0,0, 
11831,TUR,9,Ismailoglu Meliha ,OH,3,2,1,3.23,6,3,5,9,17,-11.76,2,0,0,2,100.00,1,0,11,12,8.33,8,0,19,27,29.63,7,0,8,87.50,0,0,1,1,0.00
11831,TUR,10,Aykac Ayca ,L,0,0,0, ,0,0,0,0,0, ,0,0,0,0, ,0,0,0,0, ,0,0,0,0, ,0,0,0, ,0,0,0,0, 
11831,TUR,11,Aydemir Akyol Naz ,S,0,1,0,-7.69,1,0,0,1,1,0.00,1,1,1,3,0.00,0,1,8,9,-11.11,0,0,0,0, ,5,0,6,83.33,8,0,83,91,8.79
11831,TUR,13,Boz Meryem ,O,16,1,0,13.11,17,16,8,17,41,19.51,1,1,3,5,0.00,0,0,15,15,0.00,0,0,0,0, ,3,0,3,100.00,1,0,0,1,100.00
11831,TUR,14,Erdem DÃ¼ndar Eda ,MB,10,5,0,-1.61,15,10,7,6,23,13.04,5,7,15,27,-7.41,0,2,10,12,-16.67,1,0,0,1,100.00,0,0,2,0.00,0,0,5,5,0.00
11831,TUR,19,Kalac Asli ,MB,5,1,2,8.57,8,5,1,2,8,50.00,1,4,6,11,-27.27,2,0,14,16,12.50,0,0,1,1,0.00,4,0,4,100.00,0,0,0,0, 
11831,TUR,99,Karakurt Ebrar ,OH,13,2,1,19.15,16,13,6,13,32,21.88,2,0,5,7,28.57,1,1,6,8,0.00,0,0,0,0, ,3,1,4,50.00,1,0,0,1,100.00
11831,SRB,2,Lazovic Katarina ,OH,10,2,5,1.23,17,10,10,21,41,0.00,2,4,4,10,-20.00,5,2,23,30,10.00,9,2,14,25,28.00,14,2,17,70.59,0,0,0,0, 
11831,SRB,3,Caric Sara ,O,18,4,0,12.50,22,18,8,26,52,19.23,4,1,2,7,42.86,0,4,9,13,-30.77,1,1,3,5,0.00,10,0,11,90.91,0,0,0,0, 
11831,SRB,6,Uzelac Aleksandra ,OH,0,0,0, ,0,0,0,0,0, ,0,0,0,0, ,0,0,0,0, ,0,0,0,0, ,0,0,0, ,0,0,0,0, 
11831,SRB,7,Jaksic Ana ,S,0,1,0,0.00,1,0,0,1,1,0.00,1,1,3,5,0.00,0,0,14,14,0.00,0,0,0,0, ,2,1,5,20.00,8,0,124,132,6.06
11831,SRB,21,Kocic Jovana ,MB,5,6,1,-6.00,12,5,2,3,10,30.00,6,10,5,21,-19.05,1,3,15,19,-10.53,0,0,1,1,0.00,4,2,6,33.33,0,0,0,0, 
11831,SRB,22,Lozo Sara ,O,13,1,1,19.23,15,13,2,21,36,30.56,1,0,2,3,33.33,1,3,9,13,-15.38,13,2,28,43,25.58,7,0,9,77.78,0,0,0,0, 
11831,SRB,23,Djordjevic Mila ,S,1,0,0,0.00,1,1,1,0,2,0.00,0,0,1,1,0.00,0,0,1,1,0.00,0,0,0,0, ,1,1,2,0.00,1,0,28,29,3.45
11831,SRB,24,Medic Sofija ,MB,5,4,2,12.82,11,5,2,7,14,21.43,4,2,6,12,16.67,2,2,9,13,0.00,0,0,0,0, ,3,1,5,40.00,0,0,0,0, 
11831,SRB,25,Markovic Bozica ,MB,0,0,0, ,0,0,0,0,0, ,0,0,0,0, ,0,0,0,0, ,0,0,0,0, ,0,0,0, ,0,0,0,0, 
11831,SRB,26,Savic Vanja ,O,3,0,0,0.00,3,3,1,5,9,22.22,0,1,1,2,-50.00,0,1,1,2,-50.00,0,0,0,0, ,2,0,3,66.67,0,0,0,0, 
11831,SRB,28,Delic Jelena ,MB,0,0,0, ,0,0,0,0,0, ,0,0,0,0, ,0,0,0,0, ,0,0,0,0, ,0,0,0, ,0,0,0,0, 
11831,SRB,31,Djurdjevic Sanja ,L,0,0,0, ,0,0,0,0,0, ,0,0,0,0, ,0,0,0,0, ,8,1,12,21,33.33,20,3,26,65.38,0,0,3,3,0.00
11831,SRB,32,Gocanin Bojana ,L,0,0,0, ,0,0,0,0,0, ,0,0,0,0, ,0,0,0,0, ,0,0,0,0, ,0,0,0, ,0,0,0,0, 
11831,SRB,34,Mirosavljevic Jovana ,OH,1,0,0,0.00,1,1,1,1,3,0.00,0,0,0,0, ,0,0,4,4,0.00,1,0,3,4,25.00,2,1,3,33.33,0,0,0,0, 
11832,GER,1,Bock Linda ,L,0,0,0, ,0,0,0,0,0, ,0,0,0,0, ,0,0,0,0, ,1,0,0,1,100.00,0,0,0, ,0,0,0,0, 
11832,GER,2,KÃ¤stner Pia ,S,0,0,1,25.00,1,0,0,0,0, ,0,0,1,1,0.00,1,0,2,3,33.33,0,0,0,0, ,1,0,1,100.00,2,1,15,18,5.56
11832,GER,4,Imoudu Denise ,S,1,0,1,10.00,2,1,0,0,1,100.00,0,1,2,3,-33.33,1,0,5,6,16.67,0,0,0,0, ,11,0,11,100.00,15,3,58,76,15.79
11832,GER,5,Poll Jana Franziska ,OH,0,0,0,0.00,0,0,0,0,0, ,0,0,0,0, ,0,0,1,1,0.00,1,0,1,2,50.00,1,0,1,100.00,0,0,1,1,0.00
11832,GER,6,Janiska Jennifer ,OH,8,2,1,28.57,11,8,0,10,18,44.44,2,0,0,2,100.00,1,1,13,15,0.00,12,2,10,24,41.67,8,0,8,100.00,0,0,0,0, 
11832,GER,7,Vanjak Ivana ,OH,5,0,0,7.14,5,5,3,3,11,18.18,0,1,1,2,-50.00,0,0,1,1,0.00,0,0,0,0, ,0,2,2,-100.00,0,0,0,0, 
11832,GER,8,Drewniok Kimberly ,O,9,0,0,2.78,9,9,4,11,24,20.83,0,3,2,5,-60.00,0,1,6,7,-14.29,0,0,0,0, ,4,1,5,60.00,0,0,0,0, 
11832,GER,9,Alsmeier Lina ,OH,0,0,0,0.00,0,0,0,2,2,0.00,0,0,0,0, ,0,0,0,0, ,0,0,0,0, ,0,0,0, ,0,0,0,0, 
11832,GER,12,Orthmann Hanna ,OH,8,1,1,5.26,10,8,6,12,26,7.69,1,1,2,4,0.00,1,1,6,8,0.00,5,0,7,12,41.67,2,2,4,0.00,0,0,0,0, 
11832,GER,14,SchÃ¶lzel Marie ,MB,3,0,1,-11.54,4,3,1,7,11,18.18,0,6,2,8,-75.00,1,0,6,7,14.29,0,0,0,0, ,0,1,2,-50.00,0,1,1,2,-50.00
11832,GER,16,Ambrosius Lea ,MB,0,0,0, ,0,0,0,0,0, ,0,0,0,0, ,0,0,0,0, ,0,0,0,0, ,0,0,0, ,0,0,0,0, 
11832,GER,17,Pogany Anna ,L,0,0,0, ,0,0,0,0,0, ,0,0,0,0, ,0,0,0,0, ,13,3,12,28,35.71,12,4,16,50.00,1,0,6,7,14.29
11832,GER,20,Bock Josepha ,MB,0,0,0, ,0,0,0,0,0, ,0,0,0,0, ,0,0,0,0, ,0,0,0,0, ,0,0,0, ,0,0,0,0, 
11832,GER,21,Weitzel Camilla ,MB,4,1,2,10.34,7,4,0,4,8,50.00,1,2,2,5,-20.00,2,2,12,16,0.00,0,0,0,0, ,1,0,1,100.00,2,0,0,2,100.00
11832,RUS,2,Malygina Daria ,O,0,0,0, ,0,0,0,0,0, ,0,0,0,0, ,0,0,0,0, ,0,0,0,0, ,0,0,0, ,0,0,0,0, 
11832,RUS,4,Pilipenko Daria ,L,0,0,0, ,0,0,0,0,0, ,0,0,0,0, ,0,0,0,0, ,1,1,1,3,0.00,4,0,4,100.00,0,0,0,0, 
11832,RUS,5,Fedorovtseva Arina ,OH,0,0,0,-20.00,0,0,0,0,0, ,0,0,1,1,0.00,0,1,3,4,-25.00,0,1,1,2,-50.00,1,0,1,100.00,0,0,0,0, 
11832,RUS,6,Koroleva Irina ,MB,5,1,2,3.85,8,5,1,2,8,50.00,1,6,2,9,-55.56,2,0,7,9,22.22,0,0,0,0, ,1,0,1,100.00,0,0,0,0, 
11832,RUS,8,Goncharova Nataliya ,O,18,2,0,25.00,20,18,3,10,31,48.39,2,3,6,11,-9.09,0,0,14,14,0.00,0,0,0,0, ,5,0,5,100.00,0,0,1,1,0.00
11832,RUS,11,Brovkina Yulia ,MB,0,0,0,-20.00,0,0,1,0,1,-100.00,0,1,0,1,-100.00,0,0,8,8,0.00,0,0,0,0, ,0,0,0, ,0,0,0,0, 
11832,RUS,13,Startseva Evgeniya ,S,3,0,0,-5.26,3,3,0,0,3,100.00,0,3,6,9,-33.33,0,1,6,7,-14.29,0,0,0,0, ,3,2,6,16.67,6,0,77,83,7.23
11832,RUS,14,Fetisova Irina ,MB,0,0,0,-30.00,0,0,0,2,2,0.00,0,2,2,4,-50.00,0,1,3,4,-25.00,0,0,0,0, ,0,0,0, ,0,0,0,0, 
11832,RUS,15,Kosheleva Tatyana ,OH,10,1,0,20.00,11,10,1,11,22,40.91,1,2,5,8,-12.50,0,1,4,5,-20.00,4,3,11,18,5.56,1,1,3,0.00,0,0,0,0, 
11832,RUS,16,Voronkova Irina ,OH,10,1,3,17.07,14,10,3,8,21,33.33,1,3,2,6,-33.33,3,1,10,14,14.29,9,2,11,22,31.82,5,0,5,100.00,0,0,1,1,0.00
11832,RUS,20,Lazareva Ekaterina ,S,0,0,0, ,0,0,0,0,0, ,0,0,0,0, ,0,0,0,0, ,0,0,0,0, ,0,0,0, ,0,0,0,0, 
11832,RUS,22,Zaytseva Tamara ,L,0,0,0, ,0,0,0,0,0, ,0,0,0,0, ,0,0,0,0, ,5,0,9,14,35.71,11,2,13,69.23,0,0,2,2,0.00
11832,RUS,23,Kapustina Irina ,OH,0,0,0,0.00,0,0,0,0,0, ,0,0,0,0, ,0,0,3,3,0.00,0,0,0,0, ,0,0,0, ,0,0,0,0, 
11832,RUS,25,Smirnova Kseniia ,OH,0,0,0,0.00,0,0,0,1,1,0.00,0,0,0,0, ,0,0,4,4,0.00,0,0,0,0, ,1,0,1,100.00,0,0,0,0, 
11833,JPN,1,Kurogo Ai ,OH,9,3,1,16.67,13,9,0,15,24,37.50,3,5,2,10,-20.00,1,1,6,8,0.00,0,0,0,0, ,9,1,11,72.73,0,0,0,0, 
11833,JPN,2,Koga Sarina ,OH,8,2,2,22.22,12,8,2,7,17,35.29,2,1,2,5,20.00,2,1,11,14,7.14,11,1,5,17,58.82,5,0,5,100.00,0,0,0,0, 
11833,JPN,3,Shimamura Haruyo ,MB,9,2,0,12.20,11,9,0,8,17,52.94,2,5,6,13,-23.08,0,1,10,11,-9.09,0,0,0,0, ,1,0,1,100.00,0,0,0,0, 
11833,JPN,5,Araki Erika ,MB,9,3,2,25.71,14,9,1,4,14,57.14,3,2,5,10,10.00,2,2,7,11,0.00,3,0,0,3,100.00,1,0,1,100.00,0,0,0,0, 
11833,JPN,7,Ishii Yuki ,OH,0,0,0,0.00,0,0,0,0,0, ,0,0,0,0, ,0,0,2,2,0.00,0,0,0,0, ,0,0,0, ,0,0,0,0, 
11833,JPN,8,Ishikawa Mayu ,OH,8,1,0,20.00,9,8,1,5,14,50.00,1,2,2,5,-20.00,0,0,11,11,0.00,11,0,6,17,64.71,3,1,4,50.00,0,0,0,0, 
11833,JPN,9,Tashiro Kanami ,S,0,0,0,0.00,0,0,0,0,0, ,0,0,0,0, ,0,0,3,3,0.00,0,0,0,0, ,2,0,3,66.67,1,0,14,15,6.67
11833,JPN,13,Okumura Mai ,MB,0,0,0, ,0,0,0,0,0, ,0,0,0,0, ,0,0,0,0, ,0,0,0,0, ,0,0,0, ,0,0,0,0, 
11833,JPN,14,Kobata Mako ,L,0,0,0, ,0,0,0,0,0, ,0,0,0,0, ,0,0,0,0, ,1,1,4,6,0.00,16,0,17,94.12,0,0,1,1,0.00
11833,JPN,15,Inoue Kotoe ,L,0,0,0, ,0,0,0,0,0, ,0,0,0,0, ,0,0,0,0, ,0,0,0,0, ,0,0,0, ,0,0,0,0, 
11833,JPN,19,Yamada Nichika ,MB,0,0,0, ,0,0,0,0,0, ,0,0,0,0, ,0,0,0,0, ,0,0,0,0, ,0,0,0, ,0,0,0,0, 
11833,JPN,20,Seki Nanami ,S,0,0,0, ,0,0,0,0,0, ,0,0,0,0, ,0,0,0,0, ,0,0,0,0, ,0,0,0, ,0,0,0,0, 
11833,JPN,21,Hayashi Kotona ,OH,1,1,0,28.57,2,1,0,5,6,16.67,1,0,0,1,100.00,0,0,0,0, ,0,0,0,0, ,0,0,1,0.00,0,0,0,0, 
11833,JPN,24,Momii Aki ,S,0,0,0,-18.75,0,0,0,0,0, ,0,1,1,2,-50.00,0,2,12,14,-14.29,0,0,0,0, ,1,2,6,-16.67,21,1,52,74,27.03
11833,THA,2,Pannoy Piyanut ,L,0,0,0, ,0,0,0,0,0, ,0,0,0,0, ,0,0,0,0, ,1,3,5,9,-22.22,6,0,7,85.71,0,0,0,0, 
11833,THA,3,ManaKij Sirima ,S,0,0,0, ,0,0,0,0,0, ,0,0,0,0, ,0,0,0,0, ,0,0,0,0, ,1,0,1,100.00,1,0,7,8,12.50
11833,THA,5,Thinkaow Pleumjit ,MB,9,1,0,15.62,10,9,1,8,18,44.44,1,2,2,5,-20.00,0,2,7,9,-22.22,0,0,1,1,0.00,2,0,2,100.00,0,0,0,0, 
11833,THA,6,Sittirak Onuma ,OH,7,1,0,2.56,8,7,6,16,29,3.45,1,0,2,3,33.33,0,1,6,7,-14.29,2,0,4,6,33.33,4,2,6,33.33,0,0,0,0, 
11833,THA,8,Sang-Ob Tirawan ,MB,0,0,0, ,0,0,0,0,0, ,0,0,0,0, ,0,0,0,0, ,0,0,0,0, ,0,0,0, ,0,0,0,0, 
11833,THA,9,Chuewulim Sutadta ,OH,5,0,0,0.00,5,5,4,7,16,6.25,0,0,1,1,0.00,0,1,4,5,-20.00,8,0,13,21,38.10,5,1,6,66.67,0,0,0,0, 
11833,THA,10,Apinyapong Wilavan ,L,1,0,0,20.00,1,1,0,2,3,33.33,0,0,0,0, ,0,0,2,2,0.00,0,1,6,7,-14.29,0,1,1,-100.00,0,0,0,0, 
11833,THA,11,Hyapha Amporn ,MB,0,0,0, ,0,0,0,0,0, ,0,0,0,0, ,0,0,0,0, ,0,0,0,0, ,0,0,0, ,0,0,0,0, 
11833,THA,12,Chaisri Tapaphaipun ,L,0,0,0, ,0,0,0,0,0, ,0,0,0,0, ,0,0,0,0, ,1,0,7,8,12.50,6,2,10,40.00,0,0,1,1,0.00
11833,THA,13,Tomkom Nootsara ,S,0,0,1,-9.09,1,0,1,2,3,-33.33,0,0,0,0, ,1,1,6,8,0.00,0,0,0,0, ,7,0,10,70.00,9,4,72,85,5.88
11833,THA,14,Juangjan Pattiya ,OH,0,0,0,-100.00,0,0,1,0,1,-100.00,0,1,0,1,-100.00,0,0,0,0, ,0,0,0,0, ,0,0,0, ,0,0,0,0, 
11833,THA,15,Kanthong Malika ,O,7,0,1,16.67,8,7,2,8,17,29.41,0,1,3,4,-25.00,1,0,8,9,11.11,7,1,7,15,40.00,3,0,5,60.00,0,0,0,0, 
11833,THA,19,Krause Karina ,MB,5,0,0,0.00,5,5,1,4,10,40.00,0,3,1,4,-75.00,0,1,8,9,-11.11,0,0,0,0, ,1,0,2,50.00,0,0,0,0, 
11833,THA,24,Nuanjam Watchareeya ,MB,0,0,0, ,0,0,0,0,0, ,0,0,0,0, ,0,0,0,0, ,0,0,0,0, ,0,0,0, ,0,0,0,0, 
11834,CHN,3,Diao Linyu ,S,1,0,1,20.00,2,1,0,0,1,100.00,0,0,0,0, ,1,1,2,4,0.00,0,0,0,0, ,0,0,0, ,0,0,12,12,0.00
11834,CHN,4,Yang Hanyu ,MB,5,2,1,0.00,8,5,2,10,17,17.65,2,3,3,8,-12.50,1,3,7,11,-18.18,1,0,0,1,100.00,1,0,1,100.00,0,0,2,2,0.00
11834,CHN,5,Gao Yi ,MB,0,0,0, ,0,0,0,0,0, ,0,0,0,0, ,0,0,0,0, ,0,0,0,0, ,0,0,0, ,0,0,0,0, 
11834,CHN,7,Wang Yuanyuan ,MB,2,1,0,-13.64,3,2,0,5,7,28.57,1,4,2,7,-42.86,0,2,6,8,-25.00,0,0,0,0, ,1,0,1,100.00,0,0,0,0, 
11834,CHN,8,Li Yao ,OH,10,2,2,9.43,14,10,1,10,21,42.86,2,6,3,11,-36.36,2,2,17,21,0.00,0,0,1,1,0.00,8,2,10,60.00,0,0,1,1,0.00
11834,CHN,9,Zhang Changning ,OH,16,6,1,14.49,23,16,8,19,43,18.60,6,3,3,12,25.00,1,2,11,14,-7.14,9,0,8,17,52.94,14,0,15,93.33,0,0,1,1,0.00
11834,CHN,10,Liu Xiaotong ,OH,0,0,0,-66.67,0,0,1,1,2,-50.00,0,2,0,2,-100.00,0,1,1,2,-50.00,2,0,6,8,25.00,4,0,4,100.00,0,0,0,0, 
11834,CHN,11,Yao Di ,S,0,0,0,-17.65,0,0,0,3,3,0.00,0,3,2,5,-60.00,0,0,9,9,0.00,0,0,0,0, ,7,1,8,75.00,10,1,104,115,7.83
11834,CHN,14,Zheng Yixin ,MB,5,0,2,21.74,7,5,1,3,9,44.44,0,0,1,1,0.00,2,1,10,13,7.69,0,0,2,2,0.00,1,0,1,100.00,0,0,0,0, 
11834,CHN,15,Lin Li ,L,0,0,0, ,0,0,0,0,0, ,0,0,0,0, ,0,0,0,0, ,3,2,3,8,12.50,9,2,13,53.85,0,0,3,3,0.00
11834,CHN,18,Wang Mengjie ,L,0,0,0, ,0,0,0,0,0, ,0,0,0,0, ,0,0,0,0, ,3,0,5,8,37.50,7,0,8,87.50,0,0,0,0, 
11834,CHN,19,Liu Yanhan ,OH,14,1,0,25.45,15,14,0,24,38,36.84,1,1,2,4,0.00,0,0,13,13,0.00,6,1,19,26,19.23,5,1,6,66.67,0,0,1,1,0.00
11834,CHN,22,Duan Fang ,OH,0,0,0,-50.00,0,0,0,0,0, ,0,0,0,0, ,0,1,1,2,-50.00,1,1,0,2,0.00,1,0,1,100.00,0,0,0,0, 
11834,KOR,1,Lee Soyoung ,OH,14,0,2,15.00,16,14,5,22,41,21.95,0,0,3,3,0.00,2,2,12,16,0.00,12,3,16,31,29.03,10,2,12,66.67,0,0,1,1,0.00
11834,KOR,2,Lee Dahyeon ,MB,0,0,0, ,0,0,0,0,0, ,0,0,0,0, ,0,0,0,0, ,0,0,0,0, ,0,0,0, ,0,0,0,0, 
11834,KOR,5,Han Dahye ,L,0,0,0, ,0,0,0,0,0, ,0,0,0,0, ,0,0,0,0, ,0,0,0,0, ,0,0,0, ,0,0,0,0, 
11834,KOR,6,Kim Dain ,S,0,0,1,-23.81,1,0,0,1,1,0.00,0,5,0,5,-100.00,1,1,13,15,0.00,0,0,0,0, ,4,1,5,60.00,7,1,90,98,6.12
11834,KOR,7,An Hyejin ,S,0,0,0,-11.11,0,0,0,1,1,0.00,0,1,0,1,-100.00,0,0,7,7,0.00,0,0,0,0, ,3,1,4,50.00,5,0,32,37,13.51
11834,KOR,8,Park Eunjin ,MB,0,0,0, ,0,0,0,0,0, ,0,0,0,0, ,0,0,0,0, ,0,0,0,0, ,0,0,0, ,0,0,0,0, 
11834,KOR,9,Oh Jiyoung ,L,0,0,0, ,0,0,0,0,0, ,0,0,0,0, ,0,0,0,0, ,13,1,8,22,54.55,13,3,19,52.63,0,0,8,8,0.00
11834,KOR,10,Kim Yeon Koung ,OH,13,1,0,6.90,14,13,8,20,41,12.20,1,0,3,4,25.00,0,2,11,13,-15.38,13,3,13,29,34.48,12,1,13,84.62,0,0,2,2,0.00
11834,KOR,12,Han Songyi ,MB,3,1,0,0.00,4,3,2,4,9,11.11,1,1,1,3,0.00,0,1,10,11,-9.09,0,0,0,0, ,3,0,4,75.00,0,0,0,0, 
11834,KOR,13,Park Jeongah ,OH,9,0,1,2.70,10,9,5,14,28,14.29,0,3,0,3,-100.00,1,1,4,6,0.00,0,0,0,0, ,3,1,4,50.00,0,0,0,0, 
11834,KOR,14,Yang Hyo Jin ,MB,7,1,0,9.38,8,7,1,7,15,40.00,1,3,1,5,-40.00,0,1,11,12,-8.33,1,0,0,1,100.00,3,0,3,100.00,0,0,0,0, 
11834,KOR,15,Yuk Seoyoung ,OH,0,0,0, ,0,0,0,0,0, ,0,0,0,0, ,0,0,0,0, ,0,0,0,0, ,0,0,0, ,0,0,0,0, 
11834,KOR,16,Jeong Jiyun ,O,2,0,0,-23.81,2,2,6,10,18,-22.22,0,1,1,2,-50.00,0,0,1,1,0.00,0,0,0,0, ,1,0,1,100.00,0,0,5,5,0.00
11834,KOR,19,Pyo Seungju ,OH,1,0,0,0.00,1,1,1,1,3,0.00,0,0,0,0, ,0,0,0,0, ,0,0,1,1,0.00,0,0,0, ,0,0,0,0, 
11835,DOM,1,Vargas Valdez Annerys Victoria ,MB,1,0,0,-20.00,1,1,1,0,2,0.00,0,0,1,1,0.00,0,1,1,2,-50.00,0,1,0,1,-100.00,0,0,0, ,0,0,0,0, 
11835,DOM,3,Eve Mejia Lisvel Elisa ,U,1,1,0,-38.10,2,1,2,1,4,-25.00,1,7,0,8,-75.00,0,1,8,9,-11.11,0,0,4,4,0.00,4,3,7,14.29,0,0,0,0, 
11835,DOM,5,Castillo Brenda ,L,0,0,0, ,0,0,0,0,0, ,0,0,0,0, ,0,0,0,0, ,8,0,8,16,50.00,9,5,14,28.57,1,0,3,4,25.00
11835,DOM,6,Dominguez Martinez Camil Inmaculada ,S,0,0,0, ,0,0,0,0,0, ,0,0,0,0, ,0,0,0,0, ,0,0,0,0, ,1,1,2,0.00,0,0,0,0, 
11835,DOM,7,Marte Frica Niverka Dharlenis ,S,0,0,0,-15.38,0,0,1,1,2,-50.00,0,1,0,1,-100.00,0,0,10,10,0.00,0,0,0,0, ,3,4,7,-14.29,0,0,0,0, 
11835,DOM,11,Rodriguez Marifranchi ,MB,0,0,0, ,0,0,0,0,0, ,0,0,0,0, ,0,0,0,0, ,0,0,0,0, ,0,0,0, ,0,0,0,0, 
11835,DOM,14,Rivera Brens Prisilla ,OH,8,0,0,10.81,8,8,3,17,28,17.86,0,0,0,0, ,0,1,8,9,-11.11,7,1,26,34,17.65,2,5,8,-37.50,0,0,1,1,0.00
11835,DOM,16,PeÃ±a Isabel Yonkaira Paola ,OH,1,0,0,-8.33,1,1,2,7,10,-10.00,0,0,0,0, ,0,0,2,2,0.00,2,0,1,3,66.67,1,0,1,100.00,0,0,0,0, 
11835,DOM,17,Mambru Casilla Gina Altagracia ,O,2,0,0,-14.29,2,2,2,0,4,0.00,0,1,0,1,-100.00,0,0,2,2,0.00,0,0,0,0, ,0,0,0, ,0,0,0,0, 
11835,DOM,18,De La Cruz De PeÃ±a Bethania ,OH,9,0,1,18.75,10,9,1,14,24,33.33,0,1,0,1,-100.00,1,2,4,7,-14.29,2,0,4,6,33.33,1,2,3,-33.33,0,0,0,0, 
11835,DOM,20,Martinez Brayelin Elizabeth ,OH,0,0,0, ,0,0,0,0,0, ,0,0,0,0, ,0,0,0,0, ,0,0,0,0, ,0,0,0, ,0,0,0,0, 
11835,DOM,21,Martinez Jineiry ,MB,3,1,0,25.00,4,3,0,6,9,33.33,1,0,0,1,100.00,0,0,6,6,0.00,0,0,2,2,0.00,1,1,2,0.00,0,0,0,0, 
11835,DOM,23,Gonzalez Lopez Gaila Ceneida ,O,9,1,0,2.56,10,9,4,12,25,20.00,1,4,1,6,-50.00,0,1,7,8,-12.50,0,0,0,0, ,1,2,3,-33.33,0,0,0,0, 
11835,DOM,25,Martinez Caro Larysmer ,OH,0,0,0, ,0,0,0,0,0, ,0,0,0,0, ,0,0,0,0, ,0,0,0,0, ,0,0,0, ,0,0,0,0, 
11835,USA,1,Hancock Micha ,S,0,0,0, ,0,0,0,0,0, ,0,0,0,0, ,0,0,0,0, ,0,0,0,0, ,0,0,0, ,0,0,0,0, 
11835,USA,3,Plummer Kathryn ,OH,14,2,0,11.63,16,14,5,9,28,32.14,2,3,1,6,-16.67,0,3,6,9,-33.33,7,1,16,24,25.00,4,3,7,14.29,1,0,1,2,50.00
11835,USA,4,Wong-Orantes Justine ,L,0,0,0, ,0,0,0,0,0, ,0,0,0,0, ,0,0,0,0, ,9,0,6,15,60.00,10,5,16,31.25,0,0,2,2,0.00
11835,USA,6,Dixon Tetori ,MB,6,0,0,11.54,6,6,1,6,13,38.46,0,1,2,3,-33.33,0,1,9,10,-10.00,0,0,0,0, ,0,1,1,-100.00,0,0,0,0, 
11835,USA,7,Carlini Lauren ,S,1,1,1,13.33,3,1,0,1,2,50.00,1,1,0,2,0.00,1,0,10,11,9.09,0,0,0,0, ,2,2,4,0.00,0,0,0,0, 
11835,USA,8,Tapp Hannah ,MB,3,4,0,10.34,7,3,0,3,6,50.00,4,3,2,9,11.11,0,1,13,14,-7.14,0,0,0,0, ,0,1,1,-100.00,0,0,0,0, 
11835,USA,10,Larson Jordan ,OH,14,1,0,18.75,15,14,1,13,28,46.43,1,4,0,5,-60.00,0,1,14,15,-6.67,5,0,5,10,50.00,2,2,4,0.00,1,1,2,4,0.00
11835,USA,11,Drews Andrea ,O,0,0,0, ,0,0,0,0,0, ,0,0,0,0, ,0,0,0,0, ,0,0,0,0, ,0,0,0, ,0,0,0,0, 
11835,USA,12,Thompson Jordan ,O,13,1,1,12.73,15,13,3,17,33,30.30,1,4,3,8,-37.50,1,1,12,14,0.00,0,0,0,0, ,6,2,8,50.00,3,0,1,4,75.00
11835,USA,13,Wilhite Sarah ,OH,0,0,0, ,0,0,0,0,0, ,0,0,0,0, ,0,0,0,0, ,0,0,0,0, ,0,0,0, ,0,0,0,0, 
11835,USA,15,Hill Kimberly ,OH,0,0,0, ,0,0,0,0,0, ,0,0,0,0, ,0,0,0,0, ,0,0,0,0, ,0,0,0, ,0,0,0,0, 
11835,USA,16,Akinradewo Foluke ,MB,0,0,0, ,0,0,0,0,0, ,0,0,0,0, ,0,0,0,0, ,0,0,0,0, ,0,0,0, ,0,0,0,0, 
11835,USA,17,Courtney Megan ,OH,0,0,0, ,0,0,0,0,0, ,0,0,0,0, ,0,0,0,0, ,0,0,0,0, ,0,0,0, ,0,0,0,0, 
11835,USA,22,Washington Haleigh ,MB,0,0,0, ,0,0,0,0,0, ,0,0,0,0, ,0,0,0,0, ,0,0,0,0, ,0,0,0, ,0,0,0,0, 
11836,ITA,2,Bosio Francesca ,S,0,0,0,-5.88,0,0,0,0,0, ,0,1,1,2,-50.00,0,0,15,15,0.00,0,0,0,0, ,8,1,9,77.78,35,1,111,147,23.13
11836,ITA,4,Bonifacio Sara ,MB,0,0,0, ,0,0,0,0,0, ,0,0,0,0, ,0,0,0,0, ,0,0,0,0, ,0,0,0, ,0,0,0,0, 
11836,ITA,12,Guerra Anastasia ,OH,12,2,2,10.00,16,12,9,16,37,8.11,2,0,1,3,66.67,2,1,17,20,5.00,11,4,33,48,14.58,11,3,14,57.14,0,0,1,1,0.00
11836,ITA,15,Nwakalor Sylvia Chinelo ,O,2,0,1,-11.11,3,2,1,1,4,25.00,0,1,1,2,-50.00,1,2,0,3,-33.33,0,0,0,0, ,4,0,4,100.00,0,0,0,0, 
11836,ITA,19,Mingardi Camilla ,OH,13,2,1,9.09,16,13,8,21,42,11.90,2,2,4,8,0.00,1,0,15,16,6.25,0,0,0,0, ,12,4,16,50.00,0,0,1,1,0.00
11836,ITA,21,Lubian Marina ,MB,6,1,4,-12.96,11,6,4,6,16,12.50,1,8,9,18,-38.89,4,6,10,20,-10.00,0,0,0,0, ,0,1,1,-100.00,0,0,2,2,0.00
11836,ITA,23,De Bortoli Chiara ,L,0,0,0, ,0,0,0,0,0, ,0,0,0,0, ,0,0,0,0, ,0,0,0,0, ,0,0,0, ,0,0,0,0, 
11836,ITA,24,Mazzaro Alessia ,MB,7,2,0,10.00,9,7,2,9,18,27.78,2,3,1,6,-16.67,0,0,16,16,0.00,0,0,0,0, ,4,0,4,100.00,0,0,0,0, 
11836,ITA,26,Battistoni Ilaria ,S,0,0,0, ,0,0,0,0,0, ,0,0,0,0, ,0,0,0,0, ,0,0,0,0, ,0,0,0, ,1,0,2,3,33.33
11836,ITA,27,Furlan Eleonora ,MB,0,0,0, ,0,0,0,0,0, ,0,0,0,0, ,0,0,0,0, ,0,0,0,0, ,0,0,0, ,0,0,0,0, 
11836,ITA,28,Melli Giulia ,OH,0,0,0,-66.67,0,0,2,0,2,-100.00,0,0,1,1,0.00,0,0,0,0, ,0,1,0,1,-100.00,0,0,0, ,0,0,0,0, 
11836,ITA,29,D'Odorico Sofia ,OH,13,4,2,10.81,19,13,4,25,42,21.43,4,5,3,12,-8.33,2,2,16,20,0.00,4,2,9,15,13.33,10,1,12,75.00,0,0,1,1,0.00
11836,ITA,31,Fersino Eleonora ,L,0,0,0, ,0,0,0,0,0, ,0,0,0,0, ,0,0,0,0, ,12,1,14,27,40.74,24,4,28,71.43,0,0,7,7,0.00
11836,ITA,32,Omoruyi Oghosasere Loveth ,OH,0,0,0, ,0,0,0,0,0, ,0,0,0,0, ,0,0,0,0, ,0,0,0,0, ,0,0,0, ,0,0,0,0, 
11836,POL,1,Nowicka Julia ,S,2,0,0,-17.65,2,2,1,4,7,14.29,0,5,4,9,-55.56,0,2,16,18,-11.11,0,0,0,0, ,13,2,15,73.33,16,3,112,131,9.92
11836,POL,3,Alagierska Klaudia ,MB,3,1,1,20.00,5,3,1,0,4,50.00,1,0,3,4,25.00,1,0,11,12,8.33,0,0,1,1,0.00,2,0,2,100.00,0,0,1,1,0.00
11836,POL,5,Kakolewska Agnieszka ,MB,2,1,2,7.14,5,2,0,7,9,22.22,1,1,7,9,0.00,2,2,6,10,0.00,0,0,0,0, ,1,0,1,100.00,0,0,1,1,0.00
11836,POL,8,Stenzel Maria ,L,0,0,0, ,0,0,0,0,0, ,0,0,0,0, ,0,0,0,0, ,13,2,16,31,35.48,8,2,10,60.00,0,0,5,5,0.00
11836,POL,9,Stysiak Magdalena ,O,21,3,1,13.16,25,21,6,25,52,28.85,3,3,2,8,0.00,1,6,9,16,-31.25,6,1,10,17,29.41,6,2,8,50.00,0,0,2,2,0.00
11836,POL,10,Efimienko-Mlotkowska Zuzanna ,MB,4,5,2,14.71,11,4,0,2,6,66.67,5,3,4,12,16.67,2,3,11,16,-6.25,1,0,0,1,100.00,2,1,3,33.33,0,0,0,0, 
11836,POL,11,Lukasik Martyna ,O,1,0,0,20.00,1,1,0,3,4,25.00,0,0,0,0, ,0,0,1,1,0.00,1,0,0,1,100.00,1,0,1,100.00,0,0,0,0, 
11836,POL,13,Jagla Monika ,L,0,0,0, ,0,0,0,0,0, ,0,0,0,0, ,0,0,0,0, ,0,0,0,0, ,9,7,17,11.76,0,0,5,5,0.00
11836,POL,17,Smarzek Malwina ,O,17,0,1,1.30,18,17,12,22,51,9.80,0,4,3,7,-57.14,1,1,17,19,0.00,0,0,0,0, ,5,1,7,57.14,0,0,2,2,0.00
11836,POL,19,Fedusio Monika ,OH,0,0,0,-100.00,0,0,0,0,0, ,0,0,0,0, ,0,1,0,1,-100.00,0,0,0,0, ,0,0,0, ,0,0,0,0, 
11836,POL,20,Czyrnianska Martyna ,OH,0,0,0, ,0,0,0,0,0, ,0,0,0,0, ,0,0,0,0, ,0,0,0,0, ,0,0,0, ,0,0,0,0, 
11836,POL,27,Åazowska Martyna ,S,0,0,0,0.00,0,0,0,0,0, ,0,0,0,0, ,0,0,1,1,0.00,0,0,0,0, ,0,0,0, ,1,0,10,11,9.09
11836,POL,30,Rozanski Olivia ,OH,0,0,0, ,0,0,0,0,0, ,0,0,0,0, ,0,0,0,0, ,0,1,1,2,-50.00,0,0,0, ,0,0,0,0, 
11836,POL,88,Gorecka Zuzanna ,OH,9,1,1,9.52,11,9,5,10,24,16.67,1,0,3,4,25.00,1,2,11,14,-7.14,10,6,30,46,8.70,14,3,20,55.00,0,0,0,0, 
11837,BRA,2,De Oliveira Saad Gattaz Caroline ,MB,0,0,0, ,0,0,0,0,0, ,0,0,0,0, ,0,0,0,0, ,0,0,0,0, ,0,0,0, ,0,0,0,0, 
11837,BRA,3,Rodrigues Lins Dos Santos Danielle ,S,0,1,0,0.00,1,0,0,0,0, ,1,1,0,2,0.00,0,0,1,1,0.00,0,0,0,0, ,3,0,3,100.00,0,0,13,13,0.00
11837,BRA,5,Da Silva Adenizia ,MB,0,0,0, ,0,0,0,0,0, ,0,0,0,0, ,0,0,0,0, ,0,0,0,0, ,0,0,0, ,0,0,0,0, 
11837,BRA,6,Alexandre Costa Nunes Nyeme Victoria ,L,0,0,0, ,0,0,0,0,0, ,0,0,0,0, ,0,0,0,0, ,0,0,0,0, ,0,0,0, ,0,0,0,0, 
11837,BRA,8,Silva Carneiro Macris Fernanda ,S,0,0,0,-16.67,0,0,0,0,0, ,0,2,0,2,-100.00,0,0,10,10,0.00,0,0,1,1,0.00,1,1,2,0.00,0,1,20,21,-4.76
11837,BRA,10,Braga Guimaraes Gabriela ,OH,11,4,0,14.00,15,11,5,11,27,22.22,4,3,0,7,14.29,0,0,16,16,0.00,15,0,10,25,60.00,3,3,6,0.00,0,0,0,0, 
11837,BRA,11,Caixeta Tandara ,OH,13,0,0,15.22,13,13,4,13,30,30.00,0,2,1,3,-66.67,0,0,13,13,0.00,0,1,0,1,-100.00,3,3,6,0.00,0,0,0,0, 
11837,BRA,13,Castro De Paula Blassioli Sheilla ,O,0,0,0, ,0,0,0,0,0, ,0,0,0,0, ,0,0,0,0, ,0,0,0,0, ,0,0,0, ,0,0,0,0, 
11837,BRA,15,Da Silva Ana Carolina ,MB,6,6,1,25.71,13,6,0,2,8,75.00,6,3,0,9,33.33,1,1,16,18,0.00,0,0,0,0, ,0,2,2,-100.00,0,0,0,0, 
11837,BRA,16,Rodrigues Fernanda ,OH,10,3,1,24.49,14,10,0,14,24,41.67,3,2,1,6,16.67,1,0,18,19,5.26,8,0,3,11,72.73,5,2,8,37.50,0,0,1,1,0.00
11837,BRA,17,Menezes Oliveira de Souza Ana Cristina ,OH,1,0,0,100.00,1,1,0,0,1,100.00,0,0,0,0, ,0,0,0,0, ,0,0,0,0, ,0,0,0, ,0,0,0,0, 
11837,BRA,18,Brait Camila ,L,0,0,0, ,0,0,0,0,0, ,0,0,0,0, ,0,0,0,0, ,4,0,8,12,33.33,11,3,14,57.14,0,0,0,0, 
11837,BRA,20,Correa Ana Beatriz ,MB,5,5,1,21.05,11,5,2,7,14,21.43,5,1,1,7,57.14,1,0,16,17,5.88,0,0,1,1,0.00,1,0,1,100.00,0,0,0,0, 
11837,BRA,24,Geraldo Teixeira Lorenne ,O,3,0,0,25.00,3,3,0,6,9,33.33,0,0,0,0, ,0,0,3,3,0.00,0,0,0,0, ,0,1,1,-100.00,0,0,0,0, 
11837,CAN,1,Bujan Cassandra ,L,0,0,0, ,0,0,0,0,0, ,0,0,0,0, ,0,0,0,0, ,2,1,14,17,5.88,3,3,6,0.00,0,1,10,11,-9.09
11837,CAN,3,Van Ryk Kiera ,OH,12,1,0,-6.12,13,12,12,14,38,0.00,1,1,0,2,0.00,0,3,6,9,-33.33,4,0,3,7,57.14,3,5,8,-25.00,0,0,3,3,0.00
11837,CAN,5,Smith Danielle ,S,0,0,0,-100.00,0,0,0,0,0, ,0,0,0,0, ,0,1,0,1,-100.00,0,0,0,0, ,0,0,0, ,0,0,0,0, 
11837,CAN,6,White Jazmine  Ruth ,MB,0,0,0,0.00,0,0,0,1,1,0.00,0,0,0,0, ,0,0,1,1,0.00,0,0,0,0, ,0,0,0, ,0,0,0,0, 
11837,CAN,7,Van Buskirk Layne ,MB,0,0,0, ,0,0,0,0,0, ,0,0,0,0, ,0,0,0,0, ,0,0,0,0, ,0,0,0, ,0,0,0,0, 
11837,CAN,9,Gray Alexa ,OH,0,0,0, ,0,0,0,0,0, ,0,0,0,0, ,0,0,0,0, ,0,0,0,0, ,0,0,0, ,0,0,0,0, 
11837,CAN,11,Mitrovic Andrea ,OH,8,0,0,-2.70,8,8,6,13,27,7.41,0,3,2,5,-60.00,0,0,5,5,0.00,9,2,24,35,20.00,2,0,2,100.00,0,0,0,0, 
11837,CAN,12,Cross Jennifer ,MB,6,1,1,2.78,8,6,2,5,13,30.77,1,4,2,7,-42.86,1,1,14,16,0.00,0,0,0,0, ,2,2,4,0.00,0,0,1,1,0.00
11837,CAN,13,King Brie ,S,0,1,0,-8.33,1,0,0,4,4,0.00,1,1,0,2,0.00,0,1,5,6,-16.67,0,0,0,0, ,9,3,13,46.15,0,1,44,45,-2.22
11837,CAN,14,Howe Hilary ,OH,9,0,0,-10.26,9,9,7,11,27,7.41,0,3,0,3,-100.00,0,3,6,9,-33.33,7,0,22,29,24.14,0,5,5,-100.00,0,0,0,0, 
11837,CAN,15,Joseph Shainah ,O,1,0,0,-14.29,1,1,2,6,9,-11.11,0,1,0,1,-100.00,0,0,4,4,0.00,0,0,0,0, ,6,2,8,50.00,0,0,0,0, 
11837,CAN,16,Livingston Caroline ,OH,0,0,0,-40.00,0,0,2,2,4,-50.00,0,0,0,0, ,0,0,1,1,0.00,2,0,2,4,50.00,1,0,1,100.00,0,0,0,0, 
11837,CAN,19,Maglio Emily ,MB,8,2,0,14.71,10,8,4,9,21,19.05,2,1,2,5,20.00,0,0,8,8,0.00,2,0,2,4,50.00,0,1,1,-100.00,0,0,0,0, 
11837,CAN,23,Austin Parker Jane ,OH,0,0,0, ,0,0,0,0,0, ,0,0,0,0, ,0,0,0,0, ,0,0,0,0, ,0,0,0, ,0,0,0,0, 
11838,NED,1,Knip Kirsten ,L,0,0,0, ,0,0,0,0,0, ,0,0,0,0, ,0,0,0,0, ,0,0,0,0, ,0,0,0, ,0,0,0,0, 
11838,NED,2,Savelkoel Fleur ,OH,0,0,0, ,0,0,0,0,0, ,0,0,0,0, ,0,0,0,0, ,0,0,0,0, ,0,0,0, ,0,0,0,0, 
11838,NED,8,Korevaar Demi ,MB,0,0,0,-33.33,0,0,0,0,0, ,0,0,0,0, ,0,1,2,3,-33.33,0,0,0,0, ,0,0,0, ,0,0,0,0, 
11838,NED,9,Schoot Myrthe ,L,0,0,0, ,0,0,0,0,0, ,0,0,0,0, ,0,0,0,0, ,12,3,27,42,21.43,18,0,18,100.00,0,0,6,6,0.00
11838,NED,10,van Aalen Sarah ,S,0,0,0, ,0,0,0,0,0, ,0,0,0,0, ,0,0,0,0, ,0,0,0,0, ,0,0,0, ,0,0,0,0, 
11838,NED,11,Buijs Anne ,OH,13,1,0,12.28,14,13,6,21,40,17.50,1,0,0,1,100.00,0,1,15,16,-6.25,13,3,19,35,28.57,9,1,10,80.00,0,0,0,0, 
11838,NED,12,Bongaerts Britt ,S,2,0,3,0.00,5,2,0,3,5,40.00,0,4,1,5,-80.00,3,1,14,18,11.11,0,0,0,0, ,7,0,7,100.00,33,0,103,136,24.26
11838,NED,16,Baijens Indy ,MB,10,3,0,20.00,13,10,0,6,16,62.50,3,4,0,7,-14.29,0,3,4,7,-42.86,0,0,0,0, ,1,0,1,100.00,0,0,0,0, 
11838,NED,18,Jasper Marrit ,OH,0,0,0,0.00,0,0,0,0,0, ,0,0,0,0, ,0,0,5,5,0.00,0,0,0,0, ,1,0,1,100.00,0,0,0,0, 
11838,NED,19,Daalderop Nika ,OH,21,3,1,21.13,25,21,5,20,46,34.78,3,1,0,4,50.00,1,4,16,21,-14.29,7,0,10,17,41.18,13,2,15,73.33,0,0,1,1,0.00
11838,NED,23,Timmerman Eline ,MB,7,1,1,2.27,9,7,4,10,21,14.29,1,2,2,5,-20.00,1,2,15,18,-5.56,0,0,1,1,0.00,5,0,5,100.00,0,0,1,1,0.00
11838,NED,24,de Zwart Laura ,MB,0,0,0, ,0,0,0,0,0, ,0,0,0,0, ,0,0,0,0, ,0,0,0,0, ,0,0,0, ,0,0,0,0, 
11838,NED,26,Dambrink Elles ,O,10,1,1,-6.00,12,10,8,9,27,7.41,1,2,0,3,-33.33,1,5,14,20,-20.00,0,0,1,1,0.00,5,2,7,42.86,0,1,0,1,-100.00
11838,NED,27,Scholten Iris ,O,0,0,0, ,0,0,0,0,0, ,0,0,0,0, ,0,0,0,0, ,0,0,0,0, ,0,0,0, ,0,0,0,0, 
11838,GER,1,Bock Linda ,L,0,0,0, ,0,0,0,0,0, ,0,0,0,0, ,0,0,0,0, ,0,0,0,0, ,0,0,0, ,0,0,0,0, 
11838,GER,2,KÃ¤stner Pia ,S,0,0,0,-11.11,0,0,1,2,3,-33.33,0,0,1,1,0.00,0,0,5,5,0.00,0,0,0,0, ,2,0,2,100.00,11,0,41,52,21.15
11838,GER,4,Imoudu Denise ,S,4,0,0,12.50,4,4,0,2,6,66.67,0,0,0,0, ,0,2,8,10,-20.00,0,0,0,0, ,3,3,6,0.00,23,1,58,82,26.83
11838,GER,5,Poll Jana Franziska ,OH,0,0,0,0.00,0,0,0,0,0, ,0,0,0,0, ,0,0,7,7,0.00,1,0,1,2,50.00,1,0,1,100.00,0,0,0,0, 
11838,GER,6,Janiska Jennifer ,OH,10,3,1,18.87,14,10,2,16,28,28.57,3,1,0,4,50.00,1,1,19,21,0.00,15,1,17,33,42.42,9,3,12,50.00,0,0,1,1,0.00
11838,GER,7,Vanjak Ivana ,OH,9,1,1,29.03,11,9,1,9,19,42.11,1,0,0,1,100.00,1,1,9,11,0.00,1,0,0,1,100.00,1,0,1,100.00,0,0,0,0, 
11838,GER,8,Drewniok Kimberly ,O,9,0,0,2.50,9,9,7,12,28,7.14,0,0,0,0, ,0,1,11,12,-8.33,0,0,0,0, ,5,0,5,100.00,0,0,0,0, 
11838,GER,9,Alsmeier Lina ,OH,14,2,2,17.24,18,14,3,25,42,26.19,2,0,0,2,100.00,2,5,7,14,-21.43,8,2,19,29,20.69,7,2,9,55.56,0,0,1,1,0.00
11838,GER,12,Orthmann Hanna ,OH,1,0,0,0.00,1,1,1,4,6,0.00,0,0,1,1,0.00,0,0,2,2,0.00,2,1,0,3,33.33,0,0,0, ,0,0,0,0, 
11838,GER,14,SchÃ¶lzel Marie ,MB,7,2,0,7.69,9,7,3,4,14,28.57,2,3,0,5,-20.00,0,1,6,7,-14.29,0,0,0,0, ,2,0,2,100.00,0,0,0,0, 
11838,GER,16,Ambrosius Lea ,MB,0,0,0, ,0,0,0,0,0, ,0,0,0,0, ,0,0,0,0, ,0,0,0,0, ,0,0,0, ,0,0,0,0, 
11838,GER,17,Pogany Anna ,L,0,0,0, ,0,0,0,0,0, ,0,0,0,0, ,0,0,0,0, ,11,2,10,23,39.13,20,3,24,70.83,0,0,8,8,0.00
11838,GER,20,Bock Josepha ,MB,0,0,0, ,0,0,0,0,0, ,0,0,0,0, ,0,0,0,0, ,0,0,0,0, ,0,0,0, ,0,0,0,0, 
11838,GER,21,Weitzel Camilla ,MB,8,1,2,-2.38,11,8,2,2,12,50.00,1,6,1,8,-62.50,2,4,16,22,-9.09,0,0,0,0, ,4,0,4,100.00,0,0,2,2,0.00
11839,THA,2,Pannoy Piyanut ,L,0,0,0, ,0,0,0,0,0, ,0,0,0,0, ,0,0,0,0, ,11,1,6,18,55.56,9,1,11,72.73,0,0,8,8,0.00
11839,THA,3,ManaKij Sirima ,S,0,0,0,0.00,0,0,0,0,0, ,0,0,0,0, ,0,0,1,1,0.00,0,0,0,0, ,3,0,3,100.00,2,0,12,14,14.29
11839,THA,5,Thinkaow Pleumjit ,MB,12,2,1,4.76,15,12,4,26,42,19.05,2,7,4,13,-38.46,1,1,6,8,0.00,0,0,0,0, ,3,0,4,75.00,0,0,2,2,0.00
11839,THA,6,Sittirak Onuma ,OH,8,0,0,-2.04,8,8,4,21,33,12.12,0,4,3,7,-57.14,0,1,8,9,-11.11,1,1,6,8,0.00,11,0,11,100.00,0,0,2,2,0.00
11839,THA,9,Chuewulim Sutadta ,OH,8,0,0,6.98,8,8,4,19,31,12.90,0,1,1,2,-50.00,0,0,10,10,0.00,7,2,12,21,23.81,13,3,20,50.00,0,0,0,0, 
11839,THA,10,Apinyapong Wilavan ,L,1,0,0,25.00,1,1,0,0,1,100.00,0,0,1,1,0.00,0,0,2,2,0.00,3,0,4,7,42.86,1,0,2,50.00,0,0,0,0, 
11839,THA,11,Hyapha Amporn ,MB,3,0,4,22.73,7,3,1,5,9,22.22,0,1,0,1,-100.00,4,0,8,12,33.33,0,0,0,0, ,1,3,4,-50.00,0,0,2,2,0.00
11839,THA,12,Chaisri Tapaphaipun ,L,0,0,0, ,0,0,0,0,0, ,0,0,0,0, ,0,0,0,0, ,2,0,2,4,50.00,4,4,9,0.00,0,0,1,1,0.00
11839,THA,13,Tomkom Nootsara ,S,2,0,0,0.00,2,2,0,1,3,66.67,0,2,0,2,-100.00,0,0,11,11,0.00,0,0,1,1,0.00,9,2,13,53.85,21,1,93,115,17.39
11839,THA,15,Kanthong Malika ,O,5,0,0,-2.78,5,5,2,13,20,15.00,0,2,2,4,-50.00,0,2,10,12,-16.67,6,0,11,17,35.29,8,3,11,45.45,0,0,2,2,0.00
11839,THA,17,Piampongsan Gullapa ,S,0,0,0, ,0,0,0,0,0, ,0,0,0,0, ,0,0,0,0, ,0,0,0,0, ,0,0,0, ,0,0,0,0, 
11839,THA,19,Krause Karina ,MB,4,1,0,15.79,5,4,0,4,8,50.00,1,2,2,5,-20.00,0,0,6,6,0.00,0,0,0,0, ,0,0,0, ,0,1,0,1,-100.00
11839,THA,22,Nilapa Chatsuda ,OH,0,0,0,-25.00,0,0,0,1,1,0.00,0,0,0,0, ,0,1,2,3,-33.33,1,1,2,4,0.00,1,1,2,0.00,0,0,0,0, 
11839,THA,24,Nuanjam Watchareeya ,MB,0,0,0, ,0,0,0,0,0, ,0,0,0,0, ,0,0,0,0, ,0,0,0,0, ,0,0,0, ,0,0,0,0, 
11839,KOR,1,Lee Soyoung ,OH,12,1,1,21.15,14,12,1,11,24,45.83,1,2,5,8,-12.50,1,0,19,20,5.00,17,5,14,36,33.33,14,1,16,81.25,0,0,1,1,0.00
11839,KOR,2,Lee Dahyeon ,MB,7,3,0,25.93,10,7,0,2,9,77.78,3,3,5,11,0.00,0,0,7,7,0.00,0,0,0,0, ,6,0,6,100.00,0,0,1,1,0.00
11839,KOR,3,Yeum Hye Seon ,S,0,0,0,0.00,0,0,0,0,0, ,0,0,0,0, ,0,0,4,4,0.00,0,0,0,0, ,2,1,3,33.33,5,0,9,14,35.71
11839,KOR,5,Han Dahye ,L,0,0,0, ,0,0,0,0,0, ,0,0,0,0, ,0,0,0,0, ,0,0,0,0, ,0,0,0, ,0,0,0,0, 
11839,KOR,7,An Hyejin ,S,1,2,1,4.35,4,1,0,0,1,100.00,2,2,5,9,0.00,1,1,11,13,0.00,0,0,0,0, ,7,1,10,60.00,34,2,84,120,26.67
11839,KOR,8,Park Eunjin ,MB,5,1,1,3.12,7,5,2,10,17,17.65,1,3,4,8,-25.00,1,1,5,7,0.00,0,0,0,0, ,1,1,3,0.00,0,0,2,2,0.00
11839,KOR,9,Oh Jiyoung ,L,0,0,0, ,0,0,0,0,0, ,0,0,0,0, ,0,0,0,0, ,10,0,8,18,55.56,19,1,21,85.71,0,0,2,2,0.00
11839,KOR,10,Kim Yeon Koung ,OH,0,0,0, ,0,0,0,0,0, ,0,0,0,0, ,0,0,0,0, ,0,0,0,0, ,0,0,0, ,0,0,0,0, 
11839,KOR,12,Han Songyi ,MB,0,0,0, ,0,0,0,0,0, ,0,0,0,0, ,0,0,0,0, ,0,0,0,0, ,0,0,0, ,0,0,0,0, 
11839,KOR,13,Park Jeongah ,OH,19,2,1,22.95,22,19,3,16,38,42.11,2,3,7,12,-8.33,1,2,8,11,-9.09,1,0,0,1,100.00,6,0,8,75.00,0,0,0,0, 
11839,KOR,14,Yang Hyo Jin ,MB,4,0,0,5.88,4,4,0,2,6,66.67,0,2,2,4,-50.00,0,1,6,7,-14.29,0,0,0,0, ,0,0,0, ,0,0,0,0, 
11839,KOR,15,Yuk Seoyoung ,OH,0,0,0,-33.33,0,0,0,0,0, ,0,0,0,0, ,0,2,4,6,-33.33,0,0,0,0, ,0,0,0, ,0,0,0,0, 
11839,KOR,16,Jeong Jiyun ,O,2,0,0,-10.00,2,2,2,4,8,0.00,0,0,1,1,0.00,0,1,0,1,-100.00,0,0,0,0, ,0,0,0, ,0,0,0,0, 
11839,KOR,19,Pyo Seungju ,OH,12,2,1,10.71,15,12,5,19,36,19.44,2,3,2,7,-14.29,1,1,11,13,0.00,6,0,8,14,42.86,16,1,17,88.24,0,0,0,0, 
11840,CHN,3,Diao Linyu ,S,2,1,0,5.26,3,2,0,1,3,66.67,1,1,1,3,0.00,0,1,12,13,-7.69,0,0,0,0, ,3,1,4,50.00,27,0,49,76,35.53
11840,CHN,4,Yang Hanyu ,MB,2,3,0,5.26,5,2,0,5,7,28.57,3,4,0,7,-14.29,0,0,5,5,0.00,0,0,0,0, ,0,0,0, ,0,0,0,0, 
11840,CHN,5,Gao Yi ,MB,0,0,0, ,0,0,0,0,0, ,0,0,0,0, ,0,0,0,0, ,0,0,0,0, ,0,0,0, ,0,0,0,0, 
11840,CHN,7,Wang Yuanyuan ,MB,6,1,0,27.27,7,6,0,8,14,42.86,1,0,0,1,100.00,0,1,6,7,-14.29,0,1,0,1,-100.00,1,0,1,100.00,0,0,1,1,0.00
11840,CHN,8,Li Yao ,OH,5,1,0,3.70,6,5,2,9,16,18.75,1,3,0,4,-50.00,0,0,7,7,0.00,0,0,1,1,0.00,2,0,2,100.00,0,1,0,1,-100.00
11840,CHN,9,Zhang Changning ,OH,0,0,0,-33.33,0,0,2,4,6,-33.33,0,0,0,0, ,0,0,0,0, ,0,0,0,0, ,0,0,0, ,0,0,0,0, 
11840,CHN,10,Liu Xiaotong ,OH,4,0,0,0.00,4,4,1,5,10,30.00,0,2,0,2,-100.00,0,1,3,4,-25.00,7,2,8,17,29.41,1,3,4,-50.00,0,0,1,1,0.00
11840,CHN,11,Yao Di ,S,0,0,0, ,0,0,0,0,0, ,0,0,0,0, ,0,0,0,0, ,0,0,0,0, ,1,1,2,0.00,0,0,9,9,0.00
11840,CHN,14,Zheng Yixin ,MB,1,0,0,-12.50,1,1,2,3,6,-16.67,0,0,1,1,0.00,0,0,1,1,0.00,0,0,0,0, ,1,0,1,100.00,0,0,0,0, 
11840,CHN,15,Lin Li ,L,0,0,0, ,0,0,0,0,0, ,0,0,0,0, ,0,0,0,0, ,0,0,0,0, ,0,0,0, ,0,0,0,0, 
11840,CHN,18,Wang Mengjie ,L,0,0,0, ,0,0,0,0,0, ,0,0,0,0, ,0,0,0,0, ,10,1,8,19,47.37,7,2,9,55.56,0,0,3,3,0.00
11840,CHN,19,Liu Yanhan ,OH,6,3,0,11.11,9,6,3,14,23,13.04,3,1,0,4,50.00,0,1,8,9,-11.11,5,2,16,23,13.04,7,1,8,75.00,0,0,0,0, 
11840,CHN,22,Duan Fang ,OH,3,0,0,25.00,3,3,0,5,8,37.50,0,0,0,0, ,0,0,4,4,0.00,1,1,5,7,0.00,1,0,1,100.00,0,0,0,0, 
11840,JPN,1,Kurogo Ai ,OH,16,0,1,27.27,17,16,3,16,35,37.14,0,0,0,0, ,1,2,6,9,-11.11,1,0,3,4,25.00,9,0,9,100.00,0,0,0,0, 
11840,JPN,2,Koga Sarina ,OH,11,0,2,16.67,13,11,5,11,27,22.22,0,0,1,1,0.00,2,1,11,14,7.14,11,0,9,20,55.00,10,1,11,81.82,0,0,0,0, 
11840,JPN,3,Shimamura Haruyo ,MB,7,0,0,12.50,7,7,0,5,12,58.33,0,2,2,4,-50.00,0,1,15,16,-6.25,0,0,0,0, ,2,1,3,33.33,0,0,0,0, 
11840,JPN,5,Araki Erika ,MB,3,1,2,3.45,6,3,1,7,11,18.18,1,4,1,6,-50.00,2,0,10,12,16.67,0,0,0,0, ,1,0,1,100.00,0,0,1,1,0.00
11840,JPN,7,Ishii Yuki ,OH,0,0,0,0.00,0,0,0,0,0, ,0,0,0,0, ,0,0,1,1,0.00,0,0,0,0, ,0,0,0, ,0,0,0,0, 
11840,JPN,8,Ishikawa Mayu ,OH,15,1,2,34.15,18,15,3,10,28,42.86,1,0,0,1,100.00,2,1,9,12,8.33,13,0,6,19,68.42,8,1,9,77.78,0,0,2,2,0.00
11840,JPN,9,Tashiro Kanami ,S,0,0,0, ,0,0,0,0,0, ,0,0,0,0, ,0,0,0,0, ,0,0,0,0, ,0,0,0, ,0,0,0,0, 
11840,JPN,13,Okumura Mai ,MB,0,0,0, ,0,0,0,0,0, ,0,0,0,0, ,0,0,0,0, ,0,0,0,0, ,0,0,0, ,0,0,0,0, 
11840,JPN,14,Kobata Mako ,L,0,0,0, ,0,0,0,0,0, ,0,0,0,0, ,0,0,0,0, ,2,0,1,3,66.67,14,5,19,47.37,1,0,5,6,16.67
11840,JPN,15,Inoue Kotoe ,L,0,0,0, ,0,0,0,0,0, ,0,0,0,0, ,0,0,0,0, ,0,0,0,0, ,0,0,0, ,0,0,0,0, 
11840,JPN,19,Yamada Nichika ,MB,0,0,0, ,0,0,0,0,0, ,0,0,0,0, ,0,0,0,0, ,0,0,0,0, ,0,0,0, ,0,0,0,0, 
11840,JPN,20,Seki Nanami ,S,0,0,0, ,0,0,0,0,0, ,0,0,0,0, ,0,0,0,0, ,0,0,0,0, ,0,0,0, ,0,0,0,0, 
11840,JPN,21,Hayashi Kotona ,OH,0,0,0,0.00,0,0,0,0,0, ,0,0,0,0, ,0,0,1,1,0.00,0,0,0,0, ,0,0,0, ,0,0,0,0, 
11840,JPN,24,Momii Aki ,S,1,1,0,-6.25,2,1,0,3,4,25.00,1,2,0,3,-33.33,0,1,8,9,-11.11,0,0,0,0, ,6,1,7,71.43,43,1,61,105,40.00
11841,BEL,3,Herbots Britt ,OH,27,0,2,11.70,29,27,13,28,68,20.59,0,4,2,6,-66.67,2,1,17,20,5.00,6,0,7,13,46.15,15,3,20,60.00,0,0,3,3,0.00
11841,BEL,4,Lemmens Nathalie ,MB,0,1,0,0.00,1,0,0,2,2,0.00,1,1,2,4,0.00,0,0,12,12,0.00,0,0,0,0, ,3,0,3,100.00,0,0,0,0, 
11841,BEL,5,Guilliams Jodie ,OH,7,0,0,-13.04,7,7,8,9,24,-4.17,0,4,5,9,-44.44,0,1,12,13,-7.69,3,1,7,11,18.18,5,0,6,83.33,0,0,0,0, 
11841,BEL,6,Gilson Helena ,OH,2,0,0,25.00,2,2,1,1,4,25.00,0,0,0,0, ,0,0,0,0, ,0,0,0,0, ,0,0,0, ,0,0,0,0, 
11841,BEL,7,Van Gestel Celine ,OH,9,0,0,2.38,9,9,6,10,25,12.00,0,1,3,4,-25.00,0,1,12,13,-7.69,15,1,22,38,36.84,15,5,20,50.00,0,0,2,2,0.00
11841,BEL,9,Demeyer Nel ,L,0,0,0, ,0,0,0,0,0, ,0,0,0,0, ,0,0,0,0, ,0,0,1,1,0.00,0,0,0, ,0,0,0,0, 
11841,BEL,10,Sobolska Dominika ,MB,5,6,0,-2.13,11,5,2,9,16,18.75,6,8,12,26,-7.69,0,2,3,5,-40.00,0,0,0,0, ,2,0,2,100.00,0,0,0,0, 
11841,BEL,12,Krenicky Charlotte ,S,0,0,0, ,0,0,0,0,0, ,0,0,0,0, ,0,0,0,0, ,0,0,0,0, ,0,0,0, ,0,0,0,0, 
11841,BEL,13,Janssens Marlies ,MB,0,0,0, ,0,0,0,0,0, ,0,0,0,0, ,0,0,0,0, ,0,0,0,0, ,0,0,0, ,0,0,0,0, 
11841,BEL,15,Van De Vyver Jutta ,S,0,0,0, ,0,0,0,0,0, ,0,0,0,0, ,0,0,0,0, ,0,0,0,0, ,0,0,1,0.00,0,0,3,3,0.00
11841,BEL,17,Van De Vyver Ilka ,S,2,0,0,-11.54,2,2,0,2,4,50.00,0,4,4,8,-50.00,0,1,13,14,-7.14,0,0,0,0, ,12,1,16,68.75,26,1,120,147,17.01
11841,BEL,18,Rampelberg Britt ,L,0,0,0, ,0,0,0,0,0, ,0,0,0,0, ,0,0,0,0, ,10,2,20,32,25.00,16,2,20,70.00,0,0,6,6,0.00
11841,BEL,19,Van Avermaet Silke ,MB,6,1,1,-12.50,8,6,2,12,20,20.00,1,10,6,17,-52.94,1,2,8,11,-9.09,0,0,0,0, ,2,1,4,25.00,0,0,1,1,0.00
11841,BEL,21,Stragier Manon ,OH,1,0,0,0.00,1,1,0,3,4,25.00,0,0,0,0, ,0,1,8,9,-11.11,0,0,0,0, ,4,0,4,100.00,0,0,0,0, 
11841,RUS,2,Malygina Daria ,O,0,0,0,-40.00,0,0,0,1,1,0.00,0,1,2,3,-33.33,0,1,0,1,-100.00,0,0,0,0, ,0,0,0, ,0,0,0,0, 
11841,RUS,4,Pilipenko Daria ,L,0,0,0, ,0,0,0,0,0, ,0,0,0,0, ,0,0,0,0, ,3,0,5,8,37.50,5,3,8,25.00,0,0,6,6,0.00
11841,RUS,5,Fedorovtseva Arina ,OH,10,0,0,16.22,10,10,3,7,20,35.00,0,0,2,2,0.00,0,1,14,15,-6.67,4,3,14,21,4.76,4,1,6,50.00,0,0,0,0, 
11841,RUS,6,Koroleva Irina ,MB,7,4,0,9.76,11,7,2,5,14,35.71,4,5,8,17,-5.88,0,0,10,10,0.00,0,0,0,0, ,8,0,8,100.00,0,0,0,0, 
11841,RUS,8,Goncharova Nataliya ,O,20,3,1,24.29,24,20,5,23,48,31.25,3,1,3,7,28.57,1,1,13,15,0.00,0,0,0,0, ,10,0,12,83.33,0,0,1,1,0.00
11841,RUS,9,Gorbunova Valeriia ,O,0,0,0,0.00,0,0,0,3,3,0.00,0,0,0,0, ,0,0,1,1,0.00,0,0,1,1,0.00,1,0,1,100.00,0,0,0,0, 
11841,RUS,10,Matveeva Polina ,S,0,0,0,0.00,0,0,0,0,0, ,0,0,1,1,0.00,0,0,0,0, ,0,0,0,0, ,0,0,0, ,0,0,16,16,0.00
11841,RUS,11,Brovkina Yulia ,MB,0,0,0,-50.00,0,0,1,0,1,-100.00,0,0,0,0, ,0,0,1,1,0.00,0,0,0,0, ,0,0,0, ,0,0,0,0, 
11841,RUS,13,Startseva Evgeniya ,S,2,0,1,-19.05,3,2,2,0,4,0.00,0,4,2,6,-66.67,1,1,9,11,0.00,0,0,1,1,0.00,12,4,18,44.44,9,1,110,120,6.67
11841,RUS,14,Fetisova Irina ,MB,1,2,0,-13.33,3,1,1,2,4,0.00,2,4,3,9,-22.22,0,2,15,17,-11.76,1,0,0,1,100.00,2,1,5,20.00,0,0,0,0, 
11841,RUS,15,Kosheleva Tatyana ,OH,6,6,0,16.67,12,6,2,11,19,21.05,6,2,7,15,26.67,0,1,7,8,-12.50,6,0,8,14,42.86,7,1,12,50.00,0,0,1,1,0.00
11841,RUS,16,Voronkova Irina ,OH,16,0,1,6.35,17,16,3,18,37,35.14,0,6,2,8,-75.00,1,4,13,18,-16.67,13,0,24,37,35.14,9,2,12,58.33,0,0,1,1,0.00
11841,RUS,22,Zaytseva Tamara ,L,0,0,0, ,0,0,0,0,0, ,0,0,0,0, ,0,0,0,0, ,2,0,1,3,66.67,4,0,4,100.00,0,0,2,2,0.00
11841,RUS,23,Kapustina Irina ,OH,1,0,1,0.00,2,1,0,0,1,100.00,0,0,0,0, ,1,2,8,11,-9.09,0,0,2,2,0.00,2,0,3,66.67,0,0,0,0, 
11842,SRB,2,Lazovic Katarina ,OH,17,1,0,10.94,18,17,3,18,38,36.84,1,4,0,5,-60.00,0,4,17,21,-19.05,7,3,22,32,12.50,4,2,7,28.57,0,0,3,3,0.00
11842,SRB,3,Caric Sara ,O,19,2,0,30.61,21,19,3,13,35,45.71,2,2,1,5,0.00,0,1,8,9,-11.11,0,0,0,0, ,5,2,7,42.86,0,0,1,1,0.00
11842,SRB,6,Uzelac Aleksandra ,OH,0,0,0, ,0,0,0,0,0, ,0,0,0,0, ,0,0,0,0, ,0,0,0,0, ,0,0,0, ,0,0,0,0, 
11842,SRB,7,Jaksic Ana ,S,1,1,0,-11.76,2,1,0,0,1,100.00,1,2,0,3,-33.33,0,2,11,13,-15.38,0,0,0,0, ,4,1,5,60.00,10,1,90,101,8.91
11842,SRB,21,Kocic Jovana ,MB,3,6,0,11.11,9,3,0,2,5,60.00,6,4,4,14,14.29,0,1,16,17,-5.88,0,0,1,1,0.00,3,0,3,100.00,0,0,0,0, 
11842,SRB,22,Lozo Sara ,O,13,0,0,1.96,13,13,6,12,31,22.58,0,5,1,6,-83.33,0,1,13,14,-7.14,6,1,14,21,23.81,12,1,14,78.57,0,0,4,4,0.00
11842,SRB,23,Djordjevic Mila ,S,0,0,0,-100.00,0,0,0,0,0, ,0,0,0,0, ,0,1,0,1,-100.00,0,0,0,0, ,0,0,0, ,0,1,8,9,-11.11
11842,SRB,24,Medic Sofija ,MB,0,0,0,-28.57,0,0,1,3,4,-25.00,0,1,0,1,-100.00,0,0,2,2,0.00,0,0,1,1,0.00,0,0,0, ,0,0,0,0, 
11842,SRB,25,Markovic Bozica ,MB,5,1,3,15.38,9,5,1,0,6,66.67,1,4,0,5,-60.00,3,0,12,15,20.00,0,0,0,0, ,1,0,1,100.00,0,0,0,0, 
11842,SRB,26,Savic Vanja ,O,0,0,0,-40.00,0,0,1,2,3,-33.33,0,0,1,1,0.00,0,1,0,1,-100.00,0,0,0,0, ,1,0,1,100.00,0,0,0,0, 
11842,SRB,28,Delic Jelena ,MB,0,0,0, ,0,0,0,0,0, ,0,0,0,0, ,0,0,0,0, ,0,0,0,0, ,0,0,0, ,0,0,0,0, 
11842,SRB,31,Djurdjevic Sanja ,L,0,0,0, ,0,0,0,0,0, ,0,0,0,0, ,0,0,0,0, ,3,1,13,17,11.76,25,3,28,78.57,0,0,4,4,0.00
11842,SRB,32,Gocanin Bojana ,L,0,0,0, ,0,0,0,0,0, ,0,0,0,0, ,0,0,0,0, ,0,0,0,0, ,0,0,0, ,0,0,0,0, 
11842,SRB,34,Mirosavljevic Jovana ,OH,0,0,0,-100.00,0,0,0,0,0, ,0,0,0,0, ,0,1,0,1,-100.00,0,0,0,0, ,0,0,0, ,0,0,0,0, 
11842,POL,1,Nowicka Julia ,S,1,2,0,0.00,3,1,1,2,4,0.00,2,2,3,7,0.00,0,0,8,8,0.00,0,0,1,1,0.00,1,2,4,-25.00,10,1,50,61,14.75
11842,POL,3,Alagierska Klaudia ,MB,0,0,0,-11.11,0,0,0,3,3,0.00,0,1,0,1,-100.00,0,0,5,5,0.00,0,0,0,0, ,0,0,0, ,0,0,1,1,0.00
11842,POL,5,Kakolewska Agnieszka ,MB,7,1,1,10.00,9,7,2,8,17,29.41,1,3,0,4,-50.00,1,1,7,9,0.00,2,0,0,2,100.00,1,2,3,-33.33,0,0,1,1,0.00
11842,POL,8,Stenzel Maria ,L,0,0,0, ,0,0,0,0,0, ,0,0,0,0, ,0,0,0,0, ,18,0,14,32,56.25,5,3,8,25.00,0,0,8,8,0.00
11842,POL,9,Stysiak Magdalena ,O,10,1,4,5.26,15,10,9,13,32,3.12,1,0,2,3,33.33,4,3,15,22,4.55,3,0,6,9,33.33,9,0,9,100.00,0,0,1,1,0.00
11842,POL,10,Efimienko-Mlotkowska Zuzanna ,MB,4,0,0,8.33,4,4,0,1,5,80.00,0,1,0,1,-100.00,0,2,4,6,-33.33,0,0,0,0, ,2,0,2,100.00,0,0,1,1,0.00
11842,POL,11,Lukasik Martyna ,O,0,0,0,0.00,0,0,0,1,1,0.00,0,0,0,0, ,0,0,0,0, ,1,1,1,3,0.00,0,0,0, ,0,0,0,0, 
11842,POL,13,Jagla Monika ,L,0,0,0, ,0,0,0,0,0, ,0,0,0,0, ,0,0,0,0, ,0,0,0,0, ,11,5,16,37.50,0,0,1,1,0.00
11842,POL,17,Smarzek Malwina ,O,10,0,0,10.53,10,10,2,12,24,33.33,0,3,2,5,-60.00,0,1,8,9,-11.11,0,0,1,1,0.00,8,1,9,77.78,0,0,1,1,0.00
11842,POL,19,Fedusio Monika ,OH,5,0,0,3.85,5,5,2,8,15,20.00,0,2,1,3,-66.67,0,0,8,8,0.00,9,1,7,17,47.06,5,2,7,42.86,0,0,0,0, 
11842,POL,20,Czyrnianska Martyna ,OH,3,0,0,33.33,3,3,1,1,5,40.00,0,0,0,0, ,0,0,1,1,0.00,0,0,0,0, ,0,1,1,-100.00,0,0,0,0, 
11842,POL,27,Åazowska Martyna ,S,2,0,0,-7.69,2,2,1,0,3,33.33,0,2,1,3,-66.67,0,0,7,7,0.00,0,0,0,0, ,2,3,5,-20.00,4,2,40,46,4.35
11842,POL,30,Rozanski Olivia ,OH,0,0,0, ,0,0,0,0,0, ,0,0,0,0, ,0,0,0,0, ,0,0,0,0, ,0,0,0, ,0,0,0,0, 
11842,POL,88,Gorecka Zuzanna ,OH,2,0,0,-29.17,2,2,4,8,14,-14.29,0,4,1,5,-80.00,0,1,4,5,-20.00,5,1,11,17,23.53,2,1,3,33.33,0,0,0,0, 
11843,BRA,2,De Oliveira Saad Gattaz Caroline ,MB,7,3,0,17.65,10,7,1,6,14,42.86,3,3,2,8,0.00,0,0,12,12,0.00,0,0,0,0, ,2,0,2,100.00,0,0,0,0, 
11843,BRA,6,Alexandre Costa Nunes Nyeme Victoria ,L,0,0,0, ,0,0,0,0,0, ,0,0,0,0, ,0,0,0,0, ,0,0,0,0, ,0,0,0, ,0,0,0,0, 
11843,BRA,8,Silva Carneiro Macris Fernanda ,S,0,3,0,6.25,3,0,0,2,2,0.00,3,1,2,6,33.33,0,1,7,8,-12.50,0,0,0,0, ,0,0,0, ,12,0,63,75,16.00
11843,BRA,9,Ratzke Roberta Silva ,S,0,0,0,-20.00,0,0,0,0,0, ,0,0,0,0, ,0,1,4,5,-20.00,0,0,0,0, ,0,0,0, ,0,0,14,14,0.00
11843,BRA,10,Braga Guimaraes Gabriela ,OH,12,0,0,16.67,12,12,1,11,24,45.83,0,2,1,3,-66.67,0,3,6,9,-33.33,13,1,6,20,60.00,2,0,2,100.00,0,0,0,0, 
11843,BRA,11,Caixeta Tandara ,OH,14,0,0,28.12,14,14,4,4,22,45.45,0,0,0,0, ,0,1,9,10,-10.00,0,0,0,0, ,4,0,4,100.00,0,0,0,0, 
11843,BRA,13,Castro De Paula Blassioli Sheilla ,O,2,0,0,33.33,2,2,0,3,5,40.00,0,0,0,0, ,0,0,1,1,0.00,0,0,0,0, ,0,0,0, ,0,0,0,0, 
11843,BRA,15,Da Silva Ana Carolina ,MB,0,0,0, ,0,0,0,0,0, ,0,0,0,0, ,0,0,0,0, ,0,0,0,0, ,0,0,0, ,0,0,0,0, 
11843,BRA,16,Rodrigues Fernanda ,OH,11,1,2,27.50,14,11,1,9,21,47.62,1,1,2,4,0.00,2,1,12,15,6.67,6,0,7,13,46.15,1,1,3,0.00,0,0,0,0, 
11843,BRA,17,Menezes Oliveira de Souza Ana Cristina ,OH,1,0,0,100.00,1,1,0,0,1,100.00,0,0,0,0, ,0,0,0,0, ,1,0,0,1,100.00,0,0,0, ,0,0,0,0, 
11843,BRA,18,Brait Camila ,L,0,0,0, ,0,0,0,0,0, ,0,0,0,0, ,0,0,0,0, ,8,0,5,13,61.54,6,1,7,71.43,0,0,2,2,0.00
11843,BRA,20,Correa Ana Beatriz ,MB,0,0,0, ,0,0,0,0,0, ,0,0,0,0, ,0,0,0,0, ,0,0,0,0, ,0,0,0, ,0,0,0,0, 
11843,BRA,24,Geraldo Teixeira Lorenne ,O,0,0,0, ,0,0,0,0,0, ,0,0,0,0, ,0,0,0,0, ,0,0,0,0, ,0,0,0, ,0,0,0,0, 
11843,BRA,28,Araujo De Souza Mayany Cristina ,MB,2,1,0,-18.18,3,2,2,2,6,0.00,1,2,0,3,-33.33,0,3,10,13,-23.08,0,0,0,0, ,0,0,0, ,0,0,0,0, 
11843,DOM,1,Vargas Valdez Annerys Victoria ,MB,2,0,0,-11.76,2,2,2,6,10,0.00,0,1,2,3,-33.33,0,1,3,4,-25.00,0,0,0,0, ,1,0,1,100.00,0,0,0,0, 
11843,DOM,3,Eve Mejia Lisvel Elisa ,U,2,2,0,9.09,4,2,2,0,4,0.00,2,0,1,3,66.67,0,1,3,4,-25.00,3,0,4,7,42.86,0,2,2,-100.00,0,0,0,0, 
11843,DOM,5,Castillo Brenda ,L,0,0,0, ,0,0,0,0,0, ,0,0,0,0, ,0,0,0,0, ,10,0,5,15,66.67,5,0,6,83.33,0,0,10,10,0.00
11843,DOM,7,Marte Frica Niverka Dharlenis ,S,1,0,0,9.09,1,1,0,0,1,100.00,0,0,1,1,0.00,0,0,9,9,0.00,0,0,0,0, ,2,0,2,100.00,2,0,82,84,2.38
11843,DOM,11,Rodriguez Marifranchi ,MB,0,0,0, ,0,0,0,0,0, ,0,0,0,0, ,0,0,0,0, ,0,0,0,0, ,0,0,0, ,0,0,0,0, 
11843,DOM,12,Perez Flores Yokaty ,S,0,0,0, ,0,0,0,0,0, ,0,0,0,0, ,0,0,0,0, ,0,0,0,0, ,0,0,0, ,0,0,0,0, 
11843,DOM,14,Rivera Brens Prisilla ,OH,4,0,0,11.11,4,4,1,7,12,25.00,0,1,1,2,-50.00,0,0,4,4,0.00,0,1,13,14,-7.14,0,1,1,-100.00,0,0,0,0, 
11843,DOM,16,PeÃ±a Isabel Yonkaira Paola ,OH,5,0,0,6.25,5,5,3,3,11,18.18,0,0,1,1,0.00,0,1,3,4,-25.00,3,0,7,10,30.00,2,0,2,100.00,0,0,0,0, 
11843,DOM,17,Mambru Casilla Gina Altagracia ,O,2,0,0,50.00,2,2,0,0,2,100.00,0,0,0,0, ,0,0,2,2,0.00,0,0,0,0, ,0,0,0, ,0,0,0,0, 
11843,DOM,18,De La Cruz De PeÃ±a Bethania ,OH,5,0,0,-11.11,5,5,7,14,26,-7.69,0,1,0,1,-100.00,0,1,8,9,-11.11,2,1,14,17,5.88,1,0,1,100.00,0,0,3,3,0.00
11843,DOM,20,Martinez Brayelin Elizabeth ,OH,0,0,0, ,0,0,0,0,0, ,0,0,0,0, ,0,0,0,0, ,0,0,0,0, ,0,0,0, ,0,0,0,0, 
11843,DOM,21,Martinez Jineiry ,MB,4,2,0,8.33,6,4,0,5,9,44.44,2,3,0,5,-20.00,0,1,9,10,-10.00,0,0,0,0, ,2,0,2,100.00,0,0,1,1,0.00
11843,DOM,23,Gonzalez Lopez Gaila Ceneida ,O,5,0,1,-6.45,6,5,4,12,21,4.76,0,4,0,4,-100.00,1,0,5,6,16.67,0,0,0,0, ,5,1,6,66.67,0,0,0,0, 
11843,DOM,25,Martinez Caro Larysmer ,OH,0,0,0, ,0,0,0,0,0, ,0,0,0,0, ,0,0,0,0, ,0,0,0,0, ,0,0,0, ,0,0,0,0, 
11844,TUR,2,Akoz Simge Sebnem ,L,0,0,0, ,0,0,0,0,0, ,0,0,0,0, ,0,0,0,0, ,5,0,3,8,62.50,7,4,11,27.27,0,0,1,1,0.00
11844,TUR,3,Ãzbay Cansu ,S,0,0,1,-26.67,1,0,0,0,0, ,0,1,0,1,-100.00,1,4,9,14,-21.43,0,0,0,0, ,2,2,4,0.00,16,0,52,68,23.53
11844,TUR,4,Senoglu Tugba ,OH,0,0,0, ,0,0,0,0,0, ,0,0,0,0, ,0,0,0,0, ,0,0,0,0, ,0,0,0, ,0,0,0,0, 
11844,TUR,5,Ercan Seyma ,OH,0,0,0,0.00,0,0,0,0,0, ,0,0,0,0, ,0,0,3,3,0.00,0,0,0,0, ,0,0,0, ,0,0,0,0, 
11844,TUR,6,Caliskan Kubra ,MB,0,0,0, ,0,0,0,0,0, ,0,0,0,0, ,0,0,0,0, ,0,0,0,0, ,0,0,0, ,0,0,0,0, 
11844,TUR,7,Baladin Hande ,OH,9,2,1,31.03,12,9,1,6,16,50.00,2,1,0,3,33.33,1,1,8,10,0.00,8,1,9,18,38.89,0,2,2,-100.00,0,0,0,0, 
11844,TUR,8,Guveli Yasemin ,MB,0,0,0, ,0,0,0,0,0, ,0,0,0,0, ,0,0,0,0, ,0,0,0,0, ,0,0,0, ,0,0,0,0, 
11844,TUR,9,Ismailoglu Meliha ,OH,5,1,0,30.00,6,5,0,3,8,62.50,1,0,1,2,50.00,0,0,10,10,0.00,10,0,6,16,62.50,9,3,12,50.00,0,0,1,1,0.00
11844,TUR,10,Aykac Ayca ,L,0,0,0, ,0,0,0,0,0, ,0,0,0,0, ,0,0,0,0, ,0,0,0,0, ,0,0,0, ,0,0,0,0, 
11844,TUR,11,Aydemir Akyol Naz ,S,0,0,0, ,0,0,0,0,0, ,0,0,0,0, ,0,0,0,0, ,0,0,0,0, ,0,0,0, ,0,0,0,0, 
11844,TUR,13,Boz Meryem ,O,0,0,0, ,0,0,0,0,0, ,0,0,0,0, ,0,0,0,0, ,0,0,0,0, ,0,0,0, ,0,0,0,0, 
11844,TUR,14,Erdem DÃ¼ndar Eda ,MB,11,0,1,19.35,12,11,0,4,15,73.33,0,4,1,5,-80.00,1,2,8,11,-9.09,0,0,0,0, ,0,0,0, ,0,0,0,0, 
11844,TUR,19,Kalac Asli ,MB,11,0,0,36.36,11,11,0,2,13,84.62,0,1,0,1,-100.00,0,2,6,8,-25.00,0,0,0,0, ,0,0,0, ,0,0,0,0, 
11844,TUR,99,Karakurt Ebrar ,OH,7,2,2,4.55,11,7,2,9,18,27.78,2,4,3,9,-22.22,2,3,12,17,-5.88,0,0,0,0, ,7,1,9,66.67,0,0,0,0, 
11844,ITA,2,Bosio Francesca ,S,1,0,1,28.57,2,1,0,0,1,100.00,0,0,0,0, ,1,0,5,6,16.67,0,0,0,0, ,1,2,3,-33.33,6,0,40,46,13.04
11844,ITA,4,Bonifacio Sara ,MB,0,0,0, ,0,0,0,0,0, ,0,0,0,0, ,0,0,0,0, ,0,0,0,0, ,0,0,0, ,0,0,0,0, 
11844,ITA,12,Guerra Anastasia ,OH,5,0,0,0.00,5,5,2,3,10,30.00,0,2,0,2,-100.00,0,1,3,4,-25.00,6,3,10,19,15.79,3,0,3,100.00,0,0,0,0, 
11844,ITA,15,Nwakalor Sylvia Chinelo ,O,9,0,0,12.50,9,9,3,7,19,31.58,0,1,0,1,-100.00,0,2,2,4,-50.00,0,0,0,0, ,3,5,8,-25.00,0,0,2,2,0.00
11844,ITA,19,Mingardi Camilla ,OH,6,0,0,0.00,6,6,4,4,14,14.29,0,0,0,0, ,0,2,4,6,-33.33,0,0,0,0, ,3,0,3,100.00,0,0,0,0, 
11844,ITA,21,Lubian Marina ,MB,4,0,0,-17.65,4,4,2,1,7,28.57,0,1,0,1,-100.00,0,4,5,9,-44.44,0,0,0,0, ,1,1,2,0.00,0,0,2,2,0.00
11844,ITA,23,De Bortoli Chiara ,L,0,0,0, ,0,0,0,0,0, ,0,0,0,0, ,0,0,0,0, ,0,1,2,3,-33.33,0,1,1,-100.00,0,0,0,0, 
11844,ITA,24,Mazzaro Alessia ,MB,1,0,0,-21.05,1,1,1,3,5,0.00,0,4,1,5,-80.00,0,0,9,9,0.00,0,0,0,0, ,1,0,2,50.00,0,0,0,0, 
11844,ITA,26,Battistoni Ilaria ,S,0,0,0,-50.00,0,0,0,0,0, ,0,1,0,1,-100.00,0,0,1,1,0.00,0,0,0,0, ,1,0,1,100.00,5,0,17,22,22.73
11844,ITA,27,Furlan Eleonora ,MB,0,0,0,0.00,0,0,0,0,0, ,0,0,0,0, ,0,0,1,1,0.00,0,0,0,0, ,0,0,0, ,0,0,0,0, 
11844,ITA,28,Melli Giulia ,OH,1,0,0,50.00,1,1,0,0,1,100.00,0,0,0,0, ,0,0,1,1,0.00,0,0,2,2,0.00,0,0,0, ,0,0,0,0, 
11844,ITA,29,D'Odorico Sofia ,OH,6,0,0,0.00,6,6,3,7,16,18.75,0,0,0,0, ,0,3,6,9,-33.33,5,1,7,13,30.77,1,0,1,100.00,0,0,1,1,0.00
11844,ITA,31,Fersino Eleonora ,L,0,0,0, ,0,0,0,0,0, ,0,0,0,0, ,0,0,0,0, ,2,0,7,9,22.22,8,5,13,23.08,0,0,4,4,0.00
11844,ITA,32,Omoruyi Oghosasere Loveth ,OH,2,1,0,18.18,3,2,0,3,5,40.00,1,1,0,2,0.00,0,0,4,4,0.00,6,0,9,15,40.00,4,0,4,100.00,0,0,2,2,0.00
11845,USA,2,Poulter Jordyn ,S,0,0,0, ,0,0,0,0,0, ,0,0,0,0, ,0,0,0,0, ,0,0,0,0, ,0,0,0, ,0,0,0,0, 
11845,USA,3,Plummer Kathryn ,OH,8,1,2,10.26,11,8,4,13,25,16.00,1,0,0,1,100.00,2,3,8,13,-7.69,11,0,23,34,32.35,3,0,3,100.00,0,0,0,0, 
11845,USA,4,Wong-Orantes Justine ,L,0,0,0, ,0,0,0,0,0, ,0,0,0,0, ,0,0,0,0, ,3,0,3,6,50.00,17,0,17,100.00,0,0,6,6,0.00
11845,USA,6,Dixon Tetori ,MB,5,2,0,10.71,7,5,0,6,11,45.45,2,1,2,5,20.00,0,3,9,12,-25.00,0,0,0,0, ,1,0,1,100.00,0,0,0,0, 
11845,USA,7,Carlini Lauren ,S,2,2,2,17.39,6,2,0,1,3,66.67,2,2,0,4,0.00,2,0,14,16,12.50,0,0,0,0, ,1,0,1,100.00,3,0,92,95,3.16
11845,USA,8,Tapp Hannah ,MB,6,1,0,31.82,7,6,0,4,10,60.00,1,0,0,1,100.00,0,0,11,11,0.00,0,0,0,0, ,0,0,0, ,0,0,0,0, 
11845,USA,10,Larson Jordan ,OH,0,0,0, ,0,0,0,0,0, ,0,0,0,0, ,0,0,0,0, ,0,0,0,0, ,0,0,0, ,0,0,0,0, 
11845,USA,11,Drews Andrea ,O,19,1,0,25.45,20,19,4,14,37,40.54,1,1,2,4,0.00,0,1,13,14,-7.14,0,0,0,0, ,4,0,4,100.00,0,1,0,1,-100.00
11845,USA,12,Thompson Jordan ,O,0,0,0, ,0,0,0,0,0, ,0,0,0,0, ,0,0,0,0, ,0,0,0,0, ,0,0,0, ,0,0,0,0, 
11845,USA,13,Wilhite Sarah ,OH,8,3,0,22.86,11,8,2,13,23,26.09,3,0,0,3,100.00,0,1,8,9,-11.11,4,0,2,6,66.67,2,0,2,100.00,0,0,4,4,0.00
11845,USA,14,Bartsch-Hackley Michelle ,OH,0,0,0, ,0,0,0,0,0, ,0,0,0,0, ,0,0,0,0, ,0,0,0,0, ,0,0,0, ,0,0,0,0, 
11845,USA,16,Akinradewo Foluke ,MB,0,0,0, ,0,0,0,0,0, ,0,0,0,0, ,0,0,0,0, ,0,0,0,0, ,0,0,0, ,0,0,0,0, 
11845,USA,17,Courtney Megan ,OH,0,0,0, ,0,0,0,0,0, ,0,0,0,0, ,0,0,0,0, ,0,0,0,0, ,0,0,0, ,0,0,0,0, 
11845,USA,22,Washington Haleigh ,MB,0,0,0, ,0,0,0,0,0, ,0,0,0,0, ,0,0,0,0, ,0,0,0,0, ,0,0,0, ,0,0,0,0, 
11845,CAN,1,Bujan Cassandra ,L,0,0,0, ,0,0,0,0,0, ,0,0,0,0, ,0,0,0,0, ,0,0,1,1,0.00,0,0,0, ,0,0,0,0, 
11845,CAN,3,Van Ryk Kiera ,OH,13,0,0,16.13,13,13,6,7,26,26.92,0,1,0,1,-100.00,0,1,3,4,-25.00,0,0,1,1,0.00,0,0,0, ,0,0,2,2,0.00
11845,CAN,5,Smith Danielle ,S,0,0,0,-25.00,0,0,0,0,0, ,0,1,1,2,-50.00,0,0,2,2,0.00,0,0,0,0, ,1,0,1,100.00,1,1,29,31,0.00
11845,CAN,6,White Jazmine  Ruth ,MB,0,0,0,-25.00,0,0,1,2,3,-33.33,0,0,0,0, ,0,0,1,1,0.00,0,0,0,0, ,0,0,0, ,0,0,0,0, 
11845,CAN,9,Gray Alexa ,OH,0,0,0, ,0,0,0,0,0, ,0,0,0,0, ,0,0,0,0, ,1,1,16,18,0.00,3,1,4,50.00,0,0,8,8,0.00
11845,CAN,11,Mitrovic Andrea ,OH,3,0,0,3.45,3,3,2,16,21,4.76,0,0,2,2,0.00,0,0,6,6,0.00,4,1,16,21,14.29,2,0,2,100.00,0,0,2,2,0.00
11845,CAN,12,Cross Jennifer ,MB,1,0,0,-6.67,1,1,0,3,4,25.00,0,1,0,1,-100.00,0,1,9,10,-10.00,0,0,1,1,0.00,0,0,0, ,0,0,1,1,0.00
11845,CAN,13,King Brie ,S,0,1,0,-22.22,1,0,1,2,3,-33.33,1,1,1,3,0.00,0,1,2,3,-33.33,0,0,0,0, ,4,1,5,60.00,2,1,48,51,1.96
11845,CAN,14,Howe Hilary ,OH,4,0,0,-7.14,4,4,3,10,17,5.88,0,3,0,3,-100.00,0,0,8,8,0.00,3,2,17,22,4.55,0,0,1,0.00,0,0,4,4,0.00
11845,CAN,15,Joseph Shainah ,O,4,0,0,27.27,4,4,1,3,8,37.50,0,0,0,0, ,0,0,3,3,0.00,0,0,0,0, ,1,0,1,100.00,0,0,1,1,0.00
11845,CAN,16,Livingston Caroline ,OH,1,0,0,-27.27,1,1,2,2,5,-20.00,0,2,0,2,-100.00,0,0,4,4,0.00,0,0,1,1,0.00,0,0,0, ,0,0,0,0, 
11845,CAN,18,Robitaille Kim ,S,0,0,0, ,0,0,0,0,0, ,0,0,0,0, ,0,0,0,0, ,0,0,0,0, ,0,0,0, ,0,0,0,0, 
11845,CAN,19,Maglio Emily ,MB,3,1,0,0.00,4,3,2,7,12,8.33,1,2,4,7,-14.29,0,0,8,8,0.00,1,0,0,1,100.00,1,0,1,100.00,0,0,0,0, 
11845,CAN,23,Austin Parker Jane ,OH,0,0,0,-100.00,0,0,0,0,0, ,0,0,0,0, ,0,1,0,1,-100.00,0,0,1,1,0.00,0,0,0, ,0,0,0,0, 
11846,GER,1,Bock Linda ,L,0,0,0, ,0,0,0,0,0, ,0,0,0,0, ,0,0,0,0, ,0,0,0,0, ,0,0,1,0.00,0,0,0,0, 
11846,GER,2,KÃ¤stner Pia ,S,0,0,2,25.00,2,0,0,0,0, ,0,1,0,1,-100.00,2,0,1,3,66.67,0,0,0,0, ,0,0,0, ,0,0,9,9,0.00
11846,GER,4,Imoudu Denise ,S,2,0,0,0.00,2,2,1,1,4,25.00,0,0,0,0, ,0,1,7,8,-12.50,0,0,0,0, ,4,0,4,100.00,7,1,63,71,8.45
11846,GER,5,Poll Jana Franziska ,OH,1,0,0,100.00,1,1,0,0,1,100.00,0,0,0,0, ,0,0,0,0, ,0,0,0,0, ,0,0,0, ,0,0,0,0, 
11846,GER,6,Janiska Jennifer ,OH,7,4,1,19.35,12,7,4,6,17,17.65,4,0,0,4,100.00,1,2,7,10,-10.00,8,0,7,15,53.33,4,0,4,100.00,0,0,1,1,0.00
11846,GER,7,Vanjak Ivana ,OH,0,0,0,0.00,0,0,0,1,1,0.00,0,0,0,0, ,0,0,2,2,0.00,0,0,0,0, ,0,0,0, ,0,0,0,0, 
11846,GER,8,Drewniok Kimberly ,O,8,0,0,12.12,8,8,2,9,19,31.58,0,0,0,0, ,0,2,12,14,-14.29,0,0,0,0, ,2,0,2,100.00,0,0,2,2,0.00
11846,GER,9,Alsmeier Lina ,OH,11,0,3,32.43,14,11,1,12,24,41.67,0,0,0,0, ,3,1,9,13,15.38,11,1,6,18,55.56,1,0,2,50.00,0,0,1,1,0.00
11846,GER,12,Orthmann Hanna ,OH,0,0,0,-25.00,0,0,1,2,3,-33.33,0,0,0,0, ,0,0,1,1,0.00,1,0,0,1,100.00,0,0,0, ,0,0,0,0, 
11846,GER,14,SchÃ¶lzel Marie ,MB,5,3,0,25.00,8,5,0,6,11,45.45,3,1,1,5,40.00,0,1,7,8,-12.50,0,0,0,0, ,0,0,0, ,0,0,1,1,0.00
11846,GER,16,Ambrosius Lea ,MB,0,0,0, ,0,0,0,0,0, ,0,0,0,0, ,0,0,0,0, ,0,0,0,0, ,0,0,0, ,0,0,0,0, 
11846,GER,17,Pogany Anna ,L,0,0,0, ,0,0,0,0,0, ,0,0,0,0, ,0,0,0,0, ,4,1,5,10,30.00,1,0,1,100.00,0,0,3,3,0.00
11846,GER,20,Bock Josepha ,MB,0,0,0,0.00,0,0,0,0,0, ,0,0,0,0, ,0,0,1,1,0.00,0,0,0,0, ,0,0,0, ,0,0,0,0, 
11846,GER,21,Weitzel Camilla ,MB,6,1,2,26.09,9,6,0,1,7,85.71,1,1,0,2,0.00,2,2,10,14,0.00,0,0,0,0, ,2,0,2,100.00,0,0,0,0, 
11846,BEL,2,Van Sas Elise ,S,0,0,0,0.00,0,0,0,1,1,0.00,0,0,0,0, ,0,0,0,0, ,0,0,0,0, ,0,0,0, ,0,0,1,1,0.00
11846,BEL,3,Herbots Britt ,OH,11,0,1,11.90,12,11,4,17,32,21.88,0,1,0,1,-100.00,1,2,6,9,-11.11,4,1,9,14,21.43,0,0,0, ,0,0,2,2,0.00
11846,BEL,4,Lemmens Nathalie ,MB,0,0,0, ,0,0,0,0,0, ,0,0,0,0, ,0,0,0,0, ,0,0,0,0, ,0,0,0, ,0,0,0,0, 
11846,BEL,5,Guilliams Jodie ,OH,3,0,0,0.00,3,3,2,6,11,9.09,0,0,0,0, ,0,1,5,6,-16.67,6,2,3,11,36.36,1,0,1,100.00,0,0,1,1,0.00
11846,BEL,6,Gilson Helena ,OH,1,0,0,-33.33,1,1,1,3,5,0.00,0,1,0,1,-100.00,0,2,1,3,-66.67,0,0,1,1,0.00,0,0,0, ,0,0,0,0, 
11846,BEL,7,Van Gestel Celine ,OH,8,0,1,11.76,9,8,4,10,22,18.18,0,1,0,1,-100.00,1,0,10,11,9.09,5,3,14,22,9.09,1,0,1,100.00,0,0,0,0, 
11846,BEL,9,Demeyer Nel ,L,0,0,0, ,0,0,0,0,0, ,0,0,0,0, ,0,0,0,0, ,0,0,0,0, ,0,0,0, ,0,0,0,0, 
11846,BEL,10,Sobolska Dominika ,MB,2,2,0,7.14,4,2,1,3,6,16.67,2,2,0,4,0.00,0,0,4,4,0.00,0,0,0,0, ,2,0,2,100.00,0,0,0,0, 
11846,BEL,13,Janssens Marlies ,MB,2,1,0,-5.56,3,2,4,3,9,-22.22,1,0,1,2,50.00,0,0,7,7,0.00,0,0,0,0, ,2,0,2,100.00,0,0,1,1,0.00
11846,BEL,15,Van De Vyver Jutta ,S,0,0,0, ,0,0,0,0,0, ,0,0,0,0, ,0,0,0,0, ,0,0,0,0, ,0,0,0, ,0,0,0,0, 
11846,BEL,17,Van De Vyver Ilka ,S,0,0,0,-18.18,0,0,0,0,0, ,0,1,1,2,-50.00,0,1,8,9,-11.11,0,0,0,0, ,0,0,0, ,1,0,81,82,1.22
11846,BEL,18,Rampelberg Britt ,L,0,0,0, ,0,0,0,0,0, ,0,0,0,0, ,0,0,0,0, ,5,2,10,17,17.65,2,0,2,100.00,0,1,2,3,-33.33
11846,BEL,19,Van Avermaet Silke ,MB,3,1,0,22.22,4,3,0,3,6,50.00,1,0,0,1,100.00,0,2,0,2,-100.00,0,0,0,0, ,1,0,1,100.00,0,0,0,0, 
11846,BEL,21,Stragier Manon ,OH,0,0,0,-50.00,0,0,0,0,0, ,0,0,0,0, ,0,1,1,2,-50.00,0,0,0,0, ,0,0,0, ,0,0,0,0, 
11847,RUS,2,Malygina Daria ,O,2,3,1,4.17,6,2,1,3,6,16.67,3,2,3,8,12.50,1,2,7,10,-10.00,0,0,0,0, ,0,1,1,-100.00,0,0,0,0, 
11847,RUS,4,Pilipenko Daria ,L,0,0,0, ,0,0,0,0,0, ,0,0,0,0, ,0,0,0,0, ,1,0,5,6,16.67,1,2,4,-25.00,0,0,2,2,0.00
11847,RUS,5,Fedorovtseva Arina ,OH,14,3,1,35.00,18,14,2,9,25,48.00,3,0,0,3,100.00,1,2,9,12,-8.33,9,1,17,27,29.63,2,2,4,0.00,0,1,1,2,-50.00
11847,RUS,6,Koroleva Irina ,MB,1,0,0,-20.00,1,1,0,0,1,100.00,0,1,0,1,-100.00,0,1,2,3,-33.33,0,0,0,0, ,0,0,0, ,0,0,0,0, 
11847,RUS,8,Goncharova Nataliya ,O,3,0,0,28.57,3,3,1,2,6,33.33,0,0,0,0, ,0,0,1,1,0.00,0,0,1,1,0.00,3,0,3,100.00,0,1,0,1,-100.00
11847,RUS,11,Brovkina Yulia ,MB,5,1,1,3.70,7,5,0,6,11,45.45,1,6,0,7,-71.43,1,0,8,9,11.11,0,0,0,0, ,0,0,0, ,0,0,0,0, 
11847,RUS,13,Startseva Evgeniya ,S,1,0,0,50.00,1,1,0,0,1,100.00,0,0,0,0, ,0,0,1,1,0.00,0,0,0,0, ,2,1,3,33.33,1,0,14,15,6.67
11847,RUS,14,Fetisova Irina ,MB,0,0,0,0.00,0,0,0,2,2,0.00,0,0,0,0, ,0,0,2,2,0.00,0,0,0,0, ,0,0,0, ,0,0,0,0, 
11847,RUS,15,Kosheleva Tatyana ,OH,1,0,0,-14.29,1,1,1,2,4,0.00,0,1,1,2,-50.00,0,0,1,1,0.00,2,0,2,4,50.00,0,1,1,-100.00,0,0,1,1,0.00
11847,RUS,16,Voronkova Irina ,OH,0,0,0,-14.29,0,0,1,4,5,-20.00,0,0,0,0, ,0,0,2,2,0.00,1,0,1,2,50.00,3,1,4,50.00,0,0,1,1,0.00
11847,RUS,20,Lazareva Ekaterina ,S,1,0,1,-5.56,2,1,0,1,2,50.00,0,2,0,2,-100.00,1,1,12,14,0.00,0,0,0,0, ,10,4,14,42.86,8,0,77,85,9.41
11847,RUS,22,Zaytseva Tamara ,L,0,0,0, ,0,0,0,0,0, ,0,0,0,0, ,0,0,0,0, ,8,2,9,19,31.58,11,6,18,27.78,0,0,9,9,0.00
11847,RUS,23,Kapustina Irina ,OH,3,1,2,-6.90,6,3,5,6,14,-14.29,1,0,0,1,100.00,2,3,9,14,-7.14,9,3,13,25,24.00,7,3,11,36.36,0,0,2,2,0.00
11847,RUS,25,Smirnova Kseniia ,OH,17,0,1,19.23,18,17,5,18,40,30.00,0,0,0,0, ,1,3,8,12,-16.67,0,0,0,0, ,5,3,8,25.00,0,1,0,1,-100.00
11847,NED,1,Knip Kirsten ,L,0,0,0, ,0,0,0,0,0, ,0,0,0,0, ,0,0,0,0, ,0,0,0,0, ,0,0,0, ,0,0,0,0, 
11847,NED,2,Savelkoel Fleur ,OH,0,0,0, ,0,0,0,0,0, ,0,0,0,0, ,0,0,0,0, ,0,0,0,0, ,0,0,0, ,0,0,0,0, 
11847,NED,8,Korevaar Demi ,MB,0,0,1,20.00,1,0,0,0,0, ,0,0,0,0, ,1,0,4,5,20.00,0,0,0,0, ,0,0,0, ,0,0,0,0, 
11847,NED,9,Schoot Myrthe ,L,0,0,0, ,0,0,0,0,0, ,0,0,0,0, ,0,0,0,0, ,10,0,8,18,55.56,18,1,19,89.47,0,0,3,3,0.00
11847,NED,10,van Aalen Sarah ,S,0,0,0, ,0,0,0,0,0, ,0,0,0,0, ,0,0,0,0, ,0,0,0,0, ,0,0,0, ,0,0,0,0, 
11847,NED,11,Buijs Anne ,OH,12,3,0,20.41,15,12,2,12,26,38.46,3,3,0,6,0.00,0,0,17,17,0.00,8,4,15,27,14.81,15,2,17,76.47,0,0,1,1,0.00
11847,NED,12,Bongaerts Britt ,S,1,0,3,4.35,4,1,0,2,3,33.33,0,3,0,3,-100.00,3,0,14,17,17.65,0,0,0,0, ,5,1,6,66.67,22,0,87,109,20.18
11847,NED,16,Baijens Indy ,MB,11,4,1,25.00,16,11,1,5,17,58.82,4,3,2,9,11.11,1,3,6,10,-20.00,0,0,0,0, ,2,0,2,100.00,0,0,1,1,0.00
11847,NED,18,Jasper Marrit ,OH,0,0,0, ,0,0,0,0,0, ,0,0,0,0, ,0,0,0,0, ,0,1,0,1,-100.00,0,0,0, ,0,0,0,0, 
11847,NED,19,Daalderop Nika ,OH,13,1,1,7.14,15,13,4,16,33,27.27,1,4,2,7,-42.86,1,3,12,16,-12.50,5,2,16,23,13.04,4,6,10,-20.00,0,0,0,0, 
11847,NED,23,Timmerman Eline ,MB,10,2,0,-2.63,12,10,1,3,14,64.29,2,8,0,10,-60.00,0,4,10,14,-28.57,0,0,0,0, ,5,0,5,100.00,0,0,0,0, 
11847,NED,24,de Zwart Laura ,MB,0,0,0, ,0,0,0,0,0, ,0,0,0,0, ,0,0,0,0, ,0,0,0,0, ,1,0,1,100.00,0,0,0,0, 
11847,NED,26,Dambrink Elles ,O,12,1,0,6.67,13,12,6,7,25,24.00,1,2,0,3,-33.33,0,2,15,17,-11.76,0,0,0,0, ,9,3,12,50.00,0,0,2,2,0.00
11847,NED,27,Scholten Iris ,O,0,0,0, ,0,0,0,0,0, ,0,0,0,0, ,0,0,0,0, ,0,0,0,0, ,0,0,0, ,0,0,0,0, 
11848,KOR,1,Lee Soyoung ,OH,8,1,1,9.09,10,8,5,9,22,13.64,1,1,0,2,0.00,1,1,7,9,0.00,8,2,15,25,24.00,1,0,1,100.00,0,0,0,0, 
11848,KOR,2,Lee Dahyeon ,MB,0,0,0, ,0,0,0,0,0, ,0,0,0,0, ,0,0,0,0, ,0,0,0,0, ,0,0,0, ,0,0,0,0, 
11848,KOR,3,Yeum Hye Seon ,S,0,0,0,0.00,0,0,0,1,1,0.00,0,0,0,0, ,0,0,5,5,0.00,0,0,0,0, ,0,0,0, ,1,1,56,58,0.00
11848,KOR,5,Han Dahye ,L,0,0,0, ,0,0,0,0,0, ,0,0,0,0, ,0,0,0,0, ,0,0,0,0, ,0,0,0, ,0,0,0,0, 
11848,KOR,6,Kim Dain ,S,0,0,0,-16.67,0,0,0,1,1,0.00,0,0,0,0, ,0,1,4,5,-20.00,0,0,0,0, ,0,0,0, ,2,0,45,47,4.26
11848,KOR,8,Park Eunjin ,MB,0,0,0, ,0,0,0,0,0, ,0,0,0,0, ,0,0,0,0, ,0,0,0,0, ,0,0,0, ,0,0,0,0, 
11848,KOR,9,Oh Jiyoung ,L,0,0,0, ,0,0,0,0,0, ,0,0,0,0, ,0,0,0,0, ,6,0,9,15,40.00,7,0,7,100.00,0,0,2,2,0.00
11848,KOR,10,Kim Yeon Koung ,OH,9,1,1,18.60,11,9,2,21,32,21.88,1,0,0,1,100.00,1,1,8,10,0.00,11,1,13,25,40.00,3,0,3,100.00,0,0,4,4,0.00
11848,KOR,12,Han Songyi ,MB,5,0,0,33.33,5,5,0,1,6,83.33,0,0,1,1,0.00,0,0,8,8,0.00,1,0,0,1,100.00,2,0,2,100.00,0,0,0,0, 
11848,KOR,13,Park Jeongah ,OH,7,0,0,3.23,7,7,4,15,26,11.54,0,1,0,1,-100.00,0,1,3,4,-25.00,0,0,0,0, ,0,0,0, ,0,0,0,0, 
11848,KOR,14,Yang Hyo Jin ,MB,5,4,0,40.91,9,5,0,3,8,62.50,4,0,0,4,100.00,0,0,10,10,0.00,0,0,0,0, ,1,0,1,100.00,0,0,0,0, 
11848,KOR,15,Yuk Seoyoung ,OH,0,0,0, ,0,0,0,0,0, ,0,0,0,0, ,0,0,0,0, ,0,0,0,0, ,0,0,0, ,0,0,0,0, 
11848,KOR,16,Jeong Jiyun ,O,4,0,1,4.35,5,4,4,7,15,0.00,0,0,0,0, ,1,0,7,8,12.50,0,0,0,0, ,0,0,0, ,0,0,0,0, 
11848,KOR,19,Pyo Seungju ,OH,0,0,0,-25.00,0,0,1,0,1,-100.00,0,0,0,0, ,0,0,3,3,0.00,0,1,3,4,-25.00,1,0,1,100.00,0,0,0,0, 
11848,JPN,1,Kurogo Ai ,OH,9,1,0,21.21,10,9,2,10,21,33.33,1,0,1,2,50.00,0,1,9,10,-10.00,2,0,5,7,28.57,1,0,1,100.00,0,1,0,1,-100.00
11848,JPN,2,Koga Sarina ,OH,18,2,0,28.57,20,18,5,11,34,38.24,2,0,0,2,100.00,0,1,12,13,-7.69,14,3,9,26,42.31,0,0,0, ,0,0,0,0, 
11848,JPN,3,Shimamura Haruyo ,MB,3,1,0,8.70,4,3,1,10,14,14.29,1,0,0,1,100.00,0,1,7,8,-12.50,4,0,0,4,100.00,0,0,0, ,0,0,0,0, 
11848,JPN,5,Araki Erika ,MB,0,0,0, ,0,0,0,0,0, ,0,0,0,0, ,0,0,0,0, ,0,0,0,0, ,0,0,0, ,0,0,0,0, 
11848,JPN,7,Ishii Yuki ,OH,0,0,0,0.00,0,0,0,0,0, ,0,0,0,0, ,0,0,2,2,0.00,0,0,0,0, ,0,0,0, ,0,0,0,0, 
11848,JPN,8,Ishikawa Mayu ,OH,17,0,1,27.45,18,17,3,16,36,38.89,0,0,1,1,0.00,1,1,12,14,0.00,7,0,2,9,77.78,2,0,3,66.67,0,0,0,0, 
11848,JPN,9,Tashiro Kanami ,S,0,0,0,0.00,0,0,0,0,0, ,0,0,0,0, ,0,0,1,1,0.00,0,0,0,0, ,0,0,0, ,1,0,12,13,7.69
11848,JPN,13,Okumura Mai ,MB,5,3,2,27.59,10,5,1,4,10,40.00,3,0,0,3,100.00,2,1,13,16,6.25,0,0,1,1,0.00,0,0,0, ,0,0,0,0, 
11848,JPN,14,Kobata Mako ,L,0,0,0, ,0,0,0,0,0, ,0,0,0,0, ,0,0,0,0, ,7,0,1,8,87.50,6,0,6,100.00,0,0,5,5,0.00
11848,JPN,15,Inoue Kotoe ,L,0,0,0, ,0,0,0,0,0, ,0,0,0,0, ,0,0,0,0, ,0,0,0,0, ,0,0,0, ,0,0,0,0, 
11848,JPN,19,Yamada Nichika ,MB,0,0,0, ,0,0,0,0,0, ,0,0,0,0, ,0,0,0,0, ,0,0,0,0, ,0,0,0, ,0,0,0,0, 
11848,JPN,20,Seki Nanami ,S,0,0,0, ,0,0,0,0,0, ,0,0,0,0, ,0,0,0,0, ,0,0,0,0, ,0,0,0, ,0,0,0,0, 
11848,JPN,21,Hayashi Kotona ,OH,0,0,0, ,0,0,0,0,0, ,0,0,0,0, ,0,0,0,0, ,1,0,1,2,50.00,0,0,0, ,0,0,0,0, 
11848,JPN,24,Momii Aki ,S,0,0,1,-6.67,1,0,0,1,1,0.00,0,1,1,2,-50.00,1,1,10,12,0.00,0,0,1,1,0.00,0,0,0, ,4,0,91,95,4.21
11849,CAN,1,Bujan Cassandra ,L,0,0,0, ,0,0,0,0,0, ,0,0,0,0, ,0,0,0,0, ,0,0,0,0, ,0,0,0, ,0,0,0,0, 
11849,CAN,3,Van Ryk Kiera ,OH,20,4,1,24.24,25,20,6,21,47,29.79,4,1,1,6,50.00,1,2,10,13,-7.69,6,3,14,23,13.04,12,3,15,60.00,0,0,0,0, 
11849,CAN,5,Smith Danielle ,S,0,0,0, ,0,0,0,0,0, ,0,0,0,0, ,0,0,0,0, ,0,0,0,0, ,0,0,0, ,0,0,0,0, 
11849,CAN,6,White Jazmine  Ruth ,MB,0,0,0, ,0,0,0,0,0, ,0,0,0,0, ,0,0,0,0, ,0,0,0,0, ,0,0,0, ,0,0,0,0, 
11849,CAN,9,Gray Alexa ,OH,0,0,0, ,0,0,0,0,0, ,0,0,0,0, ,0,0,0,0, ,7,6,16,29,3.45,12,4,16,50.00,0,0,16,16,0.00
11849,CAN,11,Mitrovic Andrea ,OH,3,1,0,7.69,4,3,3,2,8,0.00,1,0,0,1,100.00,0,0,4,4,0.00,0,0,5,5,0.00,1,1,2,0.00,0,0,1,1,0.00
11849,CAN,12,Cross Jennifer ,MB,6,1,0,-5.26,7,6,2,6,14,28.57,1,4,2,7,-42.86,0,3,14,17,-17.65,0,0,0,0, ,4,0,4,100.00,0,0,1,1,0.00
11849,CAN,13,King Brie ,S,0,1,2,-14.81,3,0,0,3,3,0.00,1,3,3,7,-28.57,2,4,11,17,-11.76,0,0,0,0, ,13,2,15,73.33,16,3,101,120,10.83
11849,CAN,14,Howe Hilary ,OH,9,1,0,10.00,10,9,3,13,25,24.00,1,0,1,2,50.00,0,3,10,13,-23.08,6,4,23,33,6.06,10,5,15,33.33,0,1,2,3,-33.33
11849,CAN,15,Joseph Shainah ,O,4,1,1,-7.50,6,4,2,15,21,9.52,1,6,2,9,-55.56,1,1,8,10,0.00,0,0,0,0, ,10,1,12,75.00,0,1,1,2,-50.00
11849,CAN,16,Livingston Caroline ,OH,0,0,0, ,0,0,0,0,0, ,0,0,0,0, ,0,0,0,0, ,0,0,0,0, ,0,0,0, ,0,0,0,0, 
11849,CAN,18,Robitaille Kim ,S,0,0,0, ,0,0,0,0,0, ,0,0,0,0, ,0,0,0,0, ,0,0,0,0, ,0,0,0, ,0,0,0,0, 
11849,CAN,19,Maglio Emily ,MB,9,2,1,11.90,12,9,1,9,19,42.11,2,4,3,9,-22.22,1,2,11,14,-7.14,0,0,1,1,0.00,9,2,11,63.64,0,0,0,0, 
11849,CAN,23,Austin Parker Jane ,OH,0,0,0, ,0,0,0,0,0, ,0,0,0,0, ,0,0,0,0, ,0,0,0,0, ,0,0,0, ,0,0,0,0, 
11849,DOM,1,Vargas Valdez Annerys Victoria ,MB,0,0,0,-100.00,0,0,0,0,0, ,0,2,0,2,-100.00,0,0,0,0, ,0,0,0,0, ,0,0,0, ,0,0,0,0, 
11849,DOM,3,Eve Mejia Lisvel Elisa ,U,4,3,1,9.68,8,4,0,7,11,36.36,3,3,2,8,0.00,1,2,9,12,-8.33,3,1,7,11,18.18,8,1,9,77.78,0,0,0,0, 
11849,DOM,5,Castillo Brenda ,L,0,0,0, ,0,0,0,0,0, ,0,0,0,0, ,0,0,0,0, ,5,3,17,25,8.00,27,3,30,80.00,0,0,12,12,0.00
11849,DOM,6,Dominguez Martinez Camil Inmaculada ,S,0,0,0, ,0,0,0,0,0, ,0,0,0,0, ,0,0,0,0, ,0,0,0,0, ,0,0,0, ,0,0,0,0, 
11849,DOM,7,Marte Frica Niverka Dharlenis ,S,0,0,3,-13.64,3,0,0,2,2,0.00,0,3,0,3,-100.00,3,3,11,17,0.00,0,0,0,0, ,9,5,14,28.57,12,1,116,129,8.53
11849,DOM,11,Rodriguez Marifranchi ,MB,0,0,0, ,0,0,0,0,0, ,0,0,0,0, ,0,0,0,0, ,0,0,0,0, ,0,0,0, ,0,0,0,0, 
11849,DOM,14,Rivera Brens Prisilla ,OH,18,0,3,21.05,21,18,3,12,33,45.45,0,3,0,3,-100.00,3,3,15,21,0.00,5,1,16,22,18.18,5,1,6,66.67,0,0,0,0, 
11849,DOM,16,PeÃ±a Isabel Yonkaira Paola ,OH,0,0,0,0.00,0,0,0,0,0, ,0,0,0,0, ,0,0,1,1,0.00,0,0,1,1,0.00,1,0,1,100.00,0,0,0,0, 
11849,DOM,17,Mambru Casilla Gina Altagracia ,O,0,0,0, ,0,0,0,0,0, ,0,0,0,0, ,0,0,0,0, ,0,0,0,0, ,0,0,0, ,0,0,0,0, 
11849,DOM,18,De La Cruz De PeÃ±a Bethania ,OH,17,0,2,15.15,19,17,8,25,50,18.00,0,0,0,0, ,2,1,13,16,6.25,3,0,11,14,21.43,14,4,18,55.56,0,0,2,2,0.00
11849,DOM,20,Martinez Brayelin Elizabeth ,OH,0,0,0, ,0,0,0,0,0, ,0,0,0,0, ,0,0,0,0, ,0,0,0,0, ,0,0,0, ,0,0,0,0, 
11849,DOM,21,Martinez Jineiry ,MB,8,3,0,6.82,11,8,2,10,20,30.00,3,5,1,9,-22.22,0,1,14,15,-6.67,0,0,0,0, ,8,2,10,60.00,0,0,2,2,0.00
11849,DOM,23,Gonzalez Lopez Gaila Ceneida ,O,6,0,4,0.00,10,6,5,20,31,3.23,0,3,1,4,-75.00,4,2,15,21,9.52,0,0,0,0, ,10,2,12,66.67,0,0,1,1,0.00
11849,DOM,25,Martinez Caro Larysmer ,OH,0,0,0, ,0,0,0,0,0, ,0,0,0,0, ,0,0,0,0, ,0,0,0,0, ,0,0,0, ,0,0,0,0, 
11850,CHN,3,Diao Linyu ,S,0,0,0, ,0,0,0,0,0, ,0,0,0,0, ,0,0,0,0, ,0,0,0,0, ,0,0,0, ,0,0,0,0, 
11850,CHN,4,Yang Hanyu ,MB,5,3,0,11.54,8,5,0,2,7,71.43,3,3,4,10,0.00,0,2,7,9,-22.22,0,0,0,0, ,1,1,2,0.00,0,0,1,1,0.00
11850,CHN,5,Gao Yi ,MB,0,0,0, ,0,0,0,0,0, ,0,0,0,0, ,0,0,0,0, ,0,0,0,0, ,0,0,0, ,0,0,0,0, 
11850,CHN,7,Wang Yuanyuan ,MB,10,3,1,15.91,14,10,2,5,17,47.06,3,5,8,16,-12.50,1,0,10,11,9.09,0,0,1,1,0.00,3,0,4,75.00,0,0,0,0, 
11850,CHN,8,Li Yao ,OH,9,1,2,18.60,12,9,1,11,21,38.10,1,3,1,5,-40.00,2,0,15,17,11.76,2,0,0,2,100.00,9,4,15,33.33,0,0,1,1,0.00
11850,CHN,9,Zhang Changning ,OH,15,2,1,28.95,18,15,3,7,25,48.00,2,2,0,4,0.00,1,2,6,9,-11.11,9,1,7,17,47.06,3,1,6,33.33,0,0,0,0, 
11850,CHN,10,Liu Xiaotong ,OH,0,0,0, ,0,0,0,0,0, ,0,0,0,0, ,0,0,0,0, ,0,0,0,0, ,0,0,0, ,0,0,0,0, 
11850,CHN,11,Yao Di ,S,0,0,0,-13.33,0,0,0,1,1,0.00,0,1,0,1,-100.00,0,1,12,13,-7.69,0,0,0,0, ,0,1,2,-50.00,37,0,44,81,45.68
11850,CHN,14,Zheng Yixin ,MB,0,0,0, ,0,0,0,0,0, ,0,0,0,0, ,0,0,0,0, ,0,0,0,0, ,0,0,0, ,0,0,0,0, 
11850,CHN,15,Lin Li ,L,0,0,0, ,0,0,0,0,0, ,0,0,0,0, ,0,0,0,0, ,0,0,0,0, ,1,0,1,100.00,0,0,0,0, 
11850,CHN,18,Wang Mengjie ,L,0,0,0, ,0,0,0,0,0, ,0,0,0,0, ,0,0,0,0, ,10,1,6,17,52.94,13,2,16,68.75,0,0,3,3,0.00
11850,CHN,19,Liu Yanhan ,OH,0,0,0, ,0,0,0,0,0, ,0,0,0,0, ,0,0,0,0, ,0,0,0,0, ,0,0,0, ,0,0,0,0, 
11850,CHN,22,Duan Fang ,OH,7,2,1,23.53,10,7,1,8,16,37.50,2,0,2,4,50.00,1,1,12,14,0.00,3,0,12,15,20.00,7,2,9,55.56,0,0,0,0, 
11850,THA,2,Pannoy Piyanut ,L,0,0,0, ,0,0,0,0,0, ,0,0,0,0, ,0,0,0,0, ,13,0,7,20,65.00,6,2,9,44.44,0,0,6,6,0.00
11850,THA,3,ManaKij Sirima ,S,0,0,0, ,0,0,0,0,0, ,0,0,0,0, ,0,0,0,0, ,0,0,0,0, ,0,0,0, ,0,0,4,4,0.00
11850,THA,5,Thinkaow Pleumjit ,MB,6,2,0,14.29,8,6,2,8,16,25.00,2,2,2,6,0.00,0,0,6,6,0.00,0,0,0,0, ,1,1,2,0.00,0,0,1,1,0.00
11850,THA,6,Sittirak Onuma ,OH,11,0,2,14.63,13,11,4,11,26,26.92,0,2,0,2,-100.00,2,1,10,13,7.69,4,3,12,19,5.26,5,0,6,83.33,0,0,1,1,0.00
11850,THA,9,Chuewulim Sutadta ,OH,2,0,0,7.69,2,2,0,7,9,22.22,0,1,0,1,-100.00,0,0,3,3,0.00,1,1,0,2,0.00,1,0,1,100.00,0,0,0,0, 
11850,THA,10,Apinyapong Wilavan ,L,2,1,0,0.00,3,2,1,5,8,12.50,1,2,0,3,-33.33,0,0,5,5,0.00,1,0,6,7,14.29,4,2,6,33.33,0,0,2,2,0.00
11850,THA,11,Hyapha Amporn ,MB,2,0,0,16.67,2,2,0,0,2,100.00,0,1,1,2,-50.00,0,0,2,2,0.00,0,0,0,0, ,0,0,1,0.00,0,0,0,0, 
11850,THA,12,Chaisri Tapaphaipun ,L,0,0,0, ,0,0,0,0,0, ,0,0,0,0, ,0,0,0,0, ,0,0,0,0, ,4,1,9,33.33,0,0,1,1,0.00
11850,THA,13,Tomkom Nootsara ,S,2,0,0,-6.67,2,2,2,1,5,0.00,0,0,1,1,0.00,0,1,8,9,-11.11,0,0,1,1,0.00,6,2,8,50.00,15,1,63,79,17.72
11850,THA,14,Juangjan Pattiya ,OH,0,0,0,-100.00,0,0,3,0,3,-100.00,0,0,0,0, ,0,0,0,0, ,0,0,0,0, ,0,0,0, ,0,0,0,0, 
11850,THA,15,Kanthong Malika ,O,8,0,0,-6.45,8,8,4,4,16,25.00,0,5,2,7,-71.43,0,1,7,8,-12.50,6,1,11,18,27.78,3,1,5,40.00,0,0,0,0, 
11850,THA,19,Krause Karina ,MB,4,0,0,-4.76,4,4,3,2,9,11.11,0,2,2,4,-50.00,0,0,8,8,0.00,0,0,0,0, ,0,2,2,-100.00,0,0,0,0, 
11850,THA,22,Nilapa Chatsuda ,OH,1,0,0,33.33,1,1,0,2,3,33.33,0,0,0,0, ,0,0,0,0, ,0,0,0,0, ,0,0,0, ,0,0,0,0, 
11850,THA,24,Nuanjam Watchareeya ,MB,0,0,0,0.00,0,0,0,0,0, ,0,0,0,0, ,0,0,1,1,0.00,0,0,0,0, ,1,0,1,100.00,0,0,0,0, 
11851,POL,1,Nowicka Julia ,S,2,3,0,10.00,5,2,0,2,4,50.00,3,2,1,6,16.67,0,0,20,20,0.00,0,0,2,2,0.00,8,3,12,41.67,27,2,80,109,22.94
11851,POL,3,Alagierska Klaudia ,MB,3,3,0,8.00,6,3,2,1,6,16.67,3,1,0,4,50.00,0,1,14,15,-6.67,0,0,0,0, ,1,1,4,0.00,0,0,1,1,0.00
11851,POL,8,Stenzel Maria ,L,0,0,0, ,0,0,0,0,0, ,0,0,0,0, ,0,0,0,0, ,7,0,13,20,35.00,7,2,9,55.56,0,0,7,7,0.00
11851,POL,9,Stysiak Magdalena ,O,19,2,5,20.63,26,19,8,13,40,27.50,2,1,1,4,25.00,5,4,10,19,5.26,4,2,21,27,7.41,5,1,6,66.67,0,0,0,0, 
11851,POL,10,Efimienko-Mlotkowska Zuzanna ,MB,4,1,0,-3.70,5,4,1,4,9,33.33,1,3,0,4,-50.00,0,2,12,14,-14.29,1,0,0,1,100.00,1,0,1,100.00,0,0,0,0, 
11851,POL,11,Lukasik Martyna ,O,6,1,3,0.00,10,6,5,17,28,3.57,1,5,0,6,-66.67,3,0,12,15,20.00,9,1,25,35,22.86,5,2,7,42.86,0,0,2,2,0.00
11851,POL,13,Jagla Monika ,L,0,0,0, ,0,0,0,0,0, ,0,0,0,0, ,0,0,0,0, ,0,0,0,0, ,5,5,12,0.00,1,0,4,5,20.00
11851,POL,17,Smarzek Malwina ,O,21,2,0,29.82,23,21,4,18,43,39.53,2,1,2,5,20.00,0,1,8,9,-11.11,0,0,1,1,0.00,6,1,7,71.43,0,0,2,2,0.00
11851,POL,19,Fedusio Monika ,OH,1,0,0,100.00,1,1,0,0,1,100.00,0,0,0,0, ,0,0,0,0, ,1,1,4,6,0.00,0,0,0, ,0,0,0,0, 
11851,POL,20,Czyrnianska Martyna ,OH,0,0,0, ,0,0,0,0,0, ,0,0,0,0, ,0,0,0,0, ,0,0,0,0, ,0,0,0, ,0,0,0,0, 
11851,POL,21,Druzkowska Karolina ,O,0,0,0, ,0,0,0,0,0, ,0,0,0,0, ,0,0,0,0, ,0,0,0,0, ,0,0,0, ,0,0,0,0, 
11851,POL,27,Åazowska Martyna ,S,0,0,0,0.00,0,0,0,0,0, ,0,0,0,0, ,0,0,2,2,0.00,0,0,0,0, ,0,0,0, ,1,0,2,3,33.33
11851,POL,30,Rozanski Olivia ,OH,1,0,0,100.00,1,1,0,0,1,100.00,0,0,0,0, ,0,0,0,0, ,0,0,0,0, ,0,0,0, ,0,0,1,1,0.00
11851,POL,78,Gryka Aleksandra ,MB,0,0,0, ,0,0,0,0,0, ,0,0,0,0, ,0,0,0,0, ,0,0,0,0, ,0,0,0, ,0,0,0,0, 
11851,TUR,2,Akoz Simge Sebnem ,L,0,0,0, ,0,0,0,0,0, ,0,0,0,0, ,0,0,0,0, ,1,1,5,7,0.00,6,1,8,62.50,0,0,4,4,0.00
11851,TUR,3,Ãzbay Cansu ,S,1,0,0,33.33,1,1,0,0,1,100.00,0,0,0,0, ,0,0,2,2,0.00,0,0,0,0, ,0,0,0, ,8,0,15,23,34.78
11851,TUR,4,Senoglu Tugba ,OH,2,0,0,33.33,2,2,1,0,3,33.33,0,0,0,0, ,0,0,0,0, ,0,0,3,3,0.00,1,0,1,100.00,0,0,0,0, 
11851,TUR,5,Ercan Seyma ,OH,0,0,0, ,0,0,0,0,0, ,0,0,0,0, ,0,0,0,0, ,0,0,0,0, ,1,0,1,100.00,0,0,0,0, 
11851,TUR,6,Caliskan Kubra ,MB,8,2,0,7.89,10,8,0,6,14,57.14,2,6,1,9,-44.44,0,1,14,15,-6.67,0,1,0,1,-100.00,1,0,1,100.00,0,0,2,2,0.00
11851,TUR,7,Baladin Hande ,OH,5,1,0,-7.89,6,5,5,8,18,0.00,1,2,1,4,-25.00,0,2,14,16,-12.50,10,2,24,36,22.22,11,2,15,60.00,0,0,0,0, 
11851,TUR,8,Guveli Yasemin ,MB,0,0,0, ,0,0,0,0,0, ,0,0,0,0, ,0,0,0,0, ,0,0,0,0, ,0,0,0, ,0,0,0,0, 
11851,TUR,9,Ismailoglu Meliha ,OH,6,0,0,3.03,6,6,4,8,18,11.11,0,1,1,2,-50.00,0,0,13,13,0.00,8,3,15,26,19.23,9,3,12,50.00,0,0,1,1,0.00
11851,TUR,10,Aykac Ayca ,L,0,0,0, ,0,0,0,0,0, ,0,0,0,0, ,0,0,0,0, ,2,1,10,13,7.69,6,1,7,71.43,0,0,2,2,0.00
11851,TUR,11,Aydemir Akyol Naz ,S,2,2,0,-4.00,4,2,0,2,4,50.00,2,3,1,6,-16.67,0,2,13,15,-13.33,0,0,0,0, ,2,0,2,100.00,21,0,73,94,22.34
11851,TUR,13,Boz Meryem ,O,2,0,0,20.00,2,2,1,1,4,25.00,0,0,1,1,0.00,0,0,0,0, ,0,0,0,0, ,0,0,0, ,0,0,0,0, 
11851,TUR,14,Erdem DÃ¼ndar Eda ,MB,16,2,2,35.56,20,16,2,7,25,56.00,2,2,3,7,0.00,2,0,11,13,15.38,0,0,0,0, ,4,2,7,28.57,0,0,0,0, 
11851,TUR,19,Kalac Asli ,MB,0,0,0, ,0,0,0,0,0, ,0,0,0,0, ,0,0,0,0, ,0,0,0,0, ,0,0,0, ,0,0,0,0, 
11851,TUR,99,Karakurt Ebrar ,OH,23,1,2,15.00,26,23,8,19,50,30.00,1,4,0,5,-60.00,2,2,21,25,0.00,0,0,0,0, ,6,3,10,30.00,0,0,2,2,0.00
11852,BRA,2,De Oliveira Saad Gattaz Caroline ,MB,3,1,0,0.00,4,3,0,6,9,33.33,1,3,4,8,-25.00,0,1,4,5,-20.00,0,0,1,1,0.00,1,0,1,100.00,0,0,0,0, 
11852,BRA,3,Rodrigues Lins Dos Santos Danielle ,S,0,0,0,0.00,0,0,0,0,0, ,0,0,1,1,0.00,0,0,4,4,0.00,0,0,0,0, ,2,0,2,100.00,6,0,17,23,26.09
11852,BRA,5,Da Silva Adenizia ,MB,3,2,1,-4.00,6,3,2,4,9,11.11,2,5,2,9,-33.33,1,0,6,7,14.29,0,0,1,1,0.00,1,0,1,100.00,0,0,1,1,0.00
11852,BRA,6,Alexandre Costa Nunes Nyeme Victoria ,L,0,0,0, ,0,0,0,0,0, ,0,0,0,0, ,0,0,0,0, ,0,0,0,0, ,0,0,0, ,0,0,0,0, 
11852,BRA,8,Silva Carneiro Macris Fernanda ,S,0,0,1,-17.39,1,0,0,2,2,0.00,0,4,2,6,-66.67,1,1,13,15,0.00,0,1,0,1,-100.00,11,5,18,33.33,18,1,84,103,16.50
11852,BRA,10,Braga Guimaraes Gabriela ,OH,13,2,0,5.00,15,13,8,18,39,12.82,2,3,1,6,-16.67,0,1,14,15,-6.67,5,1,7,13,30.77,13,1,15,80.00,0,0,2,2,0.00
11852,BRA,11,Caixeta Tandara ,OH,11,2,0,10.91,13,11,4,21,36,19.44,2,2,6,10,0.00,0,1,8,9,-11.11,0,0,0,0, ,5,1,8,50.00,0,0,2,2,0.00
11852,BRA,13,Castro De Paula Blassioli Sheilla ,O,0,0,0,-100.00,0,0,0,0,0, ,0,0,0,0, ,0,1,0,1,-100.00,0,0,0,0, ,0,0,0, ,0,0,0,0, 
11852,BRA,16,Rodrigues Fernanda ,OH,17,1,0,23.53,18,17,1,16,34,47.06,1,4,1,6,-50.00,0,1,10,11,-9.09,19,3,24,46,34.78,11,5,18,33.33,0,0,1,1,0.00
11852,BRA,17,Menezes Oliveira de Souza Ana Cristina ,OH,0,0,0, ,0,0,0,0,0, ,0,0,0,0, ,0,0,0,0, ,0,0,0,0, ,0,0,0, ,0,0,0,0, 
11852,BRA,18,Brait Camila ,L,0,0,0, ,0,0,0,0,0, ,0,0,0,0, ,0,0,0,0, ,9,1,18,28,28.57,16,1,19,78.95,0,0,12,12,0.00
11852,BRA,20,Correa Ana Beatriz ,MB,1,0,0,-15.38,1,1,0,2,3,33.33,0,3,3,6,-50.00,0,0,4,4,0.00,0,0,1,1,0.00,2,1,3,33.33,0,0,1,1,0.00
11852,BRA,24,Geraldo Teixeira Lorenne ,O,2,0,0,0.00,2,2,2,3,7,0.00,0,0,0,0, ,0,0,4,4,0.00,0,0,0,0, ,0,0,0, ,0,0,0,0, 
11852,BRA,28,Araujo De Souza Mayany Cristina ,MB,8,1,0,33.33,9,8,0,3,11,72.73,1,1,1,3,0.00,0,1,6,7,-14.29,1,0,2,3,33.33,1,0,2,50.00,0,0,2,2,0.00
11852,USA,2,Poulter Jordyn ,S,0,0,2,-13.79,2,0,0,1,1,0.00,0,6,5,11,-54.55,2,0,15,17,11.76,0,0,2,2,0.00,11,1,14,71.43,45,0,91,136,33.09
11852,USA,3,Plummer Kathryn ,OH,0,0,0, ,0,0,0,0,0, ,0,0,0,0, ,0,0,0,0, ,0,0,0,0, ,0,0,0, ,0,0,0,0, 
11852,USA,4,Wong-Orantes Justine ,L,0,0,0, ,0,0,0,0,0, ,0,0,0,0, ,0,0,0,0, ,11,0,12,23,47.83,25,2,30,76.67,0,0,6,6,0.00
11852,USA,6,Dixon Tetori ,MB,0,0,0, ,0,0,0,0,0, ,0,0,0,0, ,0,0,0,0, ,0,0,0,0, ,0,0,0, ,0,0,0,0, 
11852,USA,7,Carlini Lauren ,S,0,0,0, ,0,0,0,0,0, ,0,0,0,0, ,0,0,0,0, ,0,0,0,0, ,0,0,0, ,0,0,0,0, 
11852,USA,8,Tapp Hannah ,MB,0,0,0, ,0,0,0,0,0, ,0,0,0,0, ,0,0,0,0, ,0,0,0,0, ,0,0,0, ,0,0,0,0, 
11852,USA,10,Larson Jordan ,OH,15,1,0,16.67,16,15,3,20,38,31.58,1,3,1,5,-40.00,0,0,17,17,0.00,5,0,8,13,38.46,14,4,18,55.56,0,0,5,5,0.00
11852,USA,11,Drews Andrea ,O,15,0,1,9.68,16,15,7,15,37,21.62,0,3,5,8,-37.50,1,0,16,17,5.88,0,0,0,0, ,9,2,13,53.85,0,1,1,2,-50.00
11852,USA,12,Thompson Jordan ,O,0,0,0, ,0,0,0,0,0, ,0,0,0,0, ,0,0,0,0, ,0,0,0,0, ,0,0,0, ,0,0,0,0, 
11852,USA,13,Wilhite Sarah ,OH,21,2,2,26.09,25,21,5,17,43,37.21,2,1,2,5,20.00,2,1,18,21,4.76,10,1,23,34,26.47,4,0,5,80.00,0,0,0,0, 
11852,USA,15,Hill Kimberly ,OH,0,0,0, ,0,0,0,0,0, ,0,0,0,0, ,0,0,0,0, ,0,0,0,0, ,0,0,0, ,0,0,0,0, 
11852,USA,16,Akinradewo Foluke ,MB,7,2,1,0.00,10,7,2,6,15,33.33,2,8,7,17,-35.29,1,0,12,13,7.69,1,1,1,3,0.00,2,0,4,50.00,0,1,0,1,-100.00
11852,USA,17,Courtney Megan ,OH,0,0,0, ,0,0,0,0,0, ,0,0,0,0, ,0,0,0,0, ,0,0,0,0, ,0,0,0, ,0,0,0,0, 
11852,USA,22,Washington Haleigh ,MB,9,1,0,4.76,10,9,1,5,15,53.33,1,5,9,15,-26.67,0,2,10,12,-16.67,0,0,0,0, ,3,0,3,100.00,0,0,0,0, 
11853,SRB,2,Lazovic Katarina ,OH,17,1,0,7.14,18,17,8,22,47,19.15,1,2,3,6,-16.67,0,3,14,17,-17.65,7,0,15,22,31.82,10,0,11,90.91,0,0,4,4,0.00
11853,SRB,3,Caric Sara ,O,8,3,0,-7.32,11,8,9,10,27,-3.70,3,1,1,5,40.00,0,4,5,9,-44.44,0,0,0,0, ,8,0,9,88.89,0,0,2,2,0.00
11853,SRB,6,Uzelac Aleksandra ,OH,0,0,0, ,0,0,0,0,0, ,0,0,0,0, ,0,0,0,0, ,0,0,0,0, ,0,0,0, ,0,0,0,0, 
11853,SRB,7,Jaksic Ana ,S,1,1,1,8.33,3,1,0,1,2,50.00,1,0,0,1,100.00,1,1,19,21,0.00,0,0,0,0, ,11,0,12,91.67,20,1,81,102,18.63
11853,SRB,21,Kocic Jovana ,MB,8,1,0,2.13,9,8,0,6,14,57.14,1,7,2,10,-60.00,0,1,22,23,-4.35,0,0,0,0, ,0,2,2,-100.00,0,0,2,2,0.00
11853,SRB,22,Lozo Sara ,O,8,0,0,7.14,8,8,4,7,19,21.05,0,1,0,1,-100.00,0,1,7,8,-12.50,5,0,20,25,20.00,7,1,8,75.00,0,0,1,1,0.00
11853,SRB,23,Djordjevic Mila ,S,1,0,0,-25.00,1,1,0,0,1,100.00,0,1,0,1,-100.00,0,1,1,2,-50.00,0,0,0,0, ,1,2,3,-33.33,1,0,14,15,6.67
11853,SRB,24,Medic Sofija ,MB,5,2,1,9.09,8,5,0,6,11,45.45,2,4,3,9,-22.22,1,1,11,13,0.00,0,0,1,1,0.00,0,0,0, ,0,0,1,1,0.00
11853,SRB,25,Markovic Bozica ,MB,0,0,0, ,0,0,0,0,0, ,0,0,0,0, ,0,0,0,0, ,0,0,0,0, ,0,0,0, ,0,0,0,0, 
11853,SRB,26,Savic Vanja ,O,1,1,0,0.00,2,1,2,1,4,-25.00,1,0,0,1,100.00,0,0,0,0, ,0,0,0,0, ,0,0,0, ,0,0,0,0, 
11853,SRB,28,Delic Jelena ,MB,0,0,0, ,0,0,0,0,0, ,0,0,0,0, ,0,0,0,0, ,0,0,0,0, ,0,0,0, ,0,0,0,0, 
11853,SRB,31,Djurdjevic Sanja ,L,0,0,0, ,0,0,0,0,0, ,0,0,0,0, ,0,0,0,0, ,7,1,12,20,30.00,5,6,11,-9.09,0,0,6,6,0.00
11853,SRB,32,Gocanin Bojana ,L,0,0,0, ,0,0,0,0,0, ,0,0,0,0, ,0,0,0,0, ,0,0,0,0, ,3,2,5,20.00,0,0,1,1,0.00
11853,SRB,34,Mirosavljevic Jovana ,OH,6,0,0,22.22,6,6,1,6,13,38.46,0,0,0,0, ,0,1,4,5,-20.00,4,0,3,7,57.14,3,0,3,100.00,0,0,0,0, 
11853,ITA,2,Bosio Francesca ,S,0,0,0,-10.00,0,0,0,0,0, ,0,1,1,2,-50.00,0,0,8,8,0.00,0,0,0,0, ,2,0,2,100.00,8,0,37,45,17.78
11853,ITA,4,Bonifacio Sara ,MB,0,0,0, ,0,0,0,0,0, ,0,0,0,0, ,0,0,0,0, ,0,0,0,0, ,0,0,0, ,0,0,0,0, 
11853,ITA,12,Guerra Anastasia ,OH,0,0,0, ,0,0,0,0,0, ,0,0,0,0, ,0,0,0,0, ,0,0,0,0, ,0,0,0, ,0,0,0,0, 
11853,ITA,15,Nwakalor Sylvia Chinelo ,O,21,3,0,21.67,24,21,6,17,44,34.09,3,2,0,5,20.00,0,3,8,11,-27.27,0,0,0,0, ,5,1,7,57.14,0,0,1,1,0.00
11853,ITA,19,Mingardi Camilla ,OH,4,1,0,6.25,5,4,2,5,11,18.18,1,1,0,2,0.00,0,1,2,3,-33.33,0,0,0,0, ,2,0,2,100.00,0,0,1,1,0.00
11853,ITA,21,Lubian Marina ,MB,1,2,0,-25.00,3,1,2,3,6,-16.67,2,3,2,7,-14.29,0,3,4,7,-42.86,0,0,0,0, ,1,0,1,100.00,0,0,1,1,0.00
11853,ITA,23,De Bortoli Chiara ,L,0,0,0, ,0,0,0,0,0, ,0,0,0,0, ,0,0,0,0, ,4,0,6,10,40.00,3,1,4,50.00,0,0,3,3,0.00
11853,ITA,24,Mazzaro Alessia ,MB,2,3,1,13.33,6,2,0,4,6,33.33,3,1,0,4,50.00,1,1,18,20,0.00,0,0,0,0, ,3,1,5,40.00,0,0,0,0, 
11853,ITA,26,Battistoni Ilaria ,S,0,1,0,-38.46,1,0,0,0,0, ,1,3,2,6,-33.33,0,3,4,7,-42.86,0,0,0,0, ,7,3,10,40.00,16,2,63,81,17.28
11853,ITA,27,Furlan Eleonora ,MB,3,1,0,0.00,4,3,0,5,8,37.50,1,4,1,6,-50.00,0,0,6,6,0.00,0,0,0,0, ,1,0,1,100.00,0,0,0,0, 
11853,ITA,28,Melli Giulia ,OH,3,0,0,20.00,3,3,1,1,5,40.00,0,0,0,0, ,0,0,5,5,0.00,0,0,1,1,0.00,3,0,3,100.00,0,0,0,0, 
11853,ITA,29,D'Odorico Sofia ,OH,10,0,0,4.65,10,10,7,15,32,9.38,0,0,2,2,0.00,0,1,8,9,-11.11,4,0,13,17,23.53,6,1,7,71.43,0,0,1,1,0.00
11853,ITA,31,Fersino Eleonora ,L,0,0,0, ,0,0,0,0,0, ,0,0,0,0, ,0,0,0,0, ,11,0,6,17,64.71,9,6,15,20.00,0,1,7,8,-12.50
11853,ITA,32,Omoruyi Oghosasere Loveth ,OH,3,1,0,-10.53,4,3,7,15,25,-16.00,1,0,0,1,100.00,0,1,11,12,-8.33,9,2,29,40,17.50,9,2,12,58.33,0,1,0,1,-100.00
11700,FRA,1,Chinenyeze BarthÃ©lÃ©my ,MB,5,2,0,21.05,7,5,1,2,8,50.00,2,0,0,2,100.00,0,2,7,9,-22.22,0,0,0,0, ,0,0,0, ,0,0,1,1,0.00
11700,FRA,4,Patry Jean ,O,8,1,1,5.26,10,8,4,13,25,16.00,1,0,0,1,100.00,1,4,7,12,-25.00,0,0,0,0, ,1,0,1,100.00,0,0,0,0, 
11700,FRA,6,Toniutti Benjamin ,S,0,0,0, ,0,0,0,0,0, ,0,0,0,0, ,0,0,0,0, ,0,0,0,0, ,0,0,0, ,0,0,0,0, 
11700,FRA,7,Tillie Kevin ,OH,7,0,1,17.24,8,7,1,5,13,46.15,0,1,0,1,-100.00,1,1,13,15,0.00,6,2,13,21,19.05,1,0,1,100.00,0,0,1,1,0.00
11700,FRA,8,Lyneel Julien ,OH,0,0,0, ,0,0,0,0,0, ,0,0,0,0, ,0,0,0,0, ,0,0,0,0, ,0,0,0, ,0,0,0,0, 
11700,FRA,11,Brizard Antoine ,S,3,1,0,-12.50,4,3,0,0,3,100.00,1,0,0,1,100.00,0,6,6,12,-50.00,0,0,0,0, ,0,0,0, ,3,0,62,65,4.62
11700,FRA,12,Boyer Stephen ,O,0,0,0, ,0,0,0,0,0, ,0,0,0,0, ,0,0,0,0, ,0,0,0,0, ,0,0,0, ,0,0,0,0, 
11700,FRA,14,Le Goff Nicolas ,MB,4,2,1,9.52,7,4,2,3,9,22.22,2,2,0,4,0.00,1,1,6,8,0.00,0,0,1,1,0.00,0,0,0, ,0,0,1,1,0.00
11700,FRA,16,Bultor Daryl ,MB,0,0,0, ,0,0,0,0,0, ,0,0,0,0, ,0,0,0,0, ,0,0,0,0, ,0,0,0, ,0,0,0,0, 
11700,FRA,17,Clevenot Trevor ,OH,4,0,0,33.33,4,4,0,1,5,80.00,0,0,0,0, ,0,0,7,7,0.00,4,0,2,6,66.67,0,0,0, ,0,0,0,0, 
11700,FRA,18,Rossard Thibault ,OH,0,0,0,-33.33,0,0,0,0,0, ,0,0,0,0, ,0,1,2,3,-33.33,0,0,0,0, ,0,0,0, ,0,0,0,0, 
11700,FRA,19,Louati Yacine ,OH,8,1,1,19.23,10,8,0,6,14,57.14,1,1,1,3,0.00,1,4,4,9,-33.33,7,2,4,13,38.46,0,0,1,0.00,0,1,0,1,-100.00
11700,FRA,20,Diez Benjamin ,L,0,0,0, ,0,0,0,0,0, ,0,0,0,0, ,0,0,0,0, ,7,0,6,13,53.85,9,0,10,90.00,0,0,5,5,0.00
11700,FRA,24,Gueye Mousse ,MB,0,0,0, ,0,0,0,0,0, ,0,0,0,0, ,0,0,0,0, ,0,0,0,0, ,0,0,0, ,0,0,0,0, 
11700,BUL,1,Karyagin Denis ,O,6,0,0,27.27,6,6,0,1,7,85.71,0,0,0,0, ,0,3,1,4,-75.00,2,2,5,9,0.00,0,0,0, ,0,0,0,0, 
11700,BUL,2,Chavdarov Stefan ,MB,0,0,0,0.00,0,0,0,0,0, ,0,0,0,0, ,0,0,3,3,0.00,0,0,0,0, ,0,0,0, ,0,0,0,0, 
11700,BUL,3,Kolev Nikolay ,MB,0,0,0, ,0,0,0,0,0, ,0,0,0,0, ,0,0,0,0, ,0,0,0,0, ,0,0,0, ,0,0,0,0, 
11700,BUL,4,Atanasov Martin ,OH,2,1,2,-14.81,5,2,4,8,14,-14.29,1,2,0,3,-33.33,2,3,5,10,-10.00,2,0,6,8,25.00,0,0,0, ,0,0,0,0, 
11700,BUL,9,Seganov Georgi ,S,0,1,0,-11.76,1,0,1,0,1,-100.00,1,0,0,1,100.00,0,2,13,15,-13.33,0,0,0,0, ,0,0,0, ,3,0,66,69,4.35
11700,BUL,10,Stankov Svetoslav ,S,0,0,0, ,0,0,0,0,0, ,0,0,0,0, ,0,0,0,0, ,0,0,0,0, ,0,0,0, ,0,0,0,0, 
11700,BUL,11,Grozdanov Aleks ,MB,3,0,0,-31.58,3,3,3,1,7,0.00,0,3,0,3,-100.00,0,3,6,9,-33.33,0,0,0,0, ,0,0,0, ,0,0,2,2,0.00
11700,BUL,12,Petrov Georgi ,OH,3,0,0,0.00,3,3,1,2,6,33.33,0,1,0,1,-100.00,0,1,2,3,-33.33,7,2,7,16,31.25,0,0,0, ,0,0,0,0, 
11700,BUL,14,Asparuhov Asparuh ,OH,3,0,0,33.33,3,3,0,2,5,60.00,0,0,0,0, ,0,0,4,4,0.00,3,0,6,9,33.33,0,0,0, ,0,0,1,1,0.00
11700,BUL,16,Ivanov Vladislav ,L,0,0,0, ,0,0,0,0,0, ,0,0,0,0, ,0,0,0,0, ,8,0,5,13,61.54,8,0,10,80.00,0,0,5,5,0.00
11700,BUL,19,Sokolov Tsvetan ,O,15,2,2,21.28,19,15,5,11,31,32.26,2,1,0,3,33.33,2,3,8,13,-7.69,0,0,0,0, ,0,0,0, ,0,0,0,0, 
11700,BUL,22,Kartev Nikolay ,MB,4,1,0,11.11,5,4,1,0,5,60.00,1,0,2,3,33.33,0,2,8,10,-20.00,0,0,1,1,0.00,1,0,1,100.00,0,0,1,1,0.00
11700,BUL,24,Ivanov Martin ,L,0,0,0, ,0,0,0,0,0, ,0,0,0,0, ,0,0,0,0, ,0,0,0,0, ,0,0,0, ,0,0,0,0, 
11700,BUL,25,Parapunov Radoslav ,O,0,0,0, ,0,0,0,0,0, ,0,0,0,0, ,0,0,0,0, ,0,0,0,0, ,0,0,0, ,0,0,0,0, 
11701,GER,1,Fromm Christian ,OH,14,1,0,15.38,15,14,1,5,20,65.00,1,4,1,6,-50.00,0,4,9,13,-30.77,2,0,4,6,33.33,2,0,2,100.00,0,0,1,1,0.00
11701,GER,3,Schott Ruben ,OH,0,0,1,0.00,1,0,0,0,0, ,0,0,0,0, ,1,1,2,4,0.00,0,0,0,0, ,0,0,0, ,0,0,0,0, 
11701,GER,5,Reichert Moritz ,OH,0,0,0,-100.00,0,0,0,0,0, ,0,0,0,0, ,0,1,0,1,-100.00,0,0,1,1,0.00,0,0,0, ,0,0,1,1,0.00
11701,GER,6,Kaliberda Denys ,OH,7,1,1,14.29,9,7,1,7,15,40.00,1,1,0,2,0.00,1,3,7,11,-18.18,4,0,10,14,28.57,7,0,7,100.00,0,0,0,0, 
11701,GER,7,Sossenheimer David ,OH,0,0,0, ,0,0,0,0,0, ,0,0,0,0, ,0,0,0,0, ,0,0,0,0, ,0,0,0, ,0,0,0,0, 
11701,GER,8,BÃ¶hme Marcus ,MB,0,0,0, ,0,0,0,0,0, ,0,0,0,0, ,0,0,0,0, ,0,0,0,0, ,0,0,0, ,0,0,0,0, 
11701,GER,10,Zenger Julian ,L,0,0,0, ,0,0,0,0,0, ,0,0,0,0, ,0,0,0,0, ,8,0,10,18,44.44,9,0,10,90.00,1,0,2,3,33.33
11701,GER,13,Hirsch Simon ,O,0,1,0,100.00,1,0,0,0,0, ,1,0,0,1,100.00,0,0,0,0, ,0,0,0,0, ,0,0,0, ,0,0,0,0, 
11701,GER,15,BaxpÃ¶hler Noah ,MB,0,0,0, ,0,0,0,0,0, ,0,0,0,0, ,0,0,0,0, ,0,0,0,0, ,0,0,0, ,0,0,0,0, 
11701,GER,16,BurggrÃ¤f Eric ,S,0,0,0, ,0,0,0,0,0, ,0,0,0,0, ,0,0,0,0, ,0,0,0,0, ,0,0,0, ,0,0,0,0, 
11701,GER,17,Zimmermann Jan ,S,0,0,1,-13.33,1,0,0,0,0, ,0,2,1,3,-66.67,1,1,10,12,0.00,0,0,1,1,0.00,4,0,4,100.00,20,0,46,66,30.30
11701,GER,18,Krage Florian ,MB,4,1,0,-4.17,5,4,1,4,9,33.33,1,4,0,5,-60.00,0,1,9,10,-10.00,0,0,0,0, ,0,0,1,0.00,0,0,0,0, 
11701,GER,20,Weber Linus ,O,12,1,1,11.11,14,12,3,4,19,47.37,1,2,0,3,-33.33,1,5,8,14,-28.57,0,0,0,0, ,5,2,7,42.86,0,0,0,0, 
11701,GER,21,Krick Tobias ,MB,5,0,1,4.76,6,5,0,2,7,71.43,0,2,5,7,-28.57,1,3,3,7,-28.57,0,0,0,0, ,3,0,3,100.00,0,0,0,0, 
11701,AUS,1,Graham Beau ,MB,7,0,0,7.69,7,7,1,4,12,50.00,0,2,2,4,-50.00,0,2,8,10,-20.00,0,0,0,0, ,0,1,1,-100.00,0,0,0,0, 
11701,AUS,2,Dosanjh Arshdeep ,S,2,1,0,-30.77,3,2,0,1,3,66.67,1,2,0,3,-33.33,0,5,2,7,-71.43,0,0,0,0, ,3,1,4,50.00,12,3,36,51,17.65
11701,AUS,7,Weir James ,MB,2,1,0,-5.26,3,2,0,1,3,66.67,1,3,1,5,-40.00,0,1,10,11,-9.09,0,0,0,0, ,1,2,3,-33.33,0,0,0,0, 
11701,AUS,8,O'Dea Trent ,MB,0,0,0, ,0,0,0,0,0, ,0,0,0,0, ,0,0,0,0, ,0,0,0,0, ,0,0,0, ,0,0,0,0, 
11701,AUS,11,Perry Luke ,L,0,0,0, ,0,0,0,0,0, ,0,0,0,0, ,0,0,0,0, ,5,0,12,17,29.41,6,4,11,18.18,0,0,3,3,0.00
11701,AUS,12,Mote Nehemiah ,MB,5,1,0,4.00,6,5,1,4,10,40.00,1,3,2,6,-33.33,0,1,8,9,-11.11,1,0,1,2,50.00,2,0,2,100.00,0,0,0,0, 
11701,AUS,15,Smith Luke ,OH,10,0,0,-8.11,10,10,3,8,21,33.33,0,6,1,7,-85.71,0,4,5,9,-44.44,2,3,8,13,-7.69,0,0,0, ,0,0,0,0, 
11701,AUS,21,Butler Nicholas ,S,0,0,0, ,0,0,0,0,0, ,0,0,0,0, ,0,0,0,0, ,0,0,0,0, ,0,1,1,-100.00,3,0,3,6,50.00
11701,AUS,27,Senica Max ,OH,0,0,0, ,0,0,0,0,0, ,0,0,0,0, ,0,0,0,0, ,0,0,0,0, ,0,0,0, ,0,0,0,0, 
11701,AUS,28,Taylor Tim ,OH,0,0,0, ,0,0,0,0,0, ,0,0,0,0, ,0,0,0,0, ,0,0,0,0, ,0,0,0, ,0,0,0,0, 
11701,AUS,29,Garrett Ethan ,OH,2,0,0,-27.27,2,2,3,5,10,-10.00,0,3,0,3,-100.00,0,2,7,9,-22.22,5,2,14,21,14.29,2,2,4,0.00,0,0,0,0, 
11701,AUS,31,Aubrey Matthew ,O,0,0,0,-66.67,0,0,1,1,2,-50.00,0,1,0,1,-100.00,0,0,0,0, ,0,0,0,0, ,0,0,0, ,0,0,0,0, 
11701,AUS,33,Flowerday Sam ,OH,0,0,0, ,0,0,0,0,0, ,0,0,0,0, ,0,0,0,0, ,0,0,0,0, ,0,0,0, ,0,0,0,0, 
11701,AUS,34,Greber Billy ,L,0,0,0, ,0,0,0,0,0, ,0,0,0,0, ,0,0,0,0, ,0,0,0,0, ,0,0,0, ,0,0,0,0, 
11702,JPN,1,Shimizu Kunihiro ,O,3,0,0,11.76,3,3,1,4,8,25.00,0,0,0,0, ,0,0,9,9,0.00,0,0,0,0, ,0,0,0, ,0,0,1,1,0.00
11702,JPN,2,Onodera Taishi ,MB,4,0,0,15.79,4,4,0,3,7,57.14,0,0,1,1,0.00,0,1,10,11,-9.09,0,0,0,0, ,1,0,1,100.00,0,0,0,0, 
11702,JPN,3,Fujii Naonobu ,S,0,0,0,0.00,0,0,0,1,1,0.00,0,0,0,0, ,0,0,10,10,0.00,0,0,0,0, ,0,0,1,0.00,3,0,71,74,4.05
11702,JPN,5,Fukuzawa Tatsuya ,OH,0,0,0, ,0,0,0,0,0, ,0,0,0,0, ,0,0,0,0, ,0,0,0,0, ,0,0,0, ,0,0,0,0, 
11702,JPN,6,Yamauchi Akihiro ,MB,2,3,0,8.33,5,2,1,5,8,12.50,3,2,0,5,20.00,0,0,11,11,0.00,0,0,0,0, ,0,0,0, ,0,1,0,1,-100.00
11702,JPN,12,Sekita Masahiro ,S,0,0,0,-33.33,0,0,0,0,0, ,0,0,0,0, ,0,1,2,3,-33.33,0,0,0,0, ,0,0,0, ,1,0,14,15,6.67
11702,JPN,14,Ishikawa Yuki ,OH,15,2,1,17.78,18,15,7,9,31,25.81,2,0,0,2,100.00,1,3,8,12,-16.67,8,1,4,13,53.85,0,0,0, ,0,0,0,0, 
11702,JPN,15,Ri Haku ,MB,0,0,0, ,0,0,0,0,0, ,0,0,0,0, ,0,0,0,0, ,0,0,0,0, ,0,0,0, ,0,0,0,0, 
11702,JPN,16,Takahashi Kentaro ,MB,0,0,0, ,0,0,0,0,0, ,0,0,0,0, ,0,0,0,0, ,0,0,0,0, ,0,0,0, ,0,0,0,0, 
11702,JPN,17,Takanashi Kenta ,OH,0,0,0, ,0,0,0,0,0, ,0,0,0,0, ,0,0,0,0, ,0,0,0,0, ,0,0,0, ,0,0,0,0, 
11702,JPN,19,Otsuka Tatsunori ,OH,8,0,0,36.84,8,8,0,5,13,61.54,0,1,0,1,-100.00,0,0,5,5,0.00,0,0,0,0, ,0,0,0, ,0,0,1,1,0.00
11702,JPN,20,Yamamoto Tomohiro ,L,0,0,0, ,0,0,0,0,0, ,0,0,0,0, ,0,0,0,0, ,9,0,9,18,50.00,8,0,8,100.00,0,0,2,2,0.00
11702,JPN,21,Takahashi Ran ,OH,13,2,1,23.26,16,13,4,9,26,34.62,2,0,1,3,66.67,1,2,11,14,-7.14,8,0,11,19,42.11,1,0,1,100.00,0,0,0,0, 
11702,JPN,24,Ogawa Tomohiro ,L,0,0,0, ,0,0,0,0,0, ,0,0,0,0, ,0,0,0,0, ,0,0,0,0, ,0,0,0, ,0,0,0,0, 
11702,IRI,2,Ebadipour Ghara H. Milad ,OH,7,4,0,11.11,11,7,5,9,21,9.52,4,0,0,4,100.00,0,2,9,11,-18.18,19,0,18,37,51.35,0,0,0, ,0,0,2,2,0.00
11702,IRI,3,Abedini Reza ,MB,0,0,0, ,0,0,0,0,0, ,0,0,0,0, ,0,0,0,0, ,0,0,0,0, ,0,0,0, ,0,0,0,0, 
11702,IRI,6,Mousavi Eraghi Seyed Mohammad ,MB,5,0,0,18.75,5,5,0,4,9,55.56,0,0,0,0, ,0,2,5,7,-28.57,1,0,0,1,100.00,1,0,1,100.00,0,0,0,0, 
11702,IRI,7,Fayazi D. Purya ,OH,2,0,0,0.00,2,2,1,6,9,11.11,0,0,0,0, ,0,1,11,12,-8.33,6,2,10,18,22.22,1,0,1,100.00,1,0,1,2,50.00
11702,IRI,8,Hazratpourtalatappeh Mohammadreza ,L,0,0,0, ,0,0,0,0,0, ,0,0,0,0, ,0,0,0,0, ,4,0,4,8,50.00,3,0,3,100.00,0,0,4,4,0.00
11702,IRI,9,Gholami Masoud ,MB,0,0,0, ,0,0,0,0,0, ,0,0,0,0, ,0,0,0,0, ,0,0,0,0, ,0,0,0, ,0,0,0,0, 
11702,IRI,10,Ghafour Amir ,O,15,0,0,23.53,15,15,4,7,26,42.31,0,0,0,0, ,0,3,5,8,-37.50,0,0,0,0, ,0,0,1,0.00,0,0,2,2,0.00
11702,IRI,11,Kazemi Saber ,O,0,0,0,-50.00,0,0,0,0,0, ,0,0,0,0, ,0,1,1,2,-50.00,0,0,0,0, ,0,0,0, ,0,0,0,0, 
11702,IRI,15,Mojarad Aliasghar ,MB,6,2,0,35.29,8,6,0,3,9,66.67,2,0,0,2,100.00,0,2,4,6,-33.33,0,0,0,0, ,0,0,0, ,0,0,0,0, 
11702,IRI,16,Shafiei Ali ,MB,0,0,0, ,0,0,0,0,0, ,0,0,0,0, ,0,0,0,0, ,0,0,0,0, ,0,0,0, ,0,0,0,0, 
11702,IRI,17,Salehi Meisam ,OH,6,0,0,13.33,6,6,2,2,10,40.00,0,0,0,0, ,0,2,3,5,-40.00,1,0,3,4,25.00,0,0,0, ,0,0,0,0, 
11702,IRI,18,Vadi Mohammad Taher ,S,0,2,1,7.69,3,0,0,0,0, ,2,0,0,2,100.00,1,2,8,11,-9.09,0,0,0,0, ,0,0,0, ,8,1,66,75,9.33
11702,IRI,21,Salehi Arman ,L,0,0,0, ,0,0,0,0,0, ,0,0,0,0, ,0,0,0,0, ,0,0,0,0, ,0,0,0, ,0,0,0,0, 
11702,IRI,22,Esfandiar Amirhossein ,OH,0,0,0,-25.00,0,0,0,0,0, ,0,0,0,0, ,0,1,3,4,-25.00,0,0,0,0, ,0,0,0, ,0,0,0,0, 
11703,SRB,2,Kovacevic Uros ,OH,18,4,0,15.79,22,18,7,9,34,32.35,4,2,0,6,33.33,0,4,13,17,-23.53,5,1,13,19,21.05,6,3,10,30.00,0,0,3,3,0.00
11703,SRB,3,Kapur Milorad ,L,0,0,0, ,0,0,0,0,0, ,0,0,0,0, ,0,0,0,0, ,0,0,0,0, ,0,0,0, ,0,0,0,0, 
11703,SRB,6,Pekovic Nikola ,L,0,0,0, ,0,0,0,0,0, ,0,0,0,0, ,0,0,0,0, ,6,2,11,19,21.05,3,0,3,100.00,0,0,3,3,0.00
11703,SRB,7,Krsmanovic Petar ,MB,3,1,0,-12.00,4,3,2,2,7,14.29,1,3,1,5,-40.00,0,2,11,13,-15.38,2,0,3,5,40.00,2,1,3,33.33,0,0,0,0, 
11703,SRB,8,Ivovic Marko ,OH,11,2,0,8.33,13,11,3,9,23,34.78,2,4,0,6,-33.33,0,2,17,19,-10.53,13,1,19,33,36.36,5,1,7,57.14,0,0,1,1,0.00
11703,SRB,9,Jovovic Nikola ,S,0,2,0,-14.29,2,0,0,0,0, ,2,2,0,4,0.00,0,3,14,17,-17.65,0,0,1,1,0.00,11,3,14,57.14,36,0,71,107,33.64
11703,SRB,11,Batak Aleksa ,S,0,0,0, ,0,0,0,0,0, ,0,0,0,0, ,0,0,0,0, ,0,0,0,0, ,0,0,0, ,1,0,1,2,50.00
11703,SRB,12,Peric Pavle ,OH,0,0,0, ,0,0,0,0,0, ,0,0,0,0, ,0,0,0,0, ,0,0,0,0, ,0,0,0, ,0,0,0,0, 
11703,SRB,13,Simic Stevan ,MB,0,0,0, ,0,0,0,0,0, ,0,0,0,0, ,0,0,0,0, ,0,0,0,0, ,0,0,0, ,0,0,0,0, 
11703,SRB,14,Atanasijevic Aleksandar ,O,0,0,0, ,0,0,0,0,0, ,0,0,0,0, ,0,0,0,0, ,0,0,0,0, ,0,0,0, ,0,0,0,0, 
11703,SRB,16,Luburic Drazen ,O,27,1,1,20.00,29,27,6,11,44,47.73,1,4,1,6,-50.00,1,6,8,15,-33.33,0,0,0,0, ,3,1,4,50.00,0,0,1,1,0.00
11703,SRB,18,Podrascanin Marko ,MB,4,4,2,2.38,10,4,1,1,6,50.00,4,6,2,12,-16.67,2,2,20,24,0.00,0,0,1,1,0.00,4,0,4,100.00,0,0,1,1,0.00
11703,SRB,20,Lisinac Srecko ,MB,3,0,0,9.09,3,3,0,4,7,42.86,0,2,0,2,-100.00,0,0,2,2,0.00,0,0,1,1,0.00,1,0,1,100.00,0,0,1,1,0.00
11703,SRB,26,Kovac Davide ,OH,0,0,0, ,0,0,0,0,0, ,0,0,0,0, ,0,0,0,0, ,0,0,0,0, ,0,0,0, ,0,0,0,0, 
11703,SLO,1,Å tern TonÄek ,O,13,1,0,-6.52,14,13,9,5,27,14.81,1,3,1,5,-40.00,0,5,9,14,-35.71,0,0,0,0, ,5,4,9,11.11,0,0,0,0, 
11703,SLO,2,Pajenk Alen ,MB,6,3,1,13.79,10,6,2,0,8,50.00,3,2,0,5,20.00,1,2,13,16,-6.25,0,0,0,0, ,1,1,2,0.00,0,0,0,0, 
11703,SLO,4,Kozamernik Jan ,MB,8,4,0,16.22,12,8,0,3,11,72.73,4,5,1,10,-10.00,0,1,15,16,-6.25,0,0,4,4,0.00,3,1,4,50.00,0,0,0,0, 
11703,SLO,6,Gasparini Mitja ,O,1,0,0,33.33,1,1,0,0,1,100.00,0,0,0,0, ,0,0,2,2,0.00,0,0,0,0, ,0,0,0, ,0,0,0,0, 
11703,SLO,9,Vincic Dejan ,S,0,0,1,-12.50,1,0,2,0,2,-100.00,0,1,1,2,-50.00,1,0,11,12,8.33,0,0,0,0, ,5,5,10,0.00,36,0,51,87,41.38
11703,SLO,10,Å talekar SaÅ¡o ,MB,0,0,0, ,0,0,0,0,0, ,0,0,0,0, ,0,0,0,0, ,0,0,0,0, ,0,0,0, ,0,0,0,0, 
11703,SLO,11,Å tern Å½iga ,OH,2,0,0,50.00,2,2,0,0,2,100.00,0,0,0,0, ,0,0,2,2,0.00,0,0,2,2,0.00,0,2,2,-100.00,0,0,0,0, 
11703,SLO,12,Klobucar Jan ,L,0,0,0, ,0,0,0,0,0, ,0,0,0,0, ,0,0,0,0, ,0,0,1,1,0.00,1,0,1,100.00,0,0,0,0, 
11703,SLO,13,KovaÄiÄ Jani ,L,0,0,0, ,0,0,0,0,0, ,0,0,0,0, ,0,0,0,0, ,7,0,13,20,35.00,5,5,11,0.00,0,0,6,6,0.00
11703,SLO,15,VideÄnik Matic ,MB,0,0,0, ,0,0,0,0,0, ,0,0,0,0, ,0,0,0,0, ,0,0,0,0, ,0,0,0, ,0,0,0,0, 
11703,SLO,16,Ropret Gregor ,S,0,0,1,0.00,1,0,0,1,1,0.00,0,1,2,3,-33.33,1,0,3,4,25.00,0,0,0,0, ,0,0,1,0.00,7,0,7,14,50.00
11703,SLO,17,Urnaut Tine ,OH,14,0,0,13.64,14,14,4,14,32,31.25,0,0,1,1,0.00,0,4,7,11,-36.36,4,3,19,26,3.85,3,4,8,-12.50,0,0,0,0, 
11703,SLO,18,Äebulj Klemen ,OH,9,1,1,0.00,11,9,4,14,27,18.52,1,2,1,4,-25.00,1,5,13,19,-21.05,15,0,20,35,42.86,4,5,11,-9.09,0,1,2,3,-33.33
11703,SLO,19,MoÅ¾iÄ Rok ,OH,0,0,0, ,0,0,0,0,0, ,0,0,0,0, ,0,0,0,0, ,0,0,0,0, ,0,0,0, ,0,0,0,0, 
11704,NED,4,Ter Horst Thijs ,OH,3,1,0,37.50,4,3,0,1,4,75.00,1,0,1,2,50.00,0,1,1,2,-50.00,0,0,3,3,0.00,1,0,2,50.00,0,0,0,0, 
11704,NED,5,van der Ent Luuc ,MB,1,2,0,-23.53,3,1,0,3,4,25.00,2,9,6,17,-41.18,0,2,11,13,-15.38,0,0,0,0, ,3,1,4,50.00,0,0,0,0, 
11704,NED,6,Dronkers Just ,L,0,0,0, ,0,0,0,0,0, ,0,0,0,0, ,0,0,0,0, ,8,5,21,34,8.82,9,4,13,38.46,0,0,3,3,0.00
11704,NED,7,Jorna Gijs ,OH,0,0,0,0.00,0,0,0,0,0, ,0,0,0,0, ,0,0,1,1,0.00,0,0,0,0, ,0,2,2,-100.00,0,0,0,0, 
11704,NED,10,van Zeist Maikel ,MB,0,0,0,-100.00,0,0,0,0,0, ,0,0,0,0, ,0,1,0,1,-100.00,0,0,0,0, ,0,0,0, ,0,0,0,0, 
11704,NED,12,Tuinstra Bennie Junior ,OH,12,1,0,14.29,13,12,1,10,23,47.83,1,4,0,5,-60.00,0,2,12,14,-14.29,4,2,14,20,10.00,2,1,4,25.00,0,0,1,1,0.00
11704,NED,13,Ottevanger Steven ,L,0,0,0, ,0,0,0,0,0, ,0,0,0,0, ,0,0,0,0, ,0,0,0,0, ,1,0,1,100.00,0,0,0,0, 
11704,NED,14,Abdel-Aziz Nimir ,O,23,0,6,24.19,29,23,8,6,37,40.54,0,1,1,2,-50.00,6,5,12,23,4.35,0,1,1,2,-50.00,6,0,7,85.71,0,0,1,1,0.00
11704,NED,15,van Solkema Gijs ,S,0,0,0, ,0,0,0,0,0, ,0,0,0,0, ,0,0,0,0, ,0,0,0,0, ,0,0,0, ,1,0,3,4,25.00
11704,NED,17,Parkinson Michael ,MB,6,2,0,7.41,8,6,0,1,7,85.71,2,5,4,11,-27.27,0,1,8,9,-11.11,0,0,0,0, ,1,0,1,100.00,0,0,0,0, 
11704,NED,19,de Weijer Freek ,S,0,0,0,-25.00,0,0,0,0,0, ,0,1,2,3,-33.33,0,3,10,13,-23.08,0,0,0,0, ,2,0,4,50.00,26,0,53,79,32.91
11704,NED,21,van Schie Stijn ,OH,4,0,0,-19.23,4,4,5,4,13,-7.69,0,1,1,2,-50.00,0,3,8,11,-27.27,3,2,10,15,6.67,8,1,9,77.78,0,0,0,0, 
11704,NED,22,Wiltenburg Twan ,MB,0,0,0, ,0,0,0,0,0, ,0,0,0,0, ,0,0,0,0, ,0,0,0,0, ,0,0,0, ,0,0,0,0, 
11704,NED,25,van Tilburg Stijn ,OH,0,0,0,0.00,0,0,0,1,1,0.00,0,0,0,0, ,0,0,0,0, ,0,0,0,0, ,0,0,0, ,0,0,0,0, 
11704,RUS,1,Podlesnykh Yaroslav ,OH,5,0,0,0.00,5,5,0,7,12,41.67,0,2,4,6,-33.33,0,3,7,10,-30.00,5,2,13,20,15.00,4,1,6,50.00,0,0,1,1,0.00
11704,RUS,2,Vlasov Ilia ,MB,5,6,0,12.50,11,5,1,4,10,40.00,6,4,4,14,14.29,0,2,6,8,-25.00,0,0,1,1,0.00,0,0,0, ,0,0,0,0, 
11704,RUS,4,Volvich Artem ,MB,10,0,3,7.89,13,10,1,1,12,75.00,0,9,2,11,-81.82,3,0,12,15,20.00,0,0,0,0, ,1,1,2,0.00,0,0,0,0, 
11704,RUS,5,Semyshev Anton ,OH,0,0,0, ,0,0,0,0,0, ,0,0,0,0, ,0,0,0,0, ,0,0,0,0, ,0,0,0, ,0,0,0,0, 
11704,RUS,6,Baranov Evgeny ,L,0,0,0, ,0,0,0,0,0, ,0,0,0,0, ,0,0,0,0, ,0,0,0,0, ,0,0,0, ,0,0,0,0, 
11704,RUS,7,Volkov Dmitry ,OH,0,0,0, ,0,0,0,0,0, ,0,0,0,0, ,0,0,0,0, ,0,0,0,0, ,0,0,0, ,0,0,0,0, 
11704,RUS,10,Bogdan Denis ,OH,2,0,2,-6.25,4,2,1,3,6,16.67,0,2,0,2,-100.00,2,2,4,8,0.00,2,1,2,5,20.00,1,0,1,100.00,0,0,0,0, 
11704,RUS,11,Pankov Pavel ,S,0,0,2,-33.33,2,0,0,0,0, ,0,2,0,2,-100.00,2,4,4,10,-20.00,0,0,1,1,0.00,1,2,3,-33.33,17,0,20,37,45.95
11704,RUS,15,Poletaev Victor ,O,0,0,0,0.00,0,0,0,0,0, ,0,0,0,0, ,0,0,3,3,0.00,0,0,0,0, ,0,0,0, ,0,0,0,0, 
11704,RUS,17,Mikhaylov Maxim ,O,17,4,3,23.33,24,17,7,8,32,31.25,4,1,1,6,50.00,3,2,17,22,4.55,1,0,1,2,50.00,7,1,8,75.00,0,0,0,0, 
11704,RUS,18,Kliuka Egor ,OH,11,0,0,5.26,11,11,1,8,20,50.00,0,4,2,6,-66.67,0,4,8,12,-33.33,7,2,12,21,23.81,7,3,11,36.36,0,0,3,3,0.00
11704,RUS,20,Kurkaev Ilyas ,MB,0,0,0, ,0,0,0,0,0, ,0,0,0,0, ,0,0,0,0, ,0,0,0,0, ,0,0,0, ,0,0,0,0, 
11704,RUS,24,Kobzar Igor ,S,1,0,0,0.00,1,1,0,1,2,50.00,0,0,1,1,0.00,0,1,3,4,-25.00,0,0,0,0, ,2,1,3,33.33,21,0,23,44,47.73
11704,RUS,27,Golubev Valentin ,L,0,0,0, ,0,0,0,0,0, ,0,0,0,0, ,0,0,0,0, ,5,1,13,19,21.05,8,7,15,6.67,0,0,3,3,0.00
11705,USA,5,Ensing Kyle ,O,11,1,1,4.08,13,11,4,18,33,21.21,1,2,2,5,-20.00,1,5,5,11,-36.36,1,0,0,1,100.00,6,2,8,50.00,0,0,0,0, 
11705,USA,7,Shoji Kawika ,S,0,0,0, ,0,0,0,0,0, ,0,0,0,0, ,0,0,0,0, ,0,0,0,0, ,0,0,0, ,0,0,0,0, 
11705,USA,8,Defalco Torey ,OH,13,1,1,15.38,15,13,6,5,24,29.17,1,0,2,3,33.33,1,3,8,12,-16.67,5,1,12,18,22.22,8,3,11,45.45,0,0,0,0, 
11705,USA,9,Hanes Jake ,O,0,0,0, ,0,0,0,0,0, ,0,0,0,0, ,0,0,0,0, ,0,0,0,0, ,0,0,0, ,0,0,0,0, 
11705,USA,11,Christenson Micah ,S,3,1,1,13.04,5,3,0,3,6,50.00,1,2,1,4,-25.00,1,0,12,13,7.69,0,0,0,0, ,2,0,2,100.00,29,0,59,88,32.95
11705,USA,12,Holt Maxwell ,MB,3,1,1,-4.35,5,3,0,4,7,42.86,1,1,3,5,0.00,1,5,5,11,-36.36,0,0,1,1,0.00,2,0,2,100.00,1,0,0,1,100.00
11705,USA,13,Patch Benjamin ,O,0,0,0, ,0,0,0,0,0, ,0,0,0,0, ,0,0,0,0, ,0,0,0,0, ,0,0,0, ,0,0,0,0, 
11705,USA,15,Sander Brenden ,OH,0,0,0, ,0,0,0,0,0, ,0,0,0,0, ,0,0,0,0, ,0,0,0,0, ,0,0,0, ,0,0,0,0, 
11705,USA,17,Jaeschke Thomas ,OH,0,0,0, ,0,0,0,0,0, ,0,0,0,0, ,0,0,0,0, ,0,0,0,0, ,0,0,0, ,0,0,0,0, 
11705,USA,18,Muagututia Garrett ,OH,5,0,0,3.70,5,5,2,8,15,20.00,0,0,0,0, ,0,2,10,12,-16.67,10,2,12,24,33.33,4,2,6,33.33,0,0,0,0, 
11705,USA,19,Averill Taylor ,MB,8,1,0,16.13,9,8,0,4,12,66.67,1,3,0,4,-50.00,0,1,14,15,-6.67,0,0,0,0, ,2,1,3,33.33,0,0,0,0, 
11705,USA,20,Smith David ,MB,0,0,0, ,0,0,0,0,0, ,0,0,0,0, ,0,0,0,0, ,0,0,0,0, ,0,0,0, ,0,0,0,0, 
11705,USA,21,Watten Dustin ,L,0,0,0, ,0,0,0,0,0, ,0,0,0,0, ,0,0,0,0, ,0,0,0,0, ,0,0,0, ,0,0,0,0, 
11705,USA,22,Shoji Erik ,L,0,0,0, ,0,0,0,0,0, ,0,0,0,0, ,0,0,0,0, ,3,0,7,10,30.00,16,3,19,68.42,0,0,2,2,0.00
11705,CAN,2,Perrin John Gordon ,OH,6,0,0,9.68,6,6,0,12,18,33.33,0,2,2,4,-50.00,0,1,8,9,-11.11,3,1,9,13,15.38,4,1,5,60.00,0,1,0,1,-100.00
11705,CAN,4,Hoag Nicholas ,OH,0,0,0,0.00,0,0,0,1,1,0.00,0,0,0,0, ,0,0,2,2,0.00,0,0,0,0, ,0,0,0, ,0,0,0,0, 
11705,CAN,6,Pereira Jordan ,OH,0,0,0, ,0,0,0,0,0, ,0,0,0,0, ,0,0,0,0, ,0,0,0,0, ,0,0,0, ,0,0,0,0, 
11705,CAN,7,Maar Stephen Timothy ,OH,8,1,0,0.00,9,8,5,5,18,16.67,1,0,1,2,50.00,0,4,1,5,-80.00,2,1,10,13,7.69,5,1,6,66.67,0,0,0,0, 
11705,CAN,8,Blankenau Jay ,S,2,1,0,16.67,3,2,0,1,3,66.67,1,1,1,3,0.00,0,0,6,6,0.00,0,0,1,1,0.00,6,3,10,30.00,14,0,58,72,19.44
11705,CAN,10,Sclater Ryan Joseph ,O,1,1,0,12.50,2,1,1,3,5,0.00,1,0,0,1,100.00,0,0,2,2,0.00,0,0,0,0, ,0,0,0, ,0,0,0,0, 
11705,CAN,11,Jansen Vandoorn Daniel ,MB,3,0,0,20.00,3,3,0,0,3,100.00,0,1,1,2,-50.00,0,0,5,5,0.00,0,0,0,0, ,0,0,0, ,0,0,0,0, 
11705,CAN,13,Vernon-Evans Sharone ,O,4,1,2,-3.03,7,4,6,7,17,-11.76,1,1,2,4,0.00,2,1,9,12,8.33,0,0,0,0, ,4,0,4,100.00,0,0,0,0, 
11705,CAN,14,Loeppky Eric ,OH,0,0,0,-42.86,0,0,2,2,4,-50.00,0,0,0,0, ,0,1,2,3,-33.33,2,1,6,9,11.11,1,1,2,0.00,0,0,0,0, 
11705,CAN,17,Vigrass Graham ,MB,5,1,0,17.39,6,5,0,3,8,62.50,1,2,2,5,-20.00,0,0,10,10,0.00,1,1,0,2,0.00,2,0,2,100.00,0,1,0,1,-100.00
11705,CAN,19,Bann Blair Cameron ,L,0,0,0, ,0,0,0,0,0, ,0,0,0,0, ,0,0,0,0, ,9,0,10,19,47.37,12,5,17,41.18,0,0,2,2,0.00
11705,CAN,20,Szwarc Arthur ,O,1,1,1,-17.65,3,1,2,0,3,-33.33,1,3,2,6,-33.33,1,1,6,8,0.00,0,0,0,0, ,0,0,0, ,0,0,1,1,0.00
11705,CAN,21,Walsh Brett James ,S,0,0,0,-100.00,0,0,0,0,0, ,0,0,0,0, ,0,1,0,1,-100.00,0,0,1,1,0.00,2,0,2,100.00,4,0,0,4,100.00
11705,CAN,23,Demyanenko Danny ,MB,0,0,0, ,0,0,0,0,0, ,0,0,0,0, ,0,0,0,0, ,0,0,0,0, ,0,0,0, ,0,0,0,0, 
11706,POL,2,Muzaj Maciej ,O,11,0,3,16.00,14,11,1,13,25,40.00,0,2,3,5,-40.00,3,3,14,20,0.00,0,0,0,0, ,5,0,6,83.33,0,0,0,0, 
11706,POL,6,Kurek Bartosz ,O,0,0,0, ,0,0,0,0,0, ,0,0,0,0, ,0,0,0,0, ,0,0,0,0, ,0,0,0, ,0,0,0,0, 
11706,POL,9,Leon Venero Wilfredo ,OH,0,0,0, ,0,0,0,0,0, ,0,0,0,0, ,0,0,0,0, ,0,0,0,0, ,0,0,0, ,0,0,0,0, 
11706,POL,10,Wojtaszek Damian ,L,0,0,0, ,0,0,0,0,0, ,0,0,0,0, ,0,0,0,0, ,4,0,5,9,44.44,6,1,8,62.50,0,0,0,0, 
11706,POL,11,Drzyzga Fabian ,S,0,0,0, ,0,0,0,0,0, ,0,0,0,0, ,0,0,0,0, ,0,0,0,0, ,0,0,0, ,0,0,0,0, 
11706,POL,12,Lomacz Grzegorz ,S,1,0,0,-11.11,1,1,0,0,1,100.00,0,1,0,1,-100.00,0,1,6,7,-14.29,0,0,0,0, ,4,0,5,80.00,30,0,0,30,100.00
11706,POL,15,Kochanowski Jakub ,MB,0,0,0, ,0,0,0,0,0, ,0,0,0,0, ,0,0,0,0, ,0,0,0,0, ,0,0,0, ,0,0,0,0, 
11706,POL,16,Semeniuk Kamil ,OH,0,0,0, ,0,0,0,0,0, ,0,0,0,0, ,0,0,0,0, ,0,0,0,0, ,0,0,0, ,0,0,0,0, 
11706,POL,17,Zatorski Pawel ,L,0,0,0, ,0,0,0,0,0, ,0,0,0,0, ,0,0,0,0, ,0,0,0,0, ,0,0,0, ,0,0,0,0, 
11706,POL,20,Bieniek Mateusz ,MB,8,2,2,19.44,12,8,1,2,11,63.64,2,2,7,11,0.00,2,2,10,14,0.00,1,0,0,1,100.00,3,1,5,40.00,0,0,0,0, 
11706,POL,21,Fornal Tomasz ,OH,9,0,1,14.29,10,9,2,4,15,46.67,0,2,0,2,-100.00,1,2,8,11,-9.09,12,0,8,20,60.00,9,2,11,63.64,0,0,0,0, 
11706,POL,22,Bednorz Bartosz ,OH,3,1,3,-11.76,7,3,5,10,18,-11.11,1,2,1,4,-25.00,3,4,5,12,-8.33,8,0,6,14,57.14,3,1,5,40.00,0,0,0,0, 
11706,POL,77,Klos Karol ,MB,7,5,0,21.05,12,7,1,1,9,66.67,5,2,13,20,15.00,0,1,8,9,-11.11,0,0,0,0, ,2,1,4,25.00,0,0,0,0, 
11706,POL,99,Huber Norbert ,MB,0,0,0, ,0,0,0,0,0, ,0,0,0,0, ,0,0,0,0, ,0,0,0,0, ,0,0,0, ,0,0,0,0, 
11706,ITA,7,Balaso Fabio ,L,0,0,0, ,0,0,0,0,0, ,0,0,0,0, ,0,0,0,0, ,6,4,15,25,8.00,7,2,10,50.00,0,0,0,0, 
11706,ITA,11,Galassi Gianluca ,MB,4,2,0,0.00,6,4,0,4,8,50.00,2,4,2,8,-25.00,0,2,9,11,-18.18,0,0,0,0, ,2,0,2,100.00,0,0,0,0, 
11706,ITA,15,Sbertoli Riccardo ,S,1,1,0,-7.14,2,1,1,0,2,0.00,1,1,2,4,0.00,0,1,7,8,-12.50,0,0,1,1,0.00,5,1,9,44.44,22,0,1,23,95.65
11706,ITA,18,Michieletto Alessandro ,OH,7,0,0,12.12,7,7,1,13,21,28.57,0,0,1,1,0.00,0,2,9,11,-18.18,2,3,15,20,-5.00,2,0,3,66.67,0,0,0,0, 
11706,ITA,20,Nelli Gabriele ,O,10,0,0,-2.94,10,10,5,8,23,21.74,0,1,1,2,-50.00,0,5,4,9,-55.56,0,0,0,0, ,7,3,15,26.67,0,0,0,0, 
11706,ITA,21,Spirito Luca ,S,0,0,0, ,0,0,0,0,0, ,0,0,0,0, ,0,0,0,0, ,0,0,0,0, ,1,1,2,0.00,1,0,0,1,100.00
11706,ITA,23,Pinali Giulio ,O,0,0,0,0.00,0,0,0,1,1,0.00,0,0,0,0, ,0,0,0,0, ,0,0,0,0, ,0,0,0, ,0,0,0,0, 
11706,ITA,24,Cavuto Oreste ,OH,0,0,0, ,0,0,0,0,0, ,0,0,0,0, ,0,0,0,0, ,0,0,0,0, ,0,0,0, ,0,0,0,0, 
11706,ITA,26,Cortesia Lorenzo ,MB,1,1,0,-5.88,2,1,0,1,2,50.00,1,2,4,7,-14.29,0,1,7,8,-12.50,0,0,0,0, ,0,0,0, ,0,0,0,0, 
11706,ITA,27,Scanferla Leonardo ,L,0,0,0, ,0,0,0,0,0, ,0,0,0,0, ,0,0,0,0, ,0,0,0,0, ,0,0,0, ,0,0,0,0, 
11706,ITA,28,Recine Francesco ,OH,1,0,0,-20.00,1,1,0,0,1,100.00,0,1,0,1,-100.00,0,1,2,3,-33.33,1,0,4,5,20.00,1,0,2,50.00,0,0,0,0, 
11706,ITA,29,Bottolo Mattia ,OH,9,2,0,2.33,11,9,5,13,27,14.81,2,2,4,8,0.00,0,3,5,8,-37.50,2,1,4,7,14.29,3,1,4,50.00,0,0,0,0, 
11706,ITA,30,Mosca Leandro Ausibio ,MB,0,0,0,0.00,0,0,0,0,0, ,0,0,1,1,0.00,0,0,1,1,0.00,0,0,0,0, ,0,0,0, ,0,0,0,0, 
11706,ITA,31,Federici Filippo ,L,0,0,0, ,0,0,0,0,0, ,0,0,0,0, ,0,0,0,0, ,0,1,1,2,-50.00,0,0,0, ,0,0,0,0, 
11707,BRA,1,Rezende Bruno Mossa ,S,2,0,2,-4.76,4,2,0,1,3,66.67,0,2,0,2,-100.00,2,3,11,16,-6.25,0,0,1,1,0.00,6,3,9,33.33,19,0,52,71,26.76
11707,BRA,5,Borges Almeida Silva Mauricio ,OH,0,0,0, ,0,0,0,0,0, ,0,0,0,0, ,0,0,0,0, ,0,0,0,0, ,0,0,0, ,0,0,0,0, 
11707,BRA,6,Gil Kreling Fernando ,S,0,0,0, ,0,0,0,0,0, ,0,0,0,0, ,0,0,0,0, ,0,0,0,0, ,0,1,1,-100.00,0,0,1,1,0.00
11707,BRA,8,De Souza Wallace ,O,7,0,1,-17.50,8,7,9,3,19,-10.53,0,4,0,4,-100.00,1,2,14,17,-5.88,0,0,1,1,0.00,6,0,6,100.00,0,0,0,0, 
11707,BRA,9,Leal Hidalgo Yoandy ,OH,7,3,0,23.08,10,7,2,5,14,35.71,3,2,0,5,20.00,0,0,7,7,0.00,5,2,10,17,17.65,3,0,3,100.00,0,0,0,0, 
11707,BRA,10,Bispo dos Santos Matheus ,MB,0,0,0, ,0,0,0,0,0, ,0,0,0,0, ,0,0,0,0, ,0,0,0,0, ,0,0,0, ,0,0,0,0, 
11707,BRA,11,Kavalkievicz Gabriel ,OH,0,0,0, ,0,0,0,0,0, ,0,0,0,0, ,0,0,0,0, ,0,0,0,0, ,0,0,0, ,0,0,0,0, 
11707,BRA,12,Santos Isac ,MB,7,2,1,17.24,10,7,3,2,12,33.33,2,1,0,3,33.33,1,1,12,14,0.00,1,0,0,1,100.00,1,0,1,100.00,0,0,0,0, 
11707,BRA,14,Correia De Souza Douglas ,OH,6,0,0,30.00,6,6,2,0,8,50.00,0,0,0,0, ,0,1,1,2,-50.00,1,0,1,2,50.00,1,1,2,0.00,0,0,0,0, 
11707,BRA,15,Nascimento Maique Reis ,L,0,0,0, ,0,0,0,0,0, ,0,0,0,0, ,0,0,0,0, ,0,0,0,0, ,0,0,0, ,5,0,0,5,100.00
11707,BRA,17,Hoss Thales ,L,0,0,0, ,0,0,0,0,0, ,0,0,0,0, ,0,0,0,0, ,8,0,3,11,72.73,7,3,10,40.00,0,0,8,8,0.00
11707,BRA,18,Souza Ricardo Lucarelli ,OH,12,0,2,22.22,14,12,2,5,19,52.63,0,3,1,4,-75.00,2,1,10,13,7.69,11,1,10,22,45.45,5,2,7,42.86,0,0,0,0, 
11707,BRA,19,Moreira Roque Felipe ,O,0,0,0,0.00,0,0,0,3,3,0.00,0,0,0,0, ,0,0,0,0, ,0,0,0,0, ,0,0,0, ,0,0,0,0, 
11707,BRA,23,Resende Gualberto Flavio ,MB,3,1,1,8.70,5,3,1,2,6,33.33,1,1,3,5,0.00,1,1,10,12,0.00,0,0,0,0, ,2,1,3,33.33,0,0,0,0, 
11707,ARG,2,Pereyra Federico ,O,14,1,1,15.38,16,14,4,7,25,40.00,1,2,1,4,-25.00,1,4,5,10,-30.00,0,0,0,0, ,3,1,4,50.00,0,1,0,1,-100.00
11707,ARG,3,Martinez Franchi Jan ,OH,4,0,0,4.35,4,4,1,8,13,23.08,0,0,0,0, ,0,2,8,10,-20.00,4,0,8,12,33.33,4,1,5,60.00,0,0,0,0, 
11707,ARG,5,Uriarte Nicolas ,S,0,0,0,0.00,0,0,0,0,0, ,0,0,0,0, ,0,0,1,1,0.00,0,0,0,0, ,0,0,0, ,0,0,0,0, 
11707,ARG,7,Conte Facundo ,OH,9,3,1,2.63,13,9,7,4,20,10.00,3,2,0,5,20.00,1,3,9,13,-15.38,7,6,15,28,3.57,4,1,5,60.00,0,0,0,0, 
11707,ARG,11,SolÃ© Sebastian ,MB,5,2,0,-12.12,7,5,0,5,10,50.00,2,9,2,13,-53.85,0,2,8,10,-20.00,0,0,2,2,0.00,2,0,2,100.00,0,0,0,0, 
11707,ARG,15,De Cecco Luciano ,S,0,3,0,0.00,3,0,0,1,1,0.00,3,1,0,4,50.00,0,2,13,15,-13.33,0,0,0,0, ,0,2,2,-100.00,22,1,51,74,28.38
11707,ARG,16,Palonsky Luciano ,OH,1,0,0,33.33,1,1,0,1,2,50.00,0,0,0,0, ,0,0,1,1,0.00,0,1,2,3,-33.33,1,2,3,-33.33,0,0,0,0, 
11707,ARG,17,Mendez Nicolas ,OH,0,0,0, ,0,0,0,0,0, ,0,0,0,0, ,0,0,0,0, ,8,0,19,27,29.63,6,2,8,50.00,0,0,1,1,0.00
11707,ARG,18,Ramos Martin ,MB,5,4,1,21.74,10,5,1,1,7,57.14,4,2,0,6,33.33,1,2,7,10,-10.00,0,0,0,0, ,2,0,2,100.00,0,0,0,0, 
11708,GER,1,Fromm Christian ,OH,0,0,0, ,0,0,0,0,0, ,0,0,0,0, ,0,0,0,0, ,0,0,0,0, ,0,0,0, ,0,0,0,0, 
11708,GER,3,Schott Ruben ,OH,9,0,1,13.51,10,9,1,5,15,53.33,0,3,0,3,-100.00,1,1,17,19,0.00,13,1,16,30,40.00,7,0,7,100.00,0,0,0,0, 
11708,GER,5,Reichert Moritz ,OH,15,4,0,7.69,19,15,7,23,45,17.78,4,1,1,6,50.00,0,6,8,14,-42.86,12,0,16,28,42.86,7,3,11,36.36,0,0,0,0, 
11708,GER,6,Kaliberda Denys ,OH,0,0,0, ,0,0,0,0,0, ,0,0,0,0, ,0,0,0,0, ,0,0,0,0, ,0,0,0, ,0,0,0,0, 
11708,GER,7,Sossenheimer David ,OH,0,0,2,0.00,2,0,0,0,0, ,0,0,0,0, ,2,2,6,10,0.00,0,0,0,0, ,0,0,0, ,0,0,0,0, 
11708,GER,8,BÃ¶hme Marcus ,MB,8,1,0,16.67,9,8,0,4,12,66.67,1,5,0,6,-66.67,0,0,6,6,0.00,0,0,1,1,0.00,0,1,1,-100.00,0,0,0,0, 
11708,GER,10,Zenger Julian ,L,0,0,0, ,0,0,0,0,0, ,0,0,0,0, ,0,0,0,0, ,10,3,14,27,25.93,7,1,9,66.67,0,0,0,0, 
11708,GER,13,Hirsch Simon ,O,14,1,0,4.26,15,14,4,8,26,38.46,1,5,2,8,-50.00,0,4,9,13,-30.77,0,0,0,0, ,6,1,7,71.43,0,0,0,0, 
11708,GER,15,BaxpÃ¶hler Noah ,MB,0,0,0, ,0,0,0,0,0, ,0,0,0,0, ,0,0,0,0, ,0,0,0,0, ,0,0,0, ,0,0,0,0, 
11708,GER,16,BurggrÃ¤f Eric ,S,0,0,0,-50.00,0,0,0,0,0, ,0,0,0,0, ,0,1,1,2,-50.00,0,0,0,0, ,0,0,0, ,0,0,0,0, 
11708,GER,17,Zimmermann Jan ,S,1,2,1,5.26,4,1,0,0,1,100.00,2,1,3,6,16.67,1,2,9,12,-8.33,0,0,1,1,0.00,3,3,8,0.00,45,2,0,47,91.49
11708,GER,18,Krage Florian ,MB,1,1,0,-21.43,2,1,1,0,2,0.00,1,4,1,6,-50.00,0,0,6,6,0.00,1,1,1,3,0.00,1,1,2,0.00,0,0,0,0, 
11708,GER,20,Weber Linus ,O,7,1,1,11.54,9,7,2,4,13,38.46,1,1,0,2,0.00,1,3,7,11,-18.18,0,0,0,0, ,3,0,3,100.00,0,0,0,0, 
11708,GER,21,Krick Tobias ,MB,7,2,0,7.41,9,7,2,3,12,41.67,2,2,1,5,0.00,0,3,7,10,-30.00,0,0,1,1,0.00,1,0,1,100.00,0,0,0,0, 
11708,FRA,1,Chinenyeze BarthÃ©lÃ©my ,MB,8,3,0,7.89,11,8,1,4,13,53.85,3,3,3,9,0.00,0,4,12,16,-25.00,2,0,0,2,100.00,0,0,0, ,0,0,0,0, 
11708,FRA,4,Patry Jean ,O,0,0,0,-50.00,0,0,0,0,0, ,0,1,0,1,-100.00,0,0,1,1,0.00,0,0,0,0, ,1,0,1,100.00,0,0,0,0, 
11708,FRA,6,Toniutti Benjamin ,S,1,1,0,0.00,2,1,0,0,1,100.00,1,0,0,1,100.00,0,2,11,13,-15.38,0,0,0,0, ,3,2,5,20.00,25,0,0,25,100.00
11708,FRA,7,Tillie Kevin ,OH,0,0,0,-33.33,0,0,0,0,0, ,0,0,0,0, ,0,1,2,3,-33.33,0,0,0,0, ,0,0,0, ,0,0,0,0, 
11708,FRA,8,Lyneel Julien ,OH,0,0,0, ,0,0,0,0,0, ,0,0,0,0, ,0,0,0,0, ,3,0,10,13,23.08,6,2,8,50.00,0,0,0,0, 
11708,FRA,11,Brizard Antoine ,S,1,1,0,0.00,2,1,0,2,3,33.33,1,2,0,3,-33.33,0,0,8,8,0.00,0,0,0,0, ,2,1,5,20.00,15,0,2,17,88.24
11708,FRA,12,Boyer Stephen ,O,17,3,0,19.64,20,17,5,10,32,37.50,3,1,6,10,20.00,0,3,11,14,-21.43,0,0,0,0, ,7,4,11,27.27,0,0,0,0, 
11708,FRA,14,Le Goff Nicolas ,MB,0,0,0, ,0,0,0,0,0, ,0,0,0,0, ,0,0,0,0, ,0,0,0,0, ,0,0,0, ,0,0,0,0, 
11708,FRA,16,Bultor Daryl ,MB,12,1,0,5.71,13,12,1,0,13,84.62,1,5,2,8,-50.00,0,5,9,14,-35.71,0,0,0,0, ,2,0,2,100.00,0,0,0,0, 
11708,FRA,17,Clevenot Trevor ,OH,14,2,5,18.33,21,14,5,9,28,32.14,2,4,2,8,-25.00,5,1,18,24,16.67,17,0,12,29,58.62,9,2,12,58.33,0,0,1,1,0.00
11708,FRA,18,Rossard Thibault ,OH,9,0,0,11.11,9,9,1,11,21,38.10,0,1,0,1,-100.00,0,3,11,14,-21.43,7,2,10,19,26.32,2,2,5,0.00,0,0,0,0, 
11708,FRA,19,Louati Yacine ,OH,1,0,0,-25.00,1,1,2,4,7,-14.29,0,1,0,1,-100.00,0,1,3,4,-25.00,7,0,2,9,77.78,2,0,2,100.00,0,0,0,0, 
11708,FRA,20,Diez Benjamin ,L,0,0,0, ,0,0,0,0,0, ,0,0,0,0, ,0,0,0,0, ,2,3,4,9,-11.11,3,4,7,-14.29,0,0,0,0, 
11708,FRA,24,Gueye Mousse ,MB,0,0,0, ,0,0,0,0,0, ,0,0,0,0, ,0,0,0,0, ,0,0,0,0, ,0,0,0, ,0,0,0,0, 
11709,IRI,2,Ebadipour Ghara H. Milad ,OH,0,0,0, ,0,0,0,0,0, ,0,0,0,0, ,0,0,0,0, ,0,0,0,0, ,0,0,0, ,0,0,0,0, 
11709,IRI,6,Mousavi Eraghi Seyed Mohammad ,MB,0,0,0, ,0,0,0,0,0, ,0,0,0,0, ,0,0,0,0, ,0,0,0,0, ,0,0,0, ,0,0,0,0, 
11709,IRI,7,Fayazi D. Purya ,OH,0,0,0,0.00,0,0,0,1,1,0.00,0,0,0,0, ,0,0,1,1,0.00,1,1,1,3,0.00,1,0,1,100.00,0,0,0,0, 
11709,IRI,9,Gholami Masoud ,MB,5,1,1,-2.86,7,5,1,4,10,40.00,1,4,7,12,-25.00,1,3,9,13,-15.38,2,0,1,3,66.67,2,1,3,33.33,0,0,0,0, 
11709,IRI,10,Ghafour Amir ,O,0,0,0, ,0,0,0,0,0, ,0,0,0,0, ,0,0,0,0, ,0,0,0,0, ,0,0,0, ,0,0,0,0, 
11709,IRI,11,Kazemi Saber ,O,18,0,0,14.29,18,18,4,14,36,38.89,0,2,2,4,-50.00,0,4,12,16,-25.00,0,0,0,0, ,3,1,6,33.33,0,0,0,0, 
11709,IRI,12,Sharifi Morteza ,OH,0,0,0, ,0,0,0,0,0, ,0,0,0,0, ,0,0,0,0, ,0,0,0,0, ,0,0,0, ,0,0,0,0, 
11709,IRI,15,Mojarad Aliasghar ,MB,1,0,0,-60.00,1,1,0,0,1,100.00,0,3,0,3,-100.00,0,1,0,1,-100.00,0,0,0,0, ,0,0,0, ,0,0,0,0, 
11709,IRI,16,Shafiei Ali ,MB,0,1,0,-25.93,1,0,1,4,5,-20.00,1,5,3,9,-44.44,0,2,11,13,-15.38,0,0,0,0, ,5,0,5,100.00,0,0,0,0, 
11709,IRI,17,Salehi Meisam ,OH,11,1,0,0.00,12,11,6,6,23,21.74,1,2,2,5,-20.00,0,4,8,12,-33.33,5,0,15,20,25.00,6,0,6,100.00,0,0,0,0, 
11709,IRI,18,Vadi Mohammad Taher ,S,1,0,0,-15.38,1,1,0,1,2,50.00,0,1,1,2,-50.00,0,2,7,9,-22.22,0,0,1,1,0.00,9,1,11,72.73,29,0,0,29,100.00
11709,IRI,21,Salehi Arman ,L,0,0,0, ,0,0,0,0,0, ,0,0,0,0, ,0,0,0,0, ,13,1,16,30,40.00,12,2,14,71.43,0,0,0,0, 
11709,IRI,22,Esfandiar Amirhossein ,OH,12,0,2,6.12,14,12,3,10,25,36.00,0,6,3,9,-66.67,2,2,11,15,0.00,6,2,10,18,22.22,1,2,3,-33.33,0,1,0,1,-100.00
11709,IRI,23,Saadat Bardia ,O,1,0,0,0.00,1,1,0,0,1,100.00,0,1,1,2,-50.00,0,0,0,0, ,0,0,0,0, ,0,0,0, ,0,0,0,0, 
11709,RUS,1,Podlesnykh Yaroslav ,OH,0,0,0, ,0,0,0,0,0, ,0,0,0,0, ,0,0,0,0, ,0,0,0,0, ,0,0,0, ,0,0,0,0, 
11709,RUS,2,Vlasov Ilia ,MB,6,4,0,-11.11,10,6,0,4,10,60.00,4,12,3,19,-42.11,0,2,5,7,-28.57,0,0,0,0, ,1,0,1,100.00,0,0,0,0, 
11709,RUS,4,Volvich Artem ,MB,7,3,0,10.26,10,7,0,1,8,87.50,3,4,6,13,-7.69,0,2,16,18,-11.11,0,0,0,0, ,1,0,1,100.00,0,0,0,0, 
11709,RUS,5,Semyshev Anton ,OH,0,0,0,0.00,0,0,0,5,5,0.00,0,0,0,0, ,0,0,1,1,0.00,1,0,2,3,33.33,1,1,3,0.00,0,0,0,0, 
11709,RUS,6,Baranov Evgeny ,L,0,0,0, ,0,0,0,0,0, ,0,0,0,0, ,0,0,0,0, ,0,0,1,1,0.00,0,0,0, ,0,0,0,0, 
11709,RUS,7,Volkov Dmitry ,OH,0,0,0, ,0,0,0,0,0, ,0,0,0,0, ,0,0,0,0, ,0,0,0,0, ,0,0,0, ,0,0,0,0, 
11709,RUS,10,Bogdan Denis ,OH,10,2,1,8.70,13,10,3,8,21,33.33,2,3,3,8,-12.50,1,3,13,17,-11.76,7,0,6,13,53.85,6,1,8,62.50,0,0,1,1,0.00
11709,RUS,11,Pankov Pavel ,S,0,0,1,0.00,1,0,0,0,0, ,0,0,0,0, ,1,1,9,11,0.00,0,0,0,0, ,2,1,4,25.00,14,0,1,15,93.33
11709,RUS,15,Poletaev Victor ,O,2,0,0,-20.00,2,2,0,0,2,100.00,0,0,0,0, ,0,3,0,3,-100.00,0,0,0,0, ,0,0,0, ,0,0,0,0, 
11709,RUS,17,Mikhaylov Maxim ,O,19,1,2,25.49,22,19,3,10,32,50.00,1,2,3,6,-16.67,2,4,7,13,-15.38,1,0,0,1,100.00,5,1,7,57.14,0,0,0,0, 
11709,RUS,18,Kliuka Egor ,OH,10,0,0,10.81,10,10,1,5,16,56.25,0,5,3,8,-62.50,0,0,13,13,0.00,4,2,16,22,9.09,3,0,6,50.00,0,0,0,0, 
11709,RUS,20,Kurkaev Ilyas ,MB,1,0,0,0.00,1,1,0,0,1,100.00,0,1,0,1,-100.00,0,0,1,1,0.00,0,0,1,1,0.00,0,0,0, ,0,0,0,0, 
11709,RUS,24,Kobzar Igor ,S,2,0,0,-20.00,2,2,1,0,3,33.33,0,1,2,3,-33.33,0,3,6,9,-33.33,0,0,0,0, ,4,0,6,66.67,23,0,0,23,100.00
11709,RUS,27,Golubev Valentin ,L,0,0,0, ,0,0,0,0,0, ,0,0,0,0, ,0,0,0,0, ,8,1,12,21,33.33,17,2,19,78.95,0,0,0,0, 
11710,NED,4,Ter Horst Thijs ,OH,17,1,0,28.21,18,17,3,6,26,53.85,1,1,1,3,0.00,0,3,7,10,-30.00,8,1,14,23,30.43,2,3,5,-20.00,0,0,0,0, 
11710,NED,5,van der Ent Luuc ,MB,0,0,0, ,0,0,0,0,0, ,0,0,0,0, ,0,0,0,0, ,0,0,0,0, ,0,0,0, ,0,0,0,0, 
11710,NED,6,Dronkers Just ,L,0,0,0, ,0,0,0,0,0, ,0,0,0,0, ,0,0,0,0, ,10,0,19,29,34.48,6,4,10,20.00,0,0,3,3,0.00
11710,NED,7,Jorna Gijs ,OH,1,0,0,0.00,1,1,0,1,2,50.00,0,0,0,0, ,0,1,6,7,-14.29,3,0,5,8,37.50,2,1,3,33.33,0,0,0,0, 
11710,NED,8,Plak Fabian ,MB,11,2,1,17.07,14,11,2,3,16,56.25,2,3,1,6,-16.67,1,2,16,19,-5.26,1,0,1,2,50.00,2,2,4,0.00,0,0,0,0, 
11710,NED,12,Tuinstra Bennie Junior ,OH,2,0,0,0.00,2,2,1,2,5,20.00,0,0,0,0, ,0,1,0,1,-100.00,0,0,0,0, ,0,0,0, ,0,0,0,0, 
11710,NED,13,Ottevanger Steven ,L,0,0,0, ,0,0,0,0,0, ,0,0,0,0, ,0,0,0,0, ,0,0,0,0, ,0,0,0, ,0,0,0,0, 
11710,NED,14,Abdel-Aziz Nimir ,O,23,0,2,8.96,25,23,9,14,46,30.43,0,3,2,5,-60.00,2,7,7,16,-31.25,0,0,0,0, ,1,0,1,100.00,0,0,0,0, 
11710,NED,15,van Solkema Gijs ,S,0,0,0,-100.00,0,0,0,0,0, ,0,1,0,1,-100.00,0,0,0,0, ,0,0,0,0, ,0,0,0, ,2,0,2,4,50.00
11710,NED,17,Parkinson Michael ,MB,2,1,0,33.33,3,2,0,1,3,66.67,1,0,0,1,100.00,0,1,1,2,-50.00,1,0,1,2,50.00,0,0,0, ,0,0,0,0, 
11710,NED,18,Andringa Robbert ,L,1,1,0,-17.86,2,1,2,6,9,-11.11,1,3,1,5,-40.00,0,2,12,14,-14.29,9,0,12,21,42.86,4,0,4,100.00,0,0,0,0, 
11710,NED,19,de Weijer Freek ,S,0,0,0,-26.32,0,0,0,2,2,0.00,0,2,0,2,-100.00,0,3,12,15,-20.00,0,0,0,0, ,7,3,11,36.36,28,3,76,107,23.36
11710,NED,22,Wiltenburg Twan ,MB,2,1,1,18.75,4,2,0,1,3,66.67,1,0,0,1,100.00,1,1,10,12,0.00,1,1,0,2,0.00,0,0,0, ,0,0,0,0, 
11710,NED,25,van Tilburg Stijn ,OH,1,0,0,-25.00,1,1,1,2,4,0.00,0,2,0,2,-100.00,0,0,2,2,0.00,0,0,0,0, ,0,0,0, ,0,0,0,0, 
11710,JPN,1,Shimizu Kunihiro ,O,7,0,0,8.70,7,7,4,1,12,25.00,0,1,1,2,-50.00,0,0,9,9,0.00,0,1,1,2,-50.00,0,0,1,0.00,0,0,0,0, 
11710,JPN,2,Onodera Taishi ,MB,6,0,2,13.89,8,6,1,7,14,35.71,0,1,1,2,-50.00,2,1,17,20,5.00,0,0,0,0, ,2,0,2,100.00,0,0,0,0, 
11710,JPN,3,Fujii Naonobu ,S,0,0,0,0.00,0,0,0,0,0, ,0,0,2,2,0.00,0,0,3,3,0.00,0,0,0,0, ,1,1,2,0.00,8,0,51,59,13.56
11710,JPN,5,Fukuzawa Tatsuya ,OH,0,0,0, ,0,0,0,0,0, ,0,0,0,0, ,0,0,0,0, ,0,0,0,0, ,0,0,0, ,0,0,0,0, 
11710,JPN,6,Yamauchi Akihiro ,MB,0,0,0,0.00,0,0,0,1,1,0.00,0,0,0,0, ,0,0,2,2,0.00,0,0,0,0, ,0,0,0, ,0,0,0,0, 
11710,JPN,12,Sekita Masahiro ,S,0,1,0,-18.75,1,0,0,0,0, ,1,1,1,3,0.00,0,3,10,13,-23.08,0,0,0,0, ,1,1,3,0.00,21,0,28,49,42.86
11710,JPN,14,Ishikawa Yuki ,OH,15,2,0,13.73,17,15,2,8,25,52.00,2,4,1,7,-28.57,0,4,15,19,-21.05,12,0,13,25,48.00,4,1,5,60.00,0,0,0,0, 
11710,JPN,15,Ri Haku ,MB,0,0,0, ,0,0,0,0,0, ,0,0,0,0, ,0,0,0,0, ,0,0,0,0, ,0,0,0, ,0,0,0,0, 
11710,JPN,16,Takahashi Kentaro ,MB,6,2,0,9.52,8,6,0,1,7,85.71,2,1,0,3,33.33,0,5,6,11,-45.45,0,0,0,0, ,0,0,0, ,0,0,0,0, 
11710,JPN,17,Takanashi Kenta ,OH,0,0,0,-33.33,0,0,0,1,1,0.00,0,0,1,1,0.00,0,1,0,1,-100.00,0,0,0,0, ,0,0,0, ,0,0,0,0, 
11710,JPN,19,Otsuka Tatsunori ,OH,7,0,0,9.09,7,7,1,4,12,50.00,0,2,0,2,-100.00,0,2,6,8,-25.00,0,0,0,0, ,1,0,1,100.00,0,0,0,0, 
11710,JPN,20,Yamamoto Tomohiro ,L,0,0,0, ,0,0,0,0,0, ,0,0,0,0, ,0,0,0,0, ,13,3,10,26,38.46,7,3,12,33.33,0,0,0,0, 
11710,JPN,21,Takahashi Ran ,OH,25,1,0,25.40,26,25,3,10,38,57.89,1,1,0,2,0.00,0,6,17,23,-26.09,13,0,11,24,54.17,3,2,5,20.00,0,0,0,0, 
11710,JPN,24,Ogawa Tomohiro ,L,0,0,0, ,0,0,0,0,0, ,0,0,0,0, ,0,0,0,0, ,0,0,0,0, ,0,0,0, ,0,0,0,0, 
11711,AUS,1,Graham Beau ,MB,6,0,0,-13.04,6,6,6,4,16,0.00,0,1,0,1,-100.00,0,2,4,6,-33.33,0,2,1,3,-66.67,1,2,4,-25.00,0,0,0,0, 
11711,AUS,2,Dosanjh Arshdeep ,S,3,0,0,0.00,3,3,2,1,6,16.67,0,1,0,1,-100.00,0,0,9,9,0.00,0,0,0,0, ,3,2,7,14.29,10,1,53,64,14.06
11711,AUS,3,Macdonald Steven ,MB,0,0,0, ,0,0,0,0,0, ,0,0,0,0, ,0,0,0,0, ,0,0,0,0, ,0,0,0, ,0,0,0,0, 
11711,AUS,7,Weir James ,MB,2,0,0,-9.09,2,2,0,0,2,100.00,0,0,1,1,0.00,0,3,5,8,-37.50,0,1,1,2,-50.00,0,0,0, ,0,0,0,0, 
11711,AUS,8,O'Dea Trent ,MB,1,0,0,0.00,1,1,0,3,4,25.00,0,1,2,3,-33.33,0,0,2,2,0.00,0,0,0,0, ,0,0,0, ,0,0,0,0, 
11711,AUS,11,Perry Luke ,L,0,0,0, ,0,0,0,0,0, ,0,0,0,0, ,0,0,0,0, ,6,3,9,18,16.67,12,3,16,56.25,0,0,3,3,0.00
11711,AUS,12,Mote Nehemiah ,MB,1,2,1,-6.67,4,1,1,5,7,0.00,2,4,5,11,-18.18,1,1,10,12,0.00,0,0,0,0, ,2,0,2,100.00,0,0,0,0, 
11711,AUS,15,Smith Luke ,OH,9,0,0,6.25,9,9,4,6,19,26.32,0,1,0,1,-100.00,0,2,10,12,-16.67,2,2,13,17,0.00,4,2,8,25.00,0,0,0,0, 
11711,AUS,21,Butler Nicholas ,S,0,0,0, ,0,0,0,0,0, ,0,0,0,0, ,0,0,0,0, ,0,0,0,0, ,0,0,0, ,0,0,0,0, 
11711,AUS,27,Senica Max ,OH,0,0,0, ,0,0,0,0,0, ,0,0,0,0, ,0,0,0,0, ,0,0,0,0, ,0,0,0, ,0,0,0,0, 
11711,AUS,28,Taylor Tim ,OH,2,1,0,0.00,3,2,1,4,7,14.29,1,1,1,3,0.00,0,1,4,5,-20.00,1,3,3,7,-28.57,1,2,3,-33.33,0,0,0,0, 
11711,AUS,29,Garrett Ethan ,OH,1,0,0,-15.38,1,1,1,4,6,0.00,0,1,0,1,-100.00,0,1,5,6,-16.67,1,2,5,8,-12.50,0,1,1,-100.00,0,0,0,0, 
11711,AUS,31,Aubrey Matthew ,O,1,0,0,-33.33,1,1,0,1,2,50.00,0,2,0,2,-100.00,0,1,1,2,-50.00,0,0,0,0, ,2,0,5,40.00,0,0,0,0, 
11711,AUS,33,Flowerday Sam ,OH,0,0,0, ,0,0,0,0,0, ,0,0,0,0, ,0,0,0,0, ,0,0,0,0, ,0,0,0, ,0,0,0,0, 
11711,BUL,1,Karyagin Denis ,O,0,0,0,-50.00,0,0,0,0,0, ,0,0,0,0, ,0,1,1,2,-50.00,0,0,0,0, ,0,0,0, ,0,0,0,0, 
11711,BUL,2,Chavdarov Stefan ,MB,0,1,1,0.00,2,0,0,1,1,0.00,1,0,3,4,25.00,1,2,3,6,-16.67,0,0,0,0, ,1,0,1,100.00,0,0,0,0, 
11711,BUL,3,Kolev Nikolay ,MB,0,0,0, ,0,0,0,0,0, ,0,0,0,0, ,0,0,0,0, ,0,0,0,0, ,0,0,0, ,0,0,0,0, 
11711,BUL,4,Atanasov Martin ,OH,10,2,1,15.15,13,10,5,5,20,25.00,2,1,1,4,25.00,1,2,6,9,-11.11,9,0,11,20,45.00,5,0,6,83.33,0,0,0,0, 
11711,BUL,9,Seganov Georgi ,S,2,0,1,-18.75,3,2,0,0,2,100.00,0,3,1,4,-75.00,1,3,6,10,-20.00,0,1,1,2,-50.00,3,2,6,16.67,22,0,46,68,32.35
11711,BUL,10,Stankov Svetoslav ,S,0,0,0, ,0,0,0,0,0, ,0,0,0,0, ,0,0,0,0, ,0,0,0,0, ,0,0,0, ,0,0,0,0, 
11711,BUL,11,Grozdanov Aleks ,MB,3,1,5,3.33,9,3,0,3,6,50.00,1,5,4,10,-40.00,5,3,6,14,14.29,0,0,1,1,0.00,1,0,1,100.00,0,1,0,1,-100.00
11711,BUL,12,Petrov Georgi ,OH,0,0,0, ,0,0,0,0,0, ,0,0,0,0, ,0,0,0,0, ,0,0,0,0, ,0,0,0, ,0,0,0,0, 
11711,BUL,14,Asparuhov Asparuh ,OH,5,0,3,3.12,8,5,2,6,13,23.08,0,2,3,5,-40.00,3,3,8,14,0.00,6,0,9,15,40.00,5,0,6,83.33,0,0,0,0, 
11711,BUL,16,Ivanov Vladislav ,L,0,0,0, ,0,0,0,0,0, ,0,0,0,0, ,0,0,0,0, ,4,0,9,13,30.77,5,0,6,83.33,0,0,4,4,0.00
11711,BUL,19,Sokolov Tsvetan ,O,10,0,2,-2.22,12,10,6,11,27,14.81,0,3,1,4,-75.00,2,4,8,14,-14.29,0,0,0,0, ,3,1,4,50.00,0,0,0,0, 
11711,BUL,22,Kartev Nikolay ,MB,4,1,0,-6.67,5,4,1,0,5,60.00,1,4,0,5,-60.00,0,1,4,5,-20.00,0,0,0,0, ,0,0,2,0.00,0,0,0,0, 
11711,BUL,24,Ivanov Martin ,L,0,0,0, ,0,0,0,0,0, ,0,0,0,0, ,0,0,0,0, ,0,0,0,0, ,0,0,0, ,0,0,0,0, 
11711,BUL,25,Parapunov Radoslav ,O,0,0,0, ,0,0,0,0,0, ,0,0,0,0, ,0,0,0,0, ,0,0,0,0, ,0,0,0, ,0,0,0,0, 
11712,POL,5,Kaczmarek Lukasz ,O,0,0,0,-50.00,0,0,0,0,0, ,0,1,0,1,-100.00,0,0,1,1,0.00,0,0,0,0, ,0,0,0, ,0,0,0,0, 
11712,POL,6,Kurek Bartosz ,O,10,2,0,2.27,12,10,3,11,24,29.17,2,5,2,9,-33.33,0,3,8,11,-27.27,0,0,2,2,0.00,4,1,6,50.00,0,0,0,0, 
11712,POL,9,Leon Venero Wilfredo ,OH,13,0,13,37.50,26,13,2,2,17,64.71,0,1,0,1,-100.00,13,5,12,30,26.67,10,2,21,33,24.24,7,1,8,75.00,0,0,0,0, 
11712,POL,10,Wojtaszek Damian ,L,0,0,0, ,0,0,0,0,0, ,0,0,0,0, ,0,0,0,0, ,1,1,2,4,0.00,2,0,2,100.00,0,0,0,0, 
11712,POL,11,Drzyzga Fabian ,S,0,0,1,-15.00,1,0,0,2,2,0.00,0,0,1,1,0.00,1,4,12,17,-17.65,0,0,0,0, ,3,2,5,20.00,25,0,64,89,28.09
11712,POL,12,Lomacz Grzegorz ,S,0,0,0, ,0,0,0,0,0, ,0,0,0,0, ,0,0,0,0, ,0,0,0,0, ,0,0,0, ,0,0,0,0, 
11712,POL,13,Kubiak Michal ,OH,0,0,0, ,0,0,0,0,0, ,0,0,0,0, ,0,0,0,0, ,0,0,0,0, ,0,0,0, ,0,0,0,0, 
11712,POL,14,Sliwka Aleksander ,OH,0,0,1,25.00,1,0,0,0,0, ,0,0,0,0, ,1,0,3,4,25.00,0,0,0,0, ,0,0,0, ,0,0,0,0, 
11712,POL,15,Kochanowski Jakub ,MB,7,4,1,2.44,12,7,2,3,12,41.67,4,8,1,13,-30.77,1,1,14,16,0.00,0,0,0,0, ,3,0,3,100.00,0,0,0,0, 
11712,POL,16,Semeniuk Kamil ,OH,11,6,0,21.28,17,11,1,16,28,35.71,6,2,3,11,36.36,0,4,4,8,-50.00,6,0,6,12,50.00,4,1,6,50.00,0,0,0,0, 
11712,POL,17,Zatorski Pawel ,L,0,0,0, ,0,0,0,0,0, ,0,0,0,0, ,0,0,0,0, ,8,2,7,17,35.29,6,2,8,50.00,0,0,3,3,0.00
11712,POL,19,Janusz Marcin ,S,0,0,0, ,0,0,0,0,0, ,0,0,0,0, ,0,0,0,0, ,0,0,0,0, ,0,0,0, ,0,0,0,0, 
11712,POL,77,Klos Karol ,MB,0,0,0, ,0,0,0,0,0, ,0,0,0,0, ,0,0,0,0, ,0,0,0,0, ,0,0,0, ,0,0,0,0, 
11712,POL,99,Huber Norbert ,MB,5,1,1,-17.86,7,5,2,2,9,33.33,1,7,2,10,-60.00,1,3,5,9,-22.22,0,1,0,1,-100.00,0,0,0, ,0,0,0,0, 
11712,SRB,3,Kapur Milorad ,L,0,0,0, ,0,0,0,0,0, ,0,0,0,0, ,0,0,0,0, ,0,0,0,0, ,0,0,0, ,0,0,0,0, 
11712,SRB,6,Pekovic Nikola ,L,0,0,0, ,0,0,0,0,0, ,0,0,0,0, ,0,0,0,0, ,8,6,10,24,8.33,10,3,15,46.67,0,0,4,4,0.00
11712,SRB,7,Krsmanovic Petar ,MB,4,1,0,-14.81,5,4,4,0,8,0.00,1,2,0,3,-33.33,0,3,13,16,-18.75,1,0,0,1,100.00,4,0,4,100.00,0,0,0,0, 
11712,SRB,8,Ivovic Marko ,OH,12,0,1,17.65,13,12,1,4,17,64.71,0,3,0,3,-100.00,1,3,10,14,-14.29,6,6,12,24,0.00,6,1,7,71.43,0,0,0,0, 
11712,SRB,9,Jovovic Nikola ,S,1,0,0,-29.41,1,1,1,1,3,0.00,0,3,0,3,-100.00,0,2,9,11,-18.18,0,0,0,0, ,4,1,5,60.00,27,0,58,85,31.76
11712,SRB,10,KujundÅ¾iÄ Miran ,OH,1,0,0,-16.67,1,1,1,3,5,0.00,0,0,0,0, ,0,1,0,1,-100.00,1,2,1,4,-25.00,3,1,4,50.00,0,0,0,0, 
11712,SRB,11,Batak Aleksa ,S,0,0,0, ,0,0,0,0,0, ,0,0,0,0, ,0,0,0,0, ,0,0,0,0, ,0,0,0, ,0,0,0,0, 
11712,SRB,12,Peric Pavle ,OH,3,1,0,7.14,4,3,1,2,6,33.33,1,1,0,2,0.00,0,1,5,6,-16.67,1,1,7,9,0.00,2,0,2,100.00,0,0,0,0, 
11712,SRB,13,Simic Stevan ,MB,0,0,0,0.00,0,0,0,1,1,0.00,0,0,0,0, ,0,0,1,1,0.00,0,0,0,0, ,0,0,0, ,0,0,0,0, 
11712,SRB,14,Atanasijevic Aleksandar ,O,9,0,2,0.00,11,9,8,10,27,3.70,0,2,0,2,-100.00,2,1,11,14,7.14,0,0,1,1,0.00,4,1,5,60.00,0,0,0,0, 
11712,SRB,16,Luburic Drazen ,O,4,0,2,54.55,6,4,0,2,6,66.67,0,0,0,0, ,2,0,3,5,40.00,0,0,0,0, ,0,0,0, ,0,0,0,0, 
11712,SRB,18,Podrascanin Marko ,MB,11,1,1,12.50,13,11,0,4,15,73.33,1,6,4,11,-45.45,1,2,11,14,-7.14,0,0,0,0, ,3,1,4,50.00,0,0,0,0, 
11712,SRB,23,Vucicevic Bozidar ,O,0,0,0, ,0,0,0,0,0, ,0,0,0,0, ,0,0,0,0, ,0,0,0,0, ,0,0,0, ,0,0,0,0, 
11712,SRB,26,Kovac Davide ,OH,0,0,0,-55.56,0,0,2,3,5,-40.00,0,1,1,2,-50.00,0,2,0,2,-100.00,5,2,6,13,23.08,2,0,2,100.00,0,0,0,0, 
11713,ITA,1,Gardini Davide ,OH,0,0,0, ,0,0,0,0,0, ,0,0,0,0, ,0,0,0,0, ,0,0,0,0, ,0,0,0, ,0,0,0,0, 
11713,ITA,7,Balaso Fabio ,L,0,0,0, ,0,0,0,0,0, ,0,0,0,0, ,0,0,0,0, ,7,4,6,17,17.65,6,0,7,85.71,0,0,7,7,0.00
11713,ITA,11,Galassi Gianluca ,MB,9,2,2,37.04,13,9,1,4,14,57.14,2,0,0,2,100.00,2,2,7,11,0.00,0,0,1,1,0.00,0,0,0, ,0,0,2,2,0.00
11713,ITA,15,Sbertoli Riccardo ,S,1,0,2,14.29,3,1,0,0,1,100.00,0,1,0,1,-100.00,2,0,10,12,16.67,0,0,1,1,0.00,0,0,0, ,23,0,42,65,35.38
11713,ITA,18,Michieletto Alessandro ,OH,6,0,0,5.26,6,6,2,4,12,33.33,0,0,0,0, ,0,3,4,7,-42.86,4,2,10,16,12.50,1,0,1,100.00,0,0,2,2,0.00
11713,ITA,20,Nelli Gabriele ,O,6,0,1,14.81,7,6,1,9,16,31.25,0,0,1,1,0.00,1,2,7,10,-10.00,0,0,0,0, ,1,0,1,100.00,0,1,1,2,-50.00
11713,ITA,21,Spirito Luca ,S,0,0,0, ,0,0,0,0,0, ,0,0,0,0, ,0,0,0,0, ,0,0,0,0, ,0,0,0, ,1,0,1,2,50.00
11713,ITA,23,Pinali Giulio ,O,0,0,0,-100.00,0,0,0,0,0, ,0,0,0,0, ,0,1,0,1,-100.00,0,0,0,0, ,0,0,0, ,0,0,0,0, 
11713,ITA,24,Cavuto Oreste ,OH,1,0,0,-16.67,1,1,2,1,4,-25.00,0,0,0,0, ,0,0,2,2,0.00,0,0,1,1,0.00,0,0,0, ,0,0,0,0, 
11713,ITA,25,Vitelli Marco ,MB,2,0,0,0.00,2,2,0,1,3,66.67,0,0,0,0, ,0,2,1,3,-66.67,0,0,0,0, ,0,0,0, ,0,0,0,0, 
11713,ITA,26,Cortesia Lorenzo ,MB,1,0,0,-22.22,1,1,2,2,5,-20.00,0,0,0,0, ,0,1,3,4,-25.00,0,0,1,1,0.00,0,0,0, ,0,0,0,0, 
11713,ITA,28,Recine Francesco ,OH,2,0,0,0.00,2,2,1,3,6,16.67,0,0,0,0, ,0,1,1,2,-50.00,1,1,4,6,0.00,0,0,0, ,0,0,0,0, 
11713,ITA,29,Bottolo Mattia ,OH,4,1,0,0.00,5,4,4,12,20,0.00,1,0,0,1,100.00,0,1,5,6,-16.67,9,1,7,17,47.06,0,0,0, ,0,0,1,1,0.00
11713,ITA,31,Federici Filippo ,L,0,0,0, ,0,0,0,0,0, ,0,0,0,0, ,0,0,0,0, ,0,0,0,0, ,0,0,0, ,0,0,0,0, 
11713,SLO,1,Å tern TonÄek ,O,0,0,0, ,0,0,0,0,0, ,0,0,0,0, ,0,0,0,0, ,0,0,0,0, ,0,0,0, ,0,0,0,0, 
11713,SLO,2,Pajenk Alen ,MB,6,1,1,23.33,8,6,1,4,11,45.45,1,0,0,1,100.00,1,0,17,18,5.56,1,1,0,2,0.00,0,0,0, ,0,0,0,0, 
11713,SLO,4,Kozamernik Jan ,MB,6,2,2,50.00,10,6,0,0,6,100.00,2,0,0,2,100.00,2,1,7,10,10.00,0,0,1,1,0.00,0,0,0, ,0,0,2,2,0.00
11713,SLO,5,Å ket Alen ,O,0,0,0,-66.67,0,0,0,0,0, ,0,1,0,1,-100.00,0,1,1,2,-50.00,0,0,0,0, ,0,0,0, ,0,0,0,0, 
11713,SLO,6,Gasparini Mitja ,O,6,0,0,0.00,6,6,2,9,17,23.53,0,0,0,0, ,0,4,6,10,-40.00,0,0,0,0, ,1,0,1,100.00,0,0,2,2,0.00
11713,SLO,9,Vincic Dejan ,S,0,0,0, ,0,0,0,0,0, ,0,0,0,0, ,0,0,0,0, ,0,0,0,0, ,0,0,0, ,1,0,4,5,20.00
11713,SLO,11,Å tern Å½iga ,OH,12,0,0,28.12,12,12,1,12,25,44.00,0,0,0,0, ,0,2,5,7,-28.57,7,0,6,13,53.85,1,0,1,100.00,0,0,3,3,0.00
11713,SLO,12,Klobucar Jan ,L,0,0,0, ,0,0,0,0,0, ,0,0,0,0, ,0,0,0,0, ,0,0,0,0, ,0,0,0, ,0,0,0,0, 
11713,SLO,13,KovaÄiÄ Jani ,L,0,0,0, ,0,0,0,0,0, ,0,0,0,0, ,0,0,0,0, ,4,0,3,7,57.14,2,0,2,100.00,0,0,2,2,0.00
11713,SLO,15,VideÄnik Matic ,MB,0,0,0,0.00,0,0,0,0,0, ,0,0,0,0, ,0,0,1,1,0.00,0,0,1,1,0.00,0,0,0, ,0,0,0,0, 
11713,SLO,16,Ropret Gregor ,S,0,0,1,-42.86,1,0,0,0,0, ,0,0,0,0, ,1,4,2,7,-42.86,0,0,0,0, ,0,0,0, ,18,0,38,56,32.14
11713,SLO,17,Urnaut Tine ,OH,0,0,0, ,0,0,0,0,0, ,0,0,0,0, ,0,0,0,0, ,0,0,0,0, ,0,0,0, ,0,0,0,0, 
11713,SLO,18,Äebulj Klemen ,OH,8,1,4,30.56,13,8,0,8,16,50.00,1,0,0,1,100.00,4,2,13,19,10.53,5,3,8,16,12.50,1,0,1,100.00,0,0,4,4,0.00
11713,SLO,19,MoÅ¾iÄ Rok ,OH,2,0,0,14.29,2,2,1,4,7,14.29,0,0,0,0, ,0,0,0,0, ,2,1,2,5,20.00,0,0,0, ,0,0,0,0, 
11714,ARG,2,Pereyra Federico ,O,4,0,1,-26.09,5,4,7,2,13,-23.08,0,3,0,3,-100.00,1,1,5,7,0.00,0,0,0,0, ,1,1,2,0.00,0,0,0,0, 
11714,ARG,3,Martinez Franchi Jan ,OH,0,0,0, ,0,0,0,0,0, ,0,0,0,0, ,0,0,0,0, ,6,1,8,15,33.33,4,3,7,14.29,0,0,1,1,0.00
11714,ARG,5,Uriarte Nicolas ,S,1,1,0,-16.67,2,1,0,1,2,50.00,1,3,1,5,-40.00,0,1,4,5,-20.00,0,0,0,0, ,0,0,0, ,9,0,22,31,29.03
11714,ARG,7,Conte Facundo ,OH,7,1,0,-3.12,8,7,3,8,18,22.22,1,2,0,3,-33.33,0,4,7,11,-36.36,3,2,12,17,5.88,6,1,7,71.43,0,1,0,1,-100.00
11714,ARG,11,SolÃ© Sebastian ,MB,4,1,0,4.35,5,4,2,4,10,20.00,1,1,2,4,0.00,0,1,8,9,-11.11,1,0,1,2,50.00,2,0,2,100.00,0,0,0,0, 
11714,ARG,15,De Cecco Luciano ,S,0,0,0,-33.33,0,0,0,2,2,0.00,0,0,0,0, ,0,2,2,4,-50.00,0,0,0,0, ,0,1,1,-100.00,9,0,28,37,24.32
11714,ARG,16,Palonsky Luciano ,OH,2,0,0,-10.00,2,2,1,4,7,14.29,0,0,0,0, ,0,2,1,3,-66.67,0,0,0,0, ,1,2,3,-33.33,0,0,0,0, 
11714,ARG,17,Mendez Nicolas ,OH,6,1,0,-8.33,7,6,6,3,15,0.00,1,0,0,1,100.00,0,3,5,8,-37.50,4,1,18,23,13.04,3,3,7,0.00,0,0,0,0, 
11714,ARG,18,Ramos Martin ,MB,3,1,1,-10.53,5,3,0,1,4,75.00,1,5,0,6,-66.67,1,2,6,9,-11.11,3,0,0,3,100.00,2,1,3,33.33,0,0,0,0, 
11714,CAN,2,Perrin John Gordon ,OH,10,1,1,17.14,12,10,1,7,18,50.00,1,2,1,4,-25.00,1,3,9,13,-15.38,4,1,8,13,23.08,9,0,9,100.00,0,1,0,1,-100.00
11714,CAN,4,Hoag Nicholas ,OH,5,2,2,-3.03,9,5,4,7,16,6.25,2,3,1,6,-16.67,2,3,6,11,-9.09,5,0,5,10,50.00,4,2,6,33.33,0,0,0,0, 
11714,CAN,6,Pereira Jordan ,OH,0,0,0, ,0,0,0,0,0, ,0,0,0,0, ,0,0,0,0, ,0,0,0,0, ,0,0,0, ,0,0,0,0, 
11714,CAN,7,Maar Stephen Timothy ,OH,0,0,0, ,0,0,0,0,0, ,0,0,0,0, ,0,0,0,0, ,0,0,0,0, ,0,0,0, ,0,0,0,0, 
11714,CAN,8,Blankenau Jay ,S,0,0,0, ,0,0,0,0,0, ,0,0,0,0, ,0,0,0,0, ,0,0,0,0, ,0,0,0, ,0,0,0,0, 
11714,CAN,10,Sclater Ryan Joseph ,O,11,2,1,14.71,14,11,3,0,14,57.14,2,2,0,4,0.00,1,4,11,16,-18.75,0,0,0,0, ,4,1,5,60.00,0,0,0,0, 
11714,CAN,11,Jansen Vandoorn Daniel ,MB,1,1,0,-15.00,2,1,1,1,3,0.00,1,2,2,5,-20.00,0,2,10,12,-16.67,0,0,1,1,0.00,0,0,0, ,0,0,0,0, 
11714,CAN,12,Van Berkel Lucas ,MB,0,0,0,0.00,0,0,0,0,0, ,0,0,0,0, ,0,0,1,1,0.00,0,0,0,0, ,0,0,0, ,0,0,0,0, 
11714,CAN,13,Vernon-Evans Sharone ,O,0,0,0, ,0,0,0,0,0, ,0,0,0,0, ,0,0,0,0, ,0,0,0,0, ,0,0,0, ,0,0,0,0, 
11714,CAN,14,Loeppky Eric ,OH,0,0,0, ,0,0,0,0,0, ,0,0,0,0, ,0,0,0,0, ,0,0,0,0, ,0,0,0, ,0,0,0,0, 
11714,CAN,17,Vigrass Graham ,MB,6,0,0,19.05,6,6,0,1,7,85.71,0,1,2,3,-33.33,0,1,10,11,-9.09,1,0,0,1,100.00,0,2,2,-100.00,0,0,0,0, 
11714,CAN,19,Bann Blair Cameron ,L,0,0,0, ,0,0,0,0,0, ,0,0,0,0, ,0,0,0,0, ,7,1,7,15,40.00,3,2,5,20.00,0,0,0,0, 
11714,CAN,20,Szwarc Arthur ,O,0,0,0, ,0,0,0,0,0, ,0,0,0,0, ,0,0,0,0, ,0,0,0,0, ,0,0,0, ,0,0,0,0, 
11714,CAN,21,Walsh Brett James ,S,0,1,0,-12.50,1,0,0,2,2,0.00,1,3,1,5,-40.00,0,0,9,9,0.00,0,0,0,0, ,2,3,5,-20.00,17,0,38,55,30.91
11715,USA,4,Jendryk II Jeffrey ,MB,5,2,0,26.32,7,5,0,3,8,62.50,2,0,0,2,100.00,0,2,7,9,-22.22,0,0,0,0, ,0,0,0, ,0,0,0,0, 
11715,USA,5,Ensing Kyle ,O,0,0,0, ,0,0,0,0,0, ,0,0,0,0, ,0,0,0,0, ,0,0,0,0, ,0,0,0, ,0,0,0,0, 
11715,USA,6,Stahl Mitchell ,MB,5,2,1,8.33,8,5,1,5,11,36.36,2,0,0,2,100.00,1,5,5,11,-36.36,2,0,1,3,66.67,0,0,0, ,0,0,1,1,0.00
11715,USA,7,Shoji Kawika ,S,0,0,0, ,0,0,0,0,0, ,0,0,0,0, ,0,0,0,0, ,0,0,0,0, ,0,0,0, ,0,0,0,0, 
11715,USA,8,Defalco Torey ,OH,7,1,2,21.21,10,7,2,10,19,26.32,1,0,1,2,50.00,2,1,9,12,8.33,12,3,17,32,28.12,1,0,1,100.00,0,0,2,2,0.00
11715,USA,11,Christenson Micah ,S,0,0,1,-5.56,1,0,1,1,2,-50.00,0,0,0,0, ,1,1,14,16,0.00,0,0,0,0, ,0,0,0, ,19,0,58,77,24.68
11715,USA,12,Holt Maxwell ,MB,0,0,0, ,0,0,0,0,0, ,0,0,0,0, ,0,0,0,0, ,0,0,0,0, ,0,0,0, ,0,0,0,0, 
11715,USA,13,Patch Benjamin ,O,15,3,0,15.91,18,15,6,9,30,30.00,3,0,0,3,100.00,0,5,6,11,-45.45,0,0,0,0, ,0,0,0, ,0,0,1,1,0.00
11715,USA,15,Sander Brenden ,OH,0,0,0, ,0,0,0,0,0, ,0,0,0,0, ,0,0,0,0, ,0,0,0,0, ,0,0,0, ,0,0,0,0, 
11715,USA,17,Jaeschke Thomas ,OH,4,1,0,0.00,5,4,3,6,13,7.69,1,1,0,2,0.00,0,1,4,5,-20.00,8,1,8,17,41.18,0,0,0, ,0,0,0,0, 
11715,USA,18,Muagututia Garrett ,OH,0,0,0,-16.67,0,0,1,3,4,-25.00,0,0,0,0, ,0,0,2,2,0.00,0,1,2,3,-33.33,0,0,0, ,0,0,0,0, 
11715,USA,20,Smith David ,MB,0,0,0, ,0,0,0,0,0, ,0,0,0,0, ,0,0,0,0, ,0,0,0,0, ,0,0,0, ,0,0,0,0, 
11715,USA,21,Watten Dustin ,L,0,0,0, ,0,0,0,0,0, ,0,0,0,0, ,0,0,0,0, ,0,0,0,0, ,0,0,0, ,0,0,0,0, 
11715,USA,22,Shoji Erik ,L,0,0,0, ,0,0,0,0,0, ,0,0,0,0, ,0,0,0,0, ,4,1,2,7,42.86,2,0,2,100.00,0,0,1,1,0.00
11715,BRA,1,Rezende Bruno Mossa ,S,0,0,2,0.00,2,0,0,2,2,0.00,0,0,0,0, ,2,2,10,14,0.00,0,0,0,0, ,1,0,1,100.00,7,0,59,66,10.61
11715,BRA,5,Borges Almeida Silva Mauricio ,OH,0,0,0, ,0,0,0,0,0, ,0,0,0,0, ,0,0,0,0, ,0,0,0,0, ,0,0,0, ,0,0,0,0, 
11715,BRA,6,Gil Kreling Fernando ,S,0,0,0, ,0,0,0,0,0, ,0,0,0,0, ,0,0,0,0, ,0,0,0,0, ,0,0,0, ,0,0,0,0, 
11715,BRA,8,De Souza Wallace ,O,4,0,0,20.00,4,4,1,0,5,60.00,0,0,0,0, ,0,1,4,5,-20.00,0,0,0,0, ,0,0,0, ,0,0,0,0, 
11715,BRA,9,Leal Hidalgo Yoandy ,OH,9,2,2,35.71,13,9,1,3,13,61.54,2,0,0,2,100.00,2,2,9,13,0.00,2,2,16,20,0.00,0,0,0, ,0,0,0,0, 
11715,BRA,10,Bispo dos Santos Matheus ,MB,0,0,0, ,0,0,0,0,0, ,0,0,0,0, ,0,0,0,0, ,0,0,0,0, ,0,0,0, ,0,0,0,0, 
11715,BRA,12,Santos Isac ,MB,5,3,1,33.33,9,5,0,1,6,83.33,3,0,0,3,100.00,1,2,9,12,-8.33,1,0,1,2,50.00,1,0,1,100.00,0,0,1,1,0.00
11715,BRA,14,Correia De Souza Douglas ,OH,0,0,0, ,0,0,0,0,0, ,0,0,0,0, ,0,0,0,0, ,0,0,0,0, ,0,0,0, ,0,0,0,0, 
11715,BRA,15,Nascimento Maique Reis ,L,0,0,0, ,0,0,0,0,0, ,0,0,0,0, ,0,0,0,0, ,0,0,0,0, ,0,0,0, ,0,0,0,0, 
11715,BRA,17,Hoss Thales ,L,0,0,0, ,0,0,0,0,0, ,0,0,0,0, ,0,0,0,0, ,6,1,8,15,33.33,2,0,3,66.67,0,0,5,5,0.00
11715,BRA,18,Souza Ricardo Lucarelli ,OH,10,1,0,2.70,11,10,6,10,26,15.38,1,1,0,2,0.00,0,3,6,9,-33.33,6,1,5,12,41.67,0,0,0, ,0,0,1,1,0.00
11715,BRA,19,Moreira Roque Felipe ,O,0,0,0, ,0,0,0,0,0, ,0,0,0,0, ,0,0,0,0, ,0,0,0,0, ,0,0,0, ,0,0,0,0, 
11715,BRA,21,Souza Alan ,O,10,1,1,38.46,12,10,2,6,18,44.44,1,0,1,2,50.00,1,0,5,6,16.67,1,0,0,1,100.00,0,0,0, ,0,0,1,1,0.00
11715,BRA,23,Resende Gualberto Flavio ,MB,2,0,0,-8.00,2,2,2,5,9,0.00,0,1,1,2,-50.00,0,1,13,14,-7.14,0,0,1,1,0.00,1,0,1,100.00,0,0,0,0, 
11716,AUS,1,Graham Beau ,MB,13,1,0,4.17,14,13,5,8,26,30.77,1,2,2,5,-20.00,0,5,12,17,-29.41,0,0,0,0, ,4,2,7,28.57,0,1,0,1,-100.00
11716,AUS,2,Dosanjh Arshdeep ,S,2,1,1,0.00,4,2,0,5,7,28.57,1,2,0,3,-33.33,1,2,9,12,-8.33,0,0,1,1,0.00,5,2,9,33.33,31,1,67,99,30.30
11716,AUS,3,Macdonald Steven ,MB,0,0,0, ,0,0,0,0,0, ,0,0,0,0, ,0,0,0,0, ,0,0,0,0, ,0,0,0, ,0,0,0,0, 
11716,AUS,7,Weir James ,MB,2,0,2,-12.50,4,2,1,2,5,20.00,0,4,1,5,-80.00,2,1,3,6,16.67,1,0,0,1,100.00,1,0,1,100.00,0,0,0,0, 
11716,AUS,8,O'Dea Trent ,MB,7,0,0,-4.44,7,7,1,3,11,54.55,0,6,10,16,-37.50,0,2,16,18,-11.11,0,0,1,1,0.00,2,0,4,50.00,0,0,0,0, 
11716,AUS,11,Perry Luke ,L,0,0,0, ,0,0,0,0,0, ,0,0,0,0, ,0,0,0,0, ,6,1,11,18,27.78,17,0,17,100.00,0,0,7,7,0.00
11716,AUS,12,Mote Nehemiah ,MB,7,2,0,18.18,9,7,0,4,11,63.64,2,3,7,12,-8.33,0,0,10,10,0.00,1,0,2,3,33.33,2,0,3,66.67,0,0,0,0, 
11716,AUS,15,Smith Luke ,OH,8,4,0,2.38,12,8,3,11,22,22.73,4,3,0,7,14.29,0,5,8,13,-38.46,7,3,17,27,14.81,6,0,6,100.00,0,0,0,0, 
11716,AUS,21,Butler Nicholas ,S,0,0,0, ,0,0,0,0,0, ,0,0,0,0, ,0,0,0,0, ,0,0,0,0, ,2,0,2,100.00,0,0,0,0, 
11716,AUS,27,Senica Max ,OH,0,0,0, ,0,0,0,0,0, ,0,0,0,0, ,0,0,0,0, ,0,0,0,0, ,0,0,0, ,0,0,0,0, 
11716,AUS,28,Taylor Tim ,OH,1,0,0,-28.57,1,1,3,3,7,-28.57,0,0,0,0, ,0,0,0,0, ,0,2,0,2,-100.00,1,0,1,100.00,0,0,0,0, 
11716,AUS,29,Garrett Ethan ,OH,7,0,0,-20.00,7,7,4,9,20,15.00,0,5,2,7,-71.43,0,6,7,13,-46.15,9,0,16,25,36.00,4,2,7,28.57,0,0,0,0, 
11716,AUS,31,Aubrey Matthew ,O,0,0,0,-50.00,0,0,1,1,2,-50.00,0,0,0,0, ,0,0,0,0, ,0,1,0,1,-100.00,0,0,0, ,0,0,0,0, 
11716,AUS,33,Flowerday Sam ,OH,0,0,0, ,0,0,0,0,0, ,0,0,0,0, ,0,0,0,0, ,0,0,0,0, ,0,0,0, ,0,0,0,0, 
11716,FRA,1,Chinenyeze BarthÃ©lÃ©my ,MB,3,0,0,40.00,3,3,0,0,3,100.00,0,1,0,1,-100.00,0,0,1,1,0.00,0,0,0,0, ,2,0,2,100.00,0,0,0,0, 
11716,FRA,4,Patry Jean ,O,14,1,2,11.54,17,14,6,6,26,30.77,1,3,3,7,-28.57,2,2,15,19,0.00,0,0,0,0, ,7,0,8,87.50,0,0,0,0, 
11716,FRA,7,Tillie Kevin ,OH,12,2,2,23.40,16,12,0,8,20,60.00,2,3,4,9,-11.11,2,2,14,18,0.00,5,0,9,14,35.71,9,1,14,57.14,0,0,0,0, 
11716,FRA,8,Lyneel Julien ,OH,0,0,0, ,0,0,0,0,0, ,0,0,0,0, ,0,0,0,0, ,2,1,4,7,14.29,3,0,3,100.00,0,0,2,2,0.00
11716,FRA,9,Ngapeth Earvin ,OH,6,0,0,-3.45,6,6,5,11,22,4.55,0,1,0,1,-100.00,0,1,5,6,-16.67,7,0,17,24,29.17,4,1,6,50.00,0,0,0,0, 
11716,FRA,11,Brizard Antoine ,S,4,3,0,8.70,7,4,1,1,6,50.00,3,2,2,7,14.29,0,2,8,10,-20.00,0,0,1,1,0.00,4,1,6,50.00,26,0,42,68,38.24
11716,FRA,12,Boyer Stephen ,O,0,0,0, ,0,0,0,0,0, ,0,0,0,0, ,0,0,0,0, ,0,0,0,0, ,0,0,0, ,0,0,0,0, 
11716,FRA,14,Le Goff Nicolas ,MB,1,1,0,-15.38,2,1,0,3,4,25.00,1,4,7,12,-25.00,0,2,8,10,-20.00,0,0,0,0, ,2,0,3,66.67,0,0,0,0, 
11716,FRA,16,Bultor Daryl ,MB,0,2,0,-26.67,2,0,2,7,9,-22.22,2,4,4,10,-20.00,0,4,7,11,-36.36,0,1,1,2,-50.00,2,3,6,-16.67,0,0,0,0, 
11716,FRA,17,Clevenot Trevor ,OH,0,0,0,0.00,0,0,0,0,0, ,0,0,0,0, ,0,0,1,1,0.00,0,0,0,0, ,0,1,1,-100.00,0,0,0,0, 
11716,FRA,18,Rossard Thibault ,OH,5,0,2,22.22,7,5,1,3,9,44.44,0,0,1,1,0.00,2,2,4,8,0.00,4,0,3,7,57.14,2,0,2,100.00,0,0,0,0, 
11716,FRA,20,Diez Benjamin ,L,0,0,0, ,0,0,0,0,0, ,0,0,0,0, ,0,0,0,0, ,4,1,7,12,25.00,6,2,9,44.44,0,0,3,3,0.00
11716,FRA,23,Meyer LÃ©o ,S,1,1,0,0.00,2,1,0,0,1,100.00,1,1,1,3,0.00,0,1,4,5,-20.00,0,0,0,0, ,0,1,1,-100.00,11,0,16,27,40.74
11716,FRA,24,Gueye Mousse ,MB,3,0,1,-15.79,4,3,2,2,7,14.29,0,3,1,4,-75.00,1,2,5,8,-12.50,0,0,1,1,0.00,1,0,1,100.00,0,0,0,0, 
11717,NED,6,Dronkers Just ,L,0,0,0, ,0,0,0,0,0, ,0,0,0,0, ,0,0,0,0, ,0,0,0,0, ,0,0,0, ,0,0,0,0, 
11717,NED,7,Jorna Gijs ,OH,2,0,0,-16.67,2,2,2,7,11,0.00,0,2,2,4,-50.00,0,2,7,9,-22.22,4,3,15,22,4.55,5,4,9,11.11,0,0,0,0, 
11717,NED,8,Plak Fabian ,MB,0,0,0, ,0,0,0,0,0, ,0,0,0,0, ,0,0,0,0, ,0,0,0,0, ,0,0,0, ,0,0,0,0, 
11717,NED,10,van Zeist Maikel ,MB,5,0,0,-3.85,5,5,1,4,10,40.00,0,2,3,5,-40.00,0,3,8,11,-27.27,0,0,0,0, ,1,0,1,100.00,0,0,0,0, 
11717,NED,12,Tuinstra Bennie Junior ,OH,8,0,2,-6.38,10,8,5,9,22,13.64,0,5,1,6,-83.33,2,3,14,19,-5.26,3,0,12,15,20.00,3,2,5,20.00,0,0,0,0, 
11717,NED,13,Ottevanger Steven ,L,0,0,0, ,0,0,0,0,0, ,0,0,0,0, ,0,0,0,0, ,5,3,10,18,11.11,14,2,16,75.00,0,0,1,1,0.00
11717,NED,14,Abdel-Aziz Nimir ,O,9,1,1,11.11,11,9,4,4,17,29.41,1,3,0,4,-50.00,1,1,4,6,0.00,0,0,0,0, ,3,0,3,100.00,0,0,0,0, 
11717,NED,15,van Solkema Gijs ,S,0,1,0,-12.50,1,0,1,0,1,-100.00,1,0,1,2,50.00,0,1,4,5,-20.00,0,0,0,0, ,2,2,4,0.00,15,0,62,77,19.48
11717,NED,17,Parkinson Michael ,MB,4,1,0,-5.56,5,4,1,1,6,50.00,1,4,0,5,-60.00,0,1,6,7,-14.29,1,1,0,2,0.00,1,2,3,-33.33,0,0,0,0, 
11717,NED,18,Andringa Robbert ,L,0,0,0, ,0,0,0,0,0, ,0,0,0,0, ,0,0,0,0, ,0,0,0,0, ,0,0,0, ,0,0,0,0, 
11717,NED,19,de Weijer Freek ,S,0,0,0,0.00,0,0,0,0,0, ,0,0,0,0, ,0,0,2,2,0.00,0,0,0,0, ,0,0,0, ,6,0,0,6,100.00
11717,NED,21,van Schie Stijn ,OH,0,0,0, ,0,0,0,0,0, ,0,0,0,0, ,0,0,0,0, ,0,0,0,0, ,0,0,0, ,0,0,0,0, 
11717,NED,22,Wiltenburg Twan ,MB,0,0,0,0.00,0,0,0,0,0, ,0,0,0,0, ,0,0,2,2,0.00,0,0,0,0, ,1,0,1,100.00,0,0,0,0, 
11717,NED,25,van Tilburg Stijn ,OH,7,0,2,14.29,9,7,1,8,16,37.50,0,2,0,2,-100.00,2,2,6,10,0.00,0,0,1,1,0.00,1,0,1,100.00,0,0,0,0, 
11717,IRI,4,Marouflakrani Mir Saeid ,S,0,0,0, ,0,0,0,0,0, ,0,0,0,0, ,0,0,0,0, ,0,0,0,0, ,0,0,0, ,6,0,0,6,100.00
11717,IRI,6,Mousavi Eraghi Seyed Mohammad ,MB,9,1,0,16.67,10,9,0,1,10,90.00,1,2,2,5,-20.00,0,4,5,9,-44.44,0,0,0,0, ,0,0,1,0.00,0,0,0,0, 
11717,IRI,7,Fayazi D. Purya ,OH,0,0,0, ,0,0,0,0,0, ,0,0,0,0, ,0,0,0,0, ,0,0,1,1,0.00,0,1,1,-100.00,0,0,0,0, 
11717,IRI,8,Hazratpourtalatappeh Mohammadreza ,L,0,0,0, ,0,0,0,0,0, ,0,0,0,0, ,0,0,0,0, ,0,0,0,0, ,0,0,0, ,0,0,0,0, 
11717,IRI,9,Gholami Masoud ,MB,0,0,0, ,0,0,0,0,0, ,0,0,0,0, ,0,0,0,0, ,0,0,0,0, ,0,0,0, ,0,0,0,0, 
11717,IRI,11,Kazemi Saber ,O,10,0,1,-2.33,11,10,5,10,25,20.00,0,1,0,1,-100.00,1,6,10,17,-29.41,0,0,1,1,0.00,3,1,6,33.33,0,0,0,0, 
11717,IRI,12,Sharifi Morteza ,OH,0,0,0, ,0,0,0,0,0, ,0,0,0,0, ,0,0,0,0, ,0,0,0,0, ,0,0,0, ,0,0,0,0, 
11717,IRI,15,Mojarad Aliasghar ,MB,3,4,1,-6.67,8,3,0,2,5,60.00,4,5,3,12,-8.33,1,5,7,13,-30.77,0,0,1,1,0.00,1,0,2,50.00,0,0,0,0, 
11717,IRI,16,Shafiei Ali ,MB,0,0,0, ,0,0,0,0,0, ,0,0,0,0, ,0,0,0,0, ,0,0,0,0, ,0,0,0, ,0,0,0,0, 
11717,IRI,17,Salehi Meisam ,OH,8,3,1,27.59,12,8,1,3,12,58.33,3,2,0,5,20.00,1,1,10,12,0.00,2,2,10,14,0.00,4,1,6,50.00,0,0,0,0, 
11717,IRI,18,Vadi Mohammad Taher ,S,1,0,1,16.67,2,1,0,1,2,50.00,0,0,0,0, ,1,0,9,10,10.00,0,0,0,0, ,7,5,12,16.67,15,0,47,62,24.19
11717,IRI,21,Salehi Arman ,L,0,0,0, ,0,0,0,0,0, ,0,0,0,0, ,0,0,0,0, ,10,0,10,20,50.00,5,4,10,10.00,0,0,4,4,0.00
11717,IRI,22,Esfandiar Amirhossein ,OH,10,1,3,25.00,14,10,2,2,14,57.14,1,1,1,3,0.00,3,3,9,15,0.00,7,3,11,21,19.05,3,1,5,40.00,0,0,0,0, 
11717,IRI,23,Saadat Bardia ,O,3,0,0,12.50,3,3,1,1,5,40.00,0,0,1,1,0.00,0,1,1,2,-50.00,0,0,0,0, ,1,0,1,100.00,0,0,0,0, 
11718,GER,1,Fromm Christian ,OH,6,0,0,14.29,6,6,1,4,11,45.45,0,0,2,2,0.00,0,2,6,8,-25.00,0,1,3,4,-25.00,2,1,3,33.33,0,0,0,0, 
11718,GER,3,Schott Ruben ,OH,5,0,3,0.00,8,5,4,8,17,5.88,0,2,2,4,-50.00,3,2,10,15,6.67,4,2,13,19,10.53,8,0,8,100.00,0,0,0,0, 
11718,GER,5,Reichert Moritz ,OH,6,1,0,0.00,7,6,3,7,16,18.75,1,1,0,2,0.00,0,3,5,8,-37.50,4,0,14,18,22.22,3,0,3,100.00,0,0,0,0, 
11718,GER,6,Kaliberda Denys ,OH,10,1,1,4.17,12,10,6,10,26,15.38,1,0,2,3,33.33,1,4,14,19,-15.79,2,4,4,10,-20.00,7,1,9,66.67,0,0,0,0, 
11718,GER,7,Sossenheimer David ,OH,0,0,2,12.50,2,0,0,0,0, ,0,0,0,0, ,2,1,5,8,12.50,0,0,0,0, ,0,0,0, ,1,0,0,1,100.00
11718,GER,8,BÃ¶hme Marcus ,MB,5,1,0,9.52,6,5,1,2,8,50.00,1,3,3,7,-28.57,0,0,6,6,0.00,0,0,0,0, ,1,0,2,50.00,0,0,0,0, 
11718,GER,10,Zenger Julian ,L,0,0,0, ,0,0,0,0,0, ,0,0,0,0, ,0,0,0,0, ,15,2,16,33,39.39,14,6,22,36.36,0,0,7,7,0.00
11718,GER,13,Hirsch Simon ,O,10,1,1,2.38,12,10,4,9,23,26.09,1,4,1,6,-50.00,1,3,9,13,-15.38,0,0,0,0, ,4,1,6,50.00,0,0,0,0, 
11718,GER,15,BaxpÃ¶hler Noah ,MB,0,0,0,-100.00,0,0,0,0,0, ,0,0,0,0, ,0,1,0,1,-100.00,0,0,0,0, ,0,0,0, ,0,0,0,0, 
11718,GER,16,BurggrÃ¤f Eric ,S,0,0,0,-100.00,0,0,0,0,0, ,0,0,0,0, ,0,1,0,1,-100.00,0,0,0,0, ,0,0,0, ,0,0,0,0, 
11718,GER,17,Zimmermann Jan ,S,0,0,2,9.52,2,0,0,0,0, ,0,0,5,5,0.00,2,0,14,16,12.50,0,0,0,0, ,7,5,13,15.38,21,0,90,111,18.92
11718,GER,18,Krage Florian ,MB,6,2,0,-9.68,8,6,1,2,9,55.56,2,7,2,11,-45.45,0,3,8,11,-27.27,0,1,0,1,-100.00,1,0,1,100.00,0,0,0,0, 
11718,GER,19,RÃ¶hrs Erik ,OH,0,0,0, ,0,0,0,0,0, ,0,0,0,0, ,0,0,0,0, ,0,0,0,0, ,0,0,0, ,0,0,0,0, 
11718,GER,21,Krick Tobias ,MB,5,6,0,14.29,11,5,3,2,10,20.00,6,2,6,14,28.57,0,2,2,4,-50.00,0,0,2,2,0.00,0,0,1,0.00,0,0,0,0, 
11718,BUL,1,Karyagin Denis ,O,1,0,1,40.00,2,1,0,2,3,33.33,0,0,0,0, ,1,0,1,2,50.00,0,1,1,2,-50.00,0,1,1,-100.00,0,0,0,0, 
11718,BUL,2,Chavdarov Stefan ,MB,0,0,0,0.00,0,0,0,2,2,0.00,0,0,1,1,0.00,0,0,1,1,0.00,1,0,0,1,100.00,0,0,0, ,0,0,0,0, 
11718,BUL,3,Kolev Nikolay ,MB,0,0,0, ,0,0,0,0,0, ,0,0,0,0, ,0,0,0,0, ,0,0,0,0, ,0,0,0, ,0,0,0,0, 
11718,BUL,4,Atanasov Martin ,OH,6,1,3,-10.26,10,6,7,9,22,-4.55,1,2,0,3,-33.33,3,5,6,14,-14.29,6,2,16,24,16.67,5,1,6,66.67,0,0,0,0, 
11718,BUL,9,Seganov Georgi ,S,0,3,0,-6.67,3,0,0,1,1,0.00,3,3,3,9,0.00,0,2,18,20,-10.00,0,0,1,1,0.00,2,1,6,16.67,31,0,86,117,26.50
11718,BUL,10,Stankov Svetoslav ,S,0,0,0, ,0,0,0,0,0, ,0,0,0,0, ,0,0,0,0, ,0,0,0,0, ,0,0,0, ,0,0,0,0, 
11718,BUL,11,Grozdanov Aleks ,MB,5,6,0,4.55,11,5,1,4,10,40.00,6,5,10,21,4.76,0,3,10,13,-23.08,3,0,1,4,75.00,4,0,5,80.00,1,0,0,1,100.00
11718,BUL,12,Petrov Georgi ,OH,1,0,0,-28.57,1,1,1,1,3,0.00,0,2,0,2,-100.00,0,0,2,2,0.00,0,0,6,6,0.00,1,0,1,100.00,0,0,0,0, 
11718,BUL,14,Asparuhov Asparuh ,OH,7,0,3,-4.26,10,7,6,11,24,4.17,0,2,1,3,-66.67,3,4,13,20,-5.00,8,3,19,30,16.67,7,0,7,100.00,0,0,0,0, 
11718,BUL,16,Ivanov Vladislav ,L,0,0,0, ,0,0,0,0,0, ,0,0,0,0, ,0,0,0,0, ,6,2,11,19,21.05,14,1,15,86.67,0,0,3,3,0.00
11718,BUL,19,Sokolov Tsvetan ,O,23,2,1,14.93,26,23,7,13,43,37.21,2,4,1,7,-28.57,1,5,11,17,-23.53,0,0,0,0, ,7,2,12,41.67,0,0,0,0, 
11718,BUL,22,Kartev Nikolay ,MB,7,2,1,-2.38,10,7,1,3,11,54.55,2,7,4,13,-38.46,1,3,14,18,-11.11,0,0,0,0, ,1,1,2,0.00,0,0,0,0, 
11718,BUL,24,Ivanov Martin ,L,0,0,0, ,0,0,0,0,0, ,0,0,0,0, ,0,0,0,0, ,0,0,0,0, ,0,0,0, ,0,0,0,0, 
11718,BUL,25,Parapunov Radoslav ,O,5,0,1,30.00,6,5,0,0,5,100.00,0,1,0,1,-100.00,1,2,1,4,-25.00,0,1,0,1,-100.00,2,0,2,100.00,0,0,0,0, 
11719,RUS,1,Podlesnykh Yaroslav ,OH,16,1,0,5.17,17,16,5,7,28,39.29,1,3,3,7,-28.57,0,6,17,23,-26.09,14,1,21,36,36.11,5,0,7,71.43,0,0,0,0, 
11719,RUS,2,Vlasov Ilia ,MB,0,0,0, ,0,0,0,0,0, ,0,0,0,0, ,0,0,0,0, ,0,0,0,0, ,0,0,0, ,0,0,0,0, 
11719,RUS,4,Volvich Artem ,MB,7,4,0,7.89,11,7,1,3,11,54.55,4,7,5,16,-18.75,0,0,11,11,0.00,0,0,1,1,0.00,1,0,2,50.00,0,0,0,0, 
11719,RUS,5,Semyshev Anton ,OH,0,0,0,0.00,0,0,0,0,0, ,0,0,0,0, ,0,0,2,2,0.00,0,0,0,0, ,0,1,1,-100.00,0,0,0,0, 
11719,RUS,6,Baranov Evgeny ,L,0,0,0, ,0,0,0,0,0, ,0,0,0,0, ,0,0,0,0, ,9,1,9,19,42.11,9,7,16,12.50,0,0,8,8,0.00
11719,RUS,7,Volkov Dmitry ,OH,0,0,0, ,0,0,0,0,0, ,0,0,0,0, ,0,0,0,0, ,0,0,0,0, ,0,0,0, ,0,0,0,0, 
11719,RUS,10,Bogdan Denis ,OH,6,0,0,0.00,6,6,2,7,15,26.67,0,3,1,4,-75.00,0,1,9,10,-10.00,2,0,5,7,28.57,4,0,5,80.00,0,0,0,0, 
11719,RUS,11,Pankov Pavel ,S,0,4,1,15.79,5,0,0,1,1,0.00,4,2,3,9,22.22,1,0,8,9,11.11,0,0,0,0, ,3,1,6,33.33,22,0,46,68,32.35
11719,RUS,15,Poletaev Victor ,O,0,0,1,14.29,1,0,0,0,0, ,0,0,0,0, ,1,0,6,7,14.29,0,0,0,0, ,1,0,1,100.00,0,0,0,0, 
11719,RUS,17,Mikhaylov Maxim ,O,20,1,2,14.71,23,20,4,14,38,42.11,1,6,2,9,-55.56,2,3,16,21,-4.76,1,0,4,5,20.00,8,2,11,54.55,0,0,0,0, 
11719,RUS,18,Kliuka Egor ,OH,9,2,3,12.82,14,9,4,9,22,22.73,2,1,2,5,20.00,3,4,5,12,-8.33,10,1,14,25,36.00,1,0,1,100.00,0,0,0,0, 
11719,RUS,20,Kurkaev Ilyas ,MB,6,6,0,5.41,12,6,2,1,9,44.44,6,6,3,15,0.00,0,2,11,13,-15.38,0,0,0,0, ,3,2,6,16.67,0,0,0,0, 
11719,RUS,24,Kobzar Igor ,S,1,0,0,-41.67,1,1,1,0,2,0.00,0,3,0,3,-100.00,0,2,5,7,-28.57,0,0,0,0, ,2,2,4,0.00,20,0,27,47,42.55
11719,RUS,27,Golubev Valentin ,L,0,0,0, ,0,0,0,0,0, ,0,0,0,0, ,0,0,0,0, ,0,0,0,0, ,0,0,0, ,0,0,0,0, 
11719,JPN,2,Onodera Taishi ,MB,0,0,0,-100.00,0,0,0,0,0, ,0,0,0,0, ,0,1,0,1,-100.00,0,0,0,0, ,0,0,0, ,0,0,0,0, 
11719,JPN,4,Otake Issei ,O,21,3,1,40.00,25,21,2,6,29,65.52,3,0,2,5,60.00,1,5,5,11,-36.36,0,0,0,0, ,3,5,10,-20.00,0,0,0,0, 
11719,JPN,5,Fukuzawa Tatsuya ,OH,14,0,0,13.16,14,14,5,9,28,32.14,0,2,0,2,-100.00,0,2,6,8,-25.00,6,1,12,19,26.32,5,0,7,71.43,0,0,0,0, 
11719,JPN,6,Yamauchi Akihiro ,MB,0,0,0, ,0,0,0,0,0, ,0,0,0,0, ,0,0,0,0, ,0,0,0,0, ,0,0,0, ,0,0,0,0, 
11719,JPN,12,Sekita Masahiro ,S,0,0,1,0.00,1,0,0,0,0, ,0,1,2,3,-33.33,1,0,11,12,8.33,0,0,1,1,0.00,6,2,9,44.44,15,0,64,79,18.99
11719,JPN,13,Oya Masaki ,S,0,0,0,-25.00,0,0,1,0,1,-100.00,0,2,1,3,-66.67,0,1,11,12,-8.33,0,0,0,0, ,2,1,4,25.00,17,0,37,54,31.48
11719,JPN,14,Ishikawa Yuki ,OH,0,0,0, ,0,0,0,0,0, ,0,0,0,0, ,0,0,0,0, ,0,0,0,0, ,0,0,0, ,0,0,0,0, 
11719,JPN,15,Ri Haku ,MB,8,2,1,7.89,11,8,2,0,10,60.00,2,5,2,9,-33.33,1,1,17,19,0.00,0,1,0,1,-100.00,6,1,7,71.43,0,0,0,0, 
11719,JPN,16,Takahashi Kentaro ,MB,8,2,0,13.33,10,8,2,4,14,42.86,2,0,2,4,50.00,0,4,8,12,-33.33,0,0,1,1,0.00,1,1,2,0.00,0,0,0,0, 
11719,JPN,17,Takanashi Kenta ,OH,17,0,0,18.18,17,17,4,13,34,38.24,0,1,1,2,-50.00,0,2,17,19,-10.53,10,4,19,33,18.18,8,12,20,-20.00,0,0,0,0, 
11719,JPN,19,Otsuka Tatsunori ,OH,6,0,0,-11.63,6,6,5,14,25,4.00,0,4,1,5,-80.00,0,2,11,13,-15.38,2,1,3,6,16.67,3,4,7,-14.29,0,0,0,0, 
11719,JPN,20,Yamamoto Tomohiro ,L,0,0,0, ,0,0,0,0,0, ,0,0,0,0, ,0,0,0,0, ,0,0,0,0, ,0,0,0, ,0,0,0,0, 
11719,JPN,21,Takahashi Ran ,OH,1,0,0,-22.22,1,1,0,1,2,50.00,0,0,0,0, ,0,3,4,7,-42.86,0,0,5,5,0.00,2,0,2,100.00,0,0,0,0, 
11719,JPN,24,Ogawa Tomohiro ,L,0,0,0, ,0,0,0,0,0, ,0,0,0,0, ,0,0,0,0, ,9,0,22,31,29.03,16,7,24,37.50,0,0,4,4,0.00
11720,USA,4,Jendryk II Jeffrey ,MB,0,0,0, ,0,0,0,0,0, ,0,0,0,0, ,0,0,0,0, ,0,0,0,0, ,0,0,0, ,0,0,0,0, 
11720,USA,5,Ensing Kyle ,O,13,3,0,41.94,16,13,0,5,18,72.22,3,1,1,5,40.00,0,2,6,8,-25.00,0,0,0,0, ,4,0,4,100.00,0,0,0,0, 
11720,USA,8,Defalco Torey ,OH,15,5,0,12.24,20,15,3,9,27,44.44,5,5,0,10,0.00,0,6,6,12,-50.00,14,0,22,36,38.89,4,0,6,66.67,0,0,6,6,0.00
11720,USA,11,Christenson Micah ,S,1,1,3,0.00,5,1,0,0,1,100.00,1,3,2,6,-33.33,3,2,16,21,4.76,0,0,0,0, ,2,2,4,0.00,37,0,45,82,45.12
11720,USA,12,Holt Maxwell ,MB,6,0,1,0.00,7,6,0,3,9,66.67,0,2,0,2,-100.00,1,5,18,24,-16.67,0,0,1,1,0.00,2,0,2,100.00,0,0,2,2,0.00
11720,USA,13,Patch Benjamin ,O,6,3,1,0.00,10,6,6,3,15,0.00,3,1,0,4,50.00,1,3,2,6,-33.33,0,0,0,0, ,2,0,4,50.00,0,0,1,1,0.00
11720,USA,15,Sander Brenden ,OH,0,0,0, ,0,0,0,0,0, ,0,0,0,0, ,0,0,0,0, ,0,0,0,0, ,0,0,0, ,0,0,0,0, 
11720,USA,16,Tuaniga Joshua ,S,0,0,0, ,0,0,0,0,0, ,0,0,0,0, ,0,0,0,0, ,0,0,0,0, ,0,0,0, ,0,0,0,0, 
11720,USA,17,Jaeschke Thomas ,OH,0,0,0, ,0,0,0,0,0, ,0,0,0,0, ,0,0,0,0, ,0,0,0,0, ,0,0,0, ,0,0,0,0, 
11720,USA,18,Muagututia Garrett ,OH,5,0,1,-7.69,6,5,5,11,21,0.00,0,2,1,3,-66.67,1,2,12,15,-6.67,7,0,7,14,50.00,9,4,15,33.33,0,0,5,5,0.00
11720,USA,19,Averill Taylor ,MB,0,0,0, ,0,0,0,0,0, ,0,0,0,0, ,0,0,0,0, ,0,0,0,0, ,0,0,0, ,0,0,0,0, 
11720,USA,20,Smith David ,MB,8,0,0,3.85,8,8,2,4,14,42.86,0,0,1,1,0.00,0,5,6,11,-45.45,0,0,0,0, ,1,0,1,100.00,0,0,1,1,0.00
11720,USA,21,Watten Dustin ,L,0,0,0, ,0,0,0,0,0, ,0,0,0,0, ,0,0,0,0, ,0,0,0,0, ,0,0,0, ,0,0,0,0, 
11720,USA,22,Shoji Erik ,L,0,0,0, ,0,0,0,0,0, ,0,0,0,0, ,0,0,0,0, ,9,1,5,15,53.33,6,5,11,9.09,0,0,3,3,0.00
11720,ARG,2,Pereyra Federico ,O,7,1,0,-8.82,8,7,8,7,22,-4.55,1,0,0,1,100.00,0,3,8,11,-27.27,0,0,0,0, ,1,0,1,100.00,0,0,4,4,0.00
11720,ARG,3,Martinez Franchi Jan ,OH,9,0,0,2.38,9,9,4,13,26,19.23,0,3,0,3,-100.00,0,1,12,13,-7.69,4,0,14,18,22.22,4,1,5,60.00,0,0,5,5,0.00
11720,ARG,5,Uriarte Nicolas ,S,0,1,0,25.00,1,0,0,0,0, ,1,0,1,2,50.00,0,0,2,2,0.00,0,0,0,0, ,1,1,2,0.00,6,0,8,14,42.86
11720,ARG,7,Conte Facundo ,OH,7,1,1,-2.50,9,7,4,11,22,13.64,1,2,1,4,-25.00,1,4,9,14,-21.43,7,2,13,22,22.73,6,3,9,33.33,0,0,6,6,0.00
11720,ARG,11,SolÃ© Sebastian ,MB,3,2,0,9.52,5,3,0,2,5,60.00,2,2,2,6,0.00,0,1,9,10,-10.00,1,0,1,2,50.00,0,0,0, ,0,0,0,0, 
11720,ARG,15,De Cecco Luciano ,S,1,0,0,-17.65,1,1,0,3,4,25.00,0,1,1,2,-50.00,0,3,8,11,-27.27,0,0,2,2,0.00,2,0,3,66.67,22,0,43,65,33.85
11720,ARG,16,Palonsky Luciano ,OH,5,1,0,4.76,6,5,4,4,13,7.69,1,0,0,1,100.00,0,1,6,7,-14.29,0,0,0,0, ,1,1,2,0.00,0,0,0,0, 
11720,ARG,17,Mendez Nicolas ,OH,0,0,0, ,0,0,0,0,0, ,0,0,0,0, ,0,0,0,0, ,4,3,20,27,3.70,12,5,18,38.89,0,0,3,3,0.00
11720,ARG,18,Ramos Martin ,MB,4,3,0,-3.45,7,4,1,2,7,42.86,3,5,1,9,-22.22,0,2,11,13,-15.38,0,1,0,1,-100.00,1,1,2,0.00,0,0,0,0, 
11721,CAN,3,Marshall Steven ,OH,0,0,0, ,0,0,0,0,0, ,0,0,0,0, ,0,0,0,0, ,1,0,3,4,25.00,2,1,3,33.33,0,0,0,0, 
11721,CAN,4,Hoag Nicholas ,OH,7,1,0,0.00,8,7,5,9,21,9.52,1,0,1,2,50.00,0,3,10,13,-23.08,10,3,15,28,25.00,5,2,7,42.86,0,0,0,0, 
11721,CAN,6,Pereira Jordan ,OH,0,0,0, ,0,0,0,0,0, ,0,0,0,0, ,0,0,0,0, ,0,0,0,0, ,5,4,10,10.00,0,0,2,2,0.00
11721,CAN,7,Maar Stephen Timothy ,OH,0,0,0, ,0,0,0,0,0, ,0,0,0,0, ,0,0,0,0, ,0,0,0,0, ,0,0,0, ,0,0,0,0, 
11721,CAN,8,Blankenau Jay ,S,0,0,0, ,0,0,0,0,0, ,0,0,0,0, ,0,0,0,0, ,0,0,0,0, ,0,0,0, ,0,0,0,0, 
11721,CAN,10,Sclater Ryan Joseph ,O,0,0,0,0.00,0,0,0,0,0, ,0,0,0,0, ,0,0,4,4,0.00,0,0,0,0, ,0,0,0, ,0,0,0,0, 
11721,CAN,11,Jansen Vandoorn Daniel ,MB,0,0,0, ,0,0,0,0,0, ,0,0,0,0, ,0,0,0,0, ,0,0,0,0, ,0,0,0, ,0,0,0,0, 
11721,CAN,12,Van Berkel Lucas ,MB,4,3,1,3.03,8,4,0,2,6,66.67,3,7,2,12,-33.33,1,0,14,15,6.67,2,0,3,5,40.00,0,0,0, ,0,0,0,0, 
11721,CAN,13,Vernon-Evans Sharone ,O,21,2,1,13.64,24,21,5,18,44,36.36,2,4,2,8,-25.00,1,6,7,14,-35.71,0,0,1,1,0.00,5,4,11,9.09,0,0,0,0, 
11721,CAN,14,Loeppky Eric ,OH,13,1,0,20.45,14,13,2,11,26,42.31,1,2,2,5,-20.00,0,1,12,13,-7.69,6,0,15,21,28.57,7,3,12,33.33,0,0,0,0, 
11721,CAN,19,Bann Blair Cameron ,L,0,0,0, ,0,0,0,0,0, ,0,0,0,0, ,0,0,0,0, ,9,2,15,26,26.92,4,1,6,50.00,0,0,1,1,0.00
11721,CAN,20,Szwarc Arthur ,O,6,4,0,5.88,10,6,2,3,11,36.36,4,3,2,9,11.11,0,3,11,14,-21.43,0,1,0,1,-100.00,4,0,4,100.00,0,0,0,0, 
11721,CAN,21,Walsh Brett James ,S,1,1,0,-16.67,2,1,1,1,3,0.00,1,1,4,6,0.00,0,4,11,15,-26.67,0,0,0,0, ,3,4,7,-14.29,24,1,78,103,22.33
11721,CAN,23,Demyanenko Danny ,MB,0,0,0, ,0,0,0,0,0, ,0,0,0,0, ,0,0,0,0, ,0,0,0,0, ,0,0,0, ,0,0,0,0, 
11721,BRA,1,Rezende Bruno Mossa ,S,0,0,0, ,0,0,0,0,0, ,0,0,0,0, ,0,0,0,0, ,0,0,0,0, ,2,0,2,100.00,2,0,3,5,40.00
11721,BRA,5,Borges Almeida Silva Mauricio ,OH,7,0,2,5.41,9,7,3,8,18,22.22,0,1,3,4,-25.00,2,3,10,15,-6.67,8,2,15,25,24.00,5,2,8,37.50,0,0,0,0, 
11721,BRA,6,Gil Kreling Fernando ,S,0,1,1,0.00,2,0,0,1,1,0.00,1,2,0,3,-33.33,1,0,12,13,7.69,0,0,1,1,0.00,8,2,10,60.00,24,2,76,102,21.57
11721,BRA,8,De Souza Wallace ,O,19,0,0,29.17,19,19,2,12,33,51.52,0,1,0,1,-100.00,0,2,12,14,-14.29,0,0,0,0, ,7,1,9,66.67,3,0,0,3,100.00
11721,BRA,10,Bispo dos Santos Matheus ,MB,1,0,0,0.00,1,1,1,0,2,0.00,0,0,1,1,0.00,0,0,3,3,0.00,0,0,0,0, ,1,0,1,100.00,0,0,0,0, 
11721,BRA,11,Kavalkievicz Gabriel ,OH,1,0,0,100.00,1,1,0,0,1,100.00,0,0,0,0, ,0,0,0,0, ,0,0,0,0, ,0,0,0, ,0,0,0,0, 
11721,BRA,12,Santos Isac ,MB,4,3,1,0.00,8,4,1,6,11,27.27,3,3,2,8,0.00,1,4,12,17,-17.65,0,0,0,0, ,5,0,6,83.33,0,0,0,0, 
11721,BRA,14,Correia De Souza Douglas ,OH,20,1,1,18.87,22,20,9,3,32,34.38,1,2,3,6,-16.67,1,1,13,15,0.00,4,0,15,19,21.05,3,2,6,16.67,0,0,0,0, 
11721,BRA,15,Nascimento Maique Reis ,L,0,0,0, ,0,0,0,0,0, ,0,0,0,0, ,0,0,0,0, ,0,0,0,0, ,0,0,0, ,0,0,0,0, 
11721,BRA,17,Hoss Thales ,L,0,0,0, ,0,0,0,0,0, ,0,0,0,0, ,0,0,0,0, ,13,0,9,22,59.09,7,4,12,25.00,0,0,6,6,0.00
11721,BRA,18,Souza Ricardo Lucarelli ,OH,2,0,0,22.22,2,2,0,4,6,33.33,0,0,1,1,0.00,0,0,2,2,0.00,0,0,3,3,0.00,3,0,3,100.00,0,0,0,0, 
11721,BRA,19,Moreira Roque Felipe ,O,0,0,0,-33.33,0,0,0,1,1,0.00,0,1,0,1,-100.00,0,0,1,1,0.00,0,0,0,0, ,0,0,0, ,0,0,0,0, 
11721,BRA,21,Souza Alan ,O,0,0,0, ,0,0,0,0,0, ,0,0,0,0, ,0,0,0,0, ,0,0,0,0, ,0,0,0, ,0,0,0,0, 
11721,BRA,23,Resende Gualberto Flavio ,MB,6,1,1,0.00,8,6,2,6,14,28.57,1,4,2,7,-42.86,1,2,15,18,-5.56,1,0,0,1,100.00,4,2,6,33.33,0,0,0,0, 
11722,POL,2,Muzaj Maciej ,O,0,0,0,-57.14,0,0,1,2,3,-33.33,0,3,0,3,-100.00,0,0,1,1,0.00,0,0,0,0, ,0,0,0, ,0,0,1,1,0.00
11722,POL,5,Kaczmarek Lukasz ,O,15,2,0,0.00,17,15,8,12,35,20.00,2,5,2,9,-33.33,0,4,10,14,-28.57,0,0,0,0, ,4,1,5,60.00,0,0,0,0, 
11722,POL,10,Wojtaszek Damian ,L,0,0,0, ,0,0,0,0,0, ,0,0,0,0, ,0,0,0,0, ,11,1,11,23,43.48,9,3,13,46.15,0,1,3,4,-25.00
11722,POL,11,Drzyzga Fabian ,S,0,0,0, ,0,0,0,0,0, ,0,0,0,0, ,0,0,0,0, ,0,0,0,0, ,0,0,0, ,3,0,6,9,33.33
11722,POL,12,Lomacz Grzegorz ,S,0,0,1,-7.14,1,0,0,0,0, ,0,2,1,3,-66.67,1,0,10,11,9.09,0,0,0,0, ,3,2,5,20.00,27,0,62,89,30.34
11722,POL,13,Kubiak Michal ,OH,8,0,0,2.17,8,8,4,17,29,13.79,0,1,1,2,-50.00,0,2,13,15,-13.33,10,2,13,25,32.00,4,6,11,-18.18,0,0,8,8,0.00
11722,POL,14,Sliwka Aleksander ,OH,13,0,0,11.11,13,13,4,19,36,25.00,0,2,0,2,-100.00,0,1,15,16,-6.25,13,2,15,30,36.67,3,2,5,20.00,0,0,4,4,0.00
11722,POL,17,Zatorski Pawel ,L,0,0,0, ,0,0,0,0,0, ,0,0,0,0, ,0,0,0,0, ,0,0,0,0, ,0,0,0, ,0,0,0,0, 
11722,POL,19,Janusz Marcin ,S,0,0,0, ,0,0,0,0,0, ,0,0,0,0, ,0,0,0,0, ,0,0,0,0, ,0,0,0, ,0,0,0,0, 
11722,POL,20,Bieniek Mateusz ,MB,9,5,2,18.37,16,9,1,7,17,47.06,5,5,2,12,0.00,2,1,17,20,5.00,0,0,1,1,0.00,2,1,3,33.33,0,0,0,0, 
11722,POL,21,Fornal Tomasz ,OH,0,0,0,-33.33,0,0,0,0,0, ,0,0,0,0, ,0,1,2,3,-33.33,0,0,0,0, ,0,1,1,-100.00,0,0,0,0, 
11722,POL,22,Bednorz Bartosz ,OH,0,0,0, ,0,0,0,0,0, ,0,0,0,0, ,0,0,0,0, ,0,0,0,0, ,0,0,0, ,0,0,0,0, 
11722,POL,77,Klos Karol ,MB,6,1,0,4.00,7,6,0,2,8,75.00,1,4,2,7,-42.86,0,2,8,10,-20.00,0,0,2,2,0.00,0,1,1,-100.00,0,0,2,2,0.00
11722,POL,99,Huber Norbert ,MB,0,0,0, ,0,0,0,0,0, ,0,0,0,0, ,0,0,0,0, ,0,0,0,0, ,0,0,0, ,0,0,0,0, 
11722,SLO,1,Å tern TonÄek ,O,15,2,1,14.04,18,15,3,19,37,32.43,2,4,0,6,-33.33,1,3,10,14,-14.29,0,0,0,0, ,0,1,1,-100.00,0,0,2,2,0.00
11722,SLO,2,Pajenk Alen ,MB,6,1,3,18.18,10,6,1,7,14,35.71,1,1,0,2,0.00,3,2,12,17,5.88,0,0,2,2,0.00,1,0,1,100.00,0,0,3,3,0.00
11722,SLO,4,Kozamernik Jan ,MB,7,2,0,0.00,9,7,2,4,13,38.46,2,5,2,9,-33.33,0,2,12,14,-14.29,0,0,1,1,0.00,0,1,1,-100.00,0,0,3,3,0.00
11722,SLO,5,Å ket Alen ,O,2,0,1,60.00,3,2,0,1,3,66.67,0,0,0,0, ,1,0,1,2,50.00,0,0,0,0, ,0,0,0, ,0,0,0,0, 
11722,SLO,9,Vincic Dejan ,S,0,0,0, ,0,0,0,0,0, ,0,0,0,0, ,0,0,0,0, ,0,0,0,0, ,0,0,0, ,1,1,2,4,0.00
11722,SLO,10,Å talekar SaÅ¡o ,MB,0,0,0, ,0,0,0,0,0, ,0,0,0,0, ,0,0,0,0, ,0,0,0,0, ,0,0,0, ,0,0,0,0, 
11722,SLO,11,Å tern Å½iga ,OH,0,0,0, ,0,0,0,0,0, ,0,0,0,0, ,0,0,0,0, ,0,0,0,0, ,0,0,0, ,0,0,0,0, 
11722,SLO,12,Klobucar Jan ,L,0,0,0, ,0,0,0,0,0, ,0,0,0,0, ,0,0,0,0, ,0,0,0,0, ,0,0,0, ,2,0,1,3,66.67
11722,SLO,13,KovaÄiÄ Jani ,L,0,0,0, ,0,0,0,0,0, ,0,0,0,0, ,0,0,0,0, ,8,1,10,19,36.84,17,5,23,52.17,0,0,4,4,0.00
11722,SLO,15,VideÄnik Matic ,MB,0,0,0, ,0,0,0,0,0, ,0,0,0,0, ,0,0,0,0, ,0,0,0,0, ,0,0,0, ,0,0,0,0, 
11722,SLO,16,Ropret Gregor ,S,2,1,0,-3.85,3,2,1,0,3,33.33,1,1,0,2,0.00,0,2,19,21,-9.52,0,0,0,0, ,4,3,7,14.29,37,0,59,96,38.54
11722,SLO,17,Urnaut Tine ,OH,12,1,0,12.50,13,12,2,17,31,32.26,1,2,0,3,-33.33,0,3,11,14,-21.43,18,1,14,33,51.52,5,1,6,66.67,0,1,9,10,-10.00
11722,SLO,18,Äebulj Klemen ,OH,16,1,0,5.08,17,16,7,17,40,22.50,1,3,0,4,-50.00,0,4,11,15,-26.67,10,1,13,24,37.50,3,4,8,-12.50,0,0,6,6,0.00
11722,SLO,19,MoÅ¾iÄ Rok ,OH,1,0,0,100.00,1,1,0,0,1,100.00,0,0,0,0, ,0,0,0,0, ,0,0,0,0, ,0,0,0, ,0,0,0,0, 
11723,SRB,3,Kapur Milorad ,L,0,0,0, ,0,0,0,0,0, ,0,0,0,0, ,0,0,0,0, ,0,0,0,0, ,0,0,0, ,0,0,0,0, 
11723,SRB,6,Pekovic Nikola ,L,0,0,0, ,0,0,0,0,0, ,0,0,0,0, ,0,0,0,0, ,9,0,6,15,60.00,11,2,13,69.23,0,1,10,11,-9.09
11723,SRB,7,Krsmanovic Petar ,MB,3,0,0,-17.39,3,3,1,2,6,33.33,0,3,1,4,-75.00,0,3,10,13,-23.08,0,0,0,0, ,1,0,1,100.00,0,0,0,0, 
11723,SRB,8,Ivovic Marko ,OH,17,0,0,18.18,17,17,3,17,37,37.84,0,1,5,6,-16.67,0,3,9,12,-25.00,6,1,14,21,23.81,7,2,9,55.56,0,0,0,0, 
11723,SRB,9,Jovovic Nikola ,S,1,1,1,0.00,3,1,0,1,2,50.00,1,1,6,8,0.00,1,2,13,16,-6.25,0,0,1,1,0.00,10,3,14,50.00,26,1,77,104,24.04
11723,SRB,10,KujundÅ¾iÄ Miran ,OH,0,0,0, ,0,0,0,0,0, ,0,0,0,0, ,0,0,0,0, ,0,0,0,0, ,0,0,0, ,0,0,0,0, 
11723,SRB,12,Peric Pavle ,OH,9,3,0,2.63,12,9,3,8,20,30.00,3,2,1,6,16.67,0,6,6,12,-50.00,9,0,23,32,28.12,8,3,11,45.45,0,0,0,0, 
11723,SRB,13,Simic Stevan ,MB,3,3,0,17.65,6,3,0,0,3,100.00,3,3,1,7,0.00,0,0,7,7,0.00,0,0,3,3,0.00,1,2,3,-33.33,0,0,0,0, 
11723,SRB,14,Atanasijevic Aleksandar ,O,0,0,0,-16.67,0,0,0,3,3,0.00,0,0,1,1,0.00,0,1,1,2,-50.00,0,0,0,0, ,1,0,1,100.00,0,0,0,0, 
11723,SRB,16,Luburic Drazen ,O,18,1,2,9.09,21,18,5,17,40,32.50,1,3,3,7,-28.57,2,7,10,19,-26.32,0,0,0,0, ,4,1,5,60.00,0,0,0,0, 
11723,SRB,18,Podrascanin Marko ,MB,10,3,1,19.05,14,10,2,2,14,57.14,3,4,6,13,-7.69,1,0,14,15,6.67,0,0,1,1,0.00,0,0,1,0.00,0,0,0,0, 
11723,SRB,21,Todorovic Vuk ,S,0,0,0, ,0,0,0,0,0, ,0,0,0,0, ,0,0,0,0, ,0,0,0,0, ,1,1,2,0.00,0,0,7,7,0.00
11723,SRB,23,Vucicevic Bozidar ,O,0,0,0, ,0,0,0,0,0, ,0,0,0,0, ,0,0,0,0, ,0,0,0,0, ,0,0,0, ,0,0,0,0, 
11723,SRB,26,Kovac Davide ,OH,0,0,0, ,0,0,0,0,0, ,0,0,0,0, ,0,0,0,0, ,0,0,0,0, ,0,0,0, ,0,0,0,0, 
11723,ITA,1,Gardini Davide ,OH,0,0,0, ,0,0,0,0,0, ,0,0,0,0, ,0,0,0,0, ,0,1,0,1,-100.00,0,0,0, ,0,0,0,0, 
11723,ITA,7,Balaso Fabio ,L,0,0,0, ,0,0,0,0,0, ,0,0,0,0, ,0,0,0,0, ,8,1,15,24,29.17,14,5,21,42.86,0,0,8,8,0.00
11723,ITA,11,Galassi Gianluca ,MB,3,1,0,-13.79,4,3,2,0,5,20.00,1,2,6,9,-11.11,0,4,11,15,-26.67,0,0,0,0, ,5,0,5,100.00,0,0,0,0, 
11723,ITA,15,Sbertoli Riccardo ,S,0,1,0,-28.57,1,0,0,0,0, ,1,2,1,4,-25.00,0,3,7,10,-30.00,0,0,0,0, ,8,3,12,41.67,15,0,93,108,13.89
11723,ITA,18,Michieletto Alessandro ,OH,9,2,0,7.41,11,9,4,17,30,16.67,2,0,4,6,33.33,0,3,15,18,-16.67,5,1,14,20,20.00,6,2,9,44.44,0,0,0,0, 
11723,ITA,20,Nelli Gabriele ,O,0,0,0,-40.00,0,0,1,1,2,-50.00,0,0,2,2,0.00,0,1,0,1,-100.00,0,0,0,0, ,0,0,0, ,0,0,0,0, 
11723,ITA,21,Spirito Luca ,S,0,0,0,-33.33,0,0,0,0,0, ,0,1,1,2,-50.00,0,0,1,1,0.00,0,0,0,0, ,1,1,2,0.00,2,0,2,4,50.00
11723,ITA,23,Pinali Giulio ,O,21,0,1,16.39,22,21,4,14,39,43.59,0,5,1,6,-83.33,1,3,12,16,-12.50,0,0,0,0, ,3,5,8,-25.00,0,0,0,0, 
11723,ITA,24,Cavuto Oreste ,OH,0,0,0, ,0,0,0,0,0, ,0,0,0,0, ,0,0,0,0, ,0,0,0,0, ,0,0,0, ,0,0,0,0, 
11723,ITA,25,Vitelli Marco ,MB,0,0,0, ,0,0,0,0,0, ,0,0,0,0, ,0,0,0,0, ,0,0,0,0, ,0,0,0, ,0,0,0,0, 
11723,ITA,28,Recine Francesco ,OH,9,1,0,1.85,10,9,5,18,32,12.50,1,2,4,7,-14.29,0,2,13,15,-13.33,9,1,18,28,28.57,8,3,11,45.45,0,0,0,0, 
11723,ITA,29,Bottolo Mattia ,OH,0,0,0, ,0,0,0,0,0, ,0,0,0,0, ,0,0,0,0, ,0,0,0,0, ,0,0,0, ,0,0,0,0, 
11723,ITA,30,Mosca Leandro Ausibio ,MB,6,2,0,8.82,8,6,0,6,12,50.00,2,5,2,9,-33.33,0,0,13,13,0.00,1,0,0,1,100.00,2,1,3,33.33,0,0,0,0, 
11723,ITA,31,Federici Filippo ,L,0,0,0, ,0,0,0,0,0, ,0,0,0,0, ,0,0,0,0, ,0,0,0,0, ,0,0,0, ,0,0,0,0, 
11854,THA,2,Pannoy Piyanut ,L,0,0,0, ,0,0,0,0,0, ,0,0,0,0, ,0,0,0,0, ,4,1,9,14,21.43,6,5,11,9.09,0,0,1,1,0.00
11854,THA,3,ManaKij Sirima ,S,0,0,0, ,0,0,0,0,0, ,0,0,0,0, ,0,0,0,0, ,0,0,0,0, ,0,1,1,-100.00,0,0,0,0, 
11854,THA,5,Thinkaow Pleumjit ,MB,5,1,2,12.00,8,5,2,6,13,23.08,1,2,2,5,-20.00,2,1,4,7,14.29,0,0,0,0, ,0,0,0, ,0,0,0,0, 
11854,THA,6,Sittirak Onuma ,OH,10,0,0,15.38,10,10,4,17,31,19.35,0,0,1,1,0.00,0,0,7,7,0.00,1,0,3,4,25.00,1,3,4,-50.00,0,0,0,0, 
11854,THA,9,Chuewulim Sutadta ,OH,2,0,0,-12.50,2,2,3,5,10,-10.00,0,1,0,1,-100.00,0,0,5,5,0.00,2,2,8,12,0.00,1,2,3,-33.33,0,0,0,0, 
11854,THA,10,Apinyapong Wilavan ,L,0,0,0, ,0,0,0,0,0, ,0,0,0,0, ,0,0,0,0, ,0,0,0,0, ,6,5,12,8.33,0,0,0,0, 
11854,THA,11,Hyapha Amporn ,MB,0,0,0, ,0,0,0,0,0, ,0,0,0,0, ,0,0,0,0, ,0,0,0,0, ,0,0,0, ,0,0,0,0, 
11854,THA,12,Chaisri Tapaphaipun ,L,2,0,0,8.33,2,2,1,5,8,12.50,0,0,0,0, ,0,0,4,4,0.00,6,0,4,10,60.00,0,0,0, ,0,0,0,0, 
11854,THA,13,Tomkom Nootsara ,S,0,1,0,0.00,1,0,1,2,3,-33.33,1,0,1,2,50.00,0,0,7,7,0.00,0,0,0,0, ,1,7,8,-75.00,6,0,0,6,100.00
11854,THA,14,Juangjan Pattiya ,OH,1,0,0,-25.00,1,1,2,1,4,-25.00,0,0,0,0, ,0,0,0,0, ,0,0,0,0, ,0,0,0, ,0,0,0,0, 
11854,THA,15,Kanthong Malika ,O,5,0,0,13.04,5,5,1,7,13,30.77,0,0,1,1,0.00,0,1,8,9,-11.11,7,1,9,17,35.29,9,3,13,46.15,0,0,0,0, 
11854,THA,19,Krause Karina ,MB,1,0,0,-44.44,1,1,4,1,6,-50.00,0,0,0,0, ,0,1,2,3,-33.33,0,0,0,0, ,0,0,0, ,0,0,0,0, 
11854,THA,22,Nilapa Chatsuda ,OH,0,0,0,0.00,0,0,0,1,1,0.00,0,0,0,0, ,0,0,1,1,0.00,1,0,4,5,20.00,2,1,3,33.33,0,0,0,0, 
11854,THA,24,Nuanjam Watchareeya ,MB,2,1,0,5.26,3,2,1,9,12,8.33,1,1,0,2,0.00,0,0,5,5,0.00,0,1,0,1,-100.00,0,0,0, ,0,0,0,0, 
11854,NED,1,Knip Kirsten ,L,0,0,0, ,0,0,0,0,0, ,0,0,0,0, ,0,0,0,0, ,2,0,1,3,66.67,5,0,5,100.00,0,0,0,0, 
11854,NED,2,Savelkoel Fleur ,OH,1,0,0,33.33,1,1,0,2,3,33.33,0,0,0,0, ,0,0,0,0, ,0,0,0,0, ,0,0,0, ,0,0,0,0, 
11854,NED,7,Lohuis Juliet ,MB,3,0,1,-4.17,4,3,0,0,3,100.00,0,1,2,3,-33.33,1,4,13,18,-16.67,0,0,0,0, ,1,1,3,0.00,0,0,0,0, 
11854,NED,8,Korevaar Demi ,MB,0,0,0,0.00,0,0,0,0,0, ,0,0,2,2,0.00,0,0,0,0, ,0,0,0,0, ,0,0,0, ,0,0,0,0, 
11854,NED,9,Schoot Myrthe ,L,0,0,0, ,0,0,0,0,0, ,0,0,0,0, ,0,0,0,0, ,3,0,1,4,75.00,7,1,10,60.00,0,1,0,1,-100.00
11854,NED,10,van Aalen Sarah ,S,0,0,0,0.00,0,0,0,0,0, ,0,0,0,0, ,0,0,1,1,0.00,0,0,0,0, ,0,0,0, ,0,0,0,0, 
11854,NED,11,Buijs Anne ,OH,10,0,3,28.21,13,10,1,8,19,47.37,0,1,0,1,-100.00,3,0,16,19,15.79,5,1,11,17,23.53,5,2,10,30.00,0,0,0,0, 
11854,NED,12,Bongaerts Britt ,S,4,3,0,26.32,7,4,0,3,7,57.14,3,2,1,6,16.67,0,0,6,6,0.00,0,0,0,0, ,2,2,5,0.00,19,0,0,19,100.00
11854,NED,16,Baijens Indy ,MB,3,0,0,12.50,3,3,1,0,4,50.00,0,1,1,2,-50.00,0,0,2,2,0.00,0,0,1,1,0.00,0,0,0, ,0,0,0,0, 
11854,NED,18,Jasper Marrit ,OH,0,0,0,-33.33,0,0,0,0,0, ,0,0,0,0, ,0,1,2,3,-33.33,0,0,1,1,0.00,1,0,1,100.00,0,0,0,0, 
11854,NED,19,Daalderop Nika ,OH,11,1,0,18.92,12,11,1,9,21,47.62,1,3,2,6,-33.33,0,1,9,10,-10.00,12,1,3,16,68.75,7,1,8,75.00,0,0,0,0, 
11854,NED,21,Meijers Annick ,OH,1,0,0,50.00,1,1,0,1,2,50.00,0,0,0,0, ,0,0,0,0, ,0,0,0,0, ,0,0,0, ,0,0,0,0, 
11854,NED,23,Timmerman Eline ,MB,4,6,1,21.43,11,4,0,6,10,40.00,6,2,1,9,44.44,1,3,5,9,-22.22,0,0,1,1,0.00,1,0,1,100.00,0,0,0,0, 
11854,NED,26,Dambrink Elles ,O,11,0,0,13.33,11,11,1,7,19,52.63,0,4,1,5,-80.00,0,2,4,6,-33.33,2,0,0,2,100.00,2,1,3,33.33,0,0,0,0, 
11855,BEL,3,Herbots Britt ,OH,32,1,0,22.11,33,32,5,29,66,40.91,1,5,5,11,-36.36,0,2,16,18,-11.11,2,0,8,10,20.00,14,4,18,55.56,0,0,0,0, 
11855,BEL,4,Lemmens Nathalie ,MB,2,0,0,-16.00,2,2,0,3,5,40.00,0,5,5,10,-50.00,0,1,9,10,-10.00,0,0,0,0, ,4,0,4,100.00,0,0,0,0, 
11855,BEL,5,Guilliams Jodie ,OH,14,3,1,6.94,18,14,6,24,44,18.18,3,5,3,11,-18.18,1,2,14,17,-5.88,7,1,3,11,54.55,15,5,24,41.67,0,0,0,0, 
11855,BEL,6,Gilson Helena ,OH,0,0,0, ,0,0,0,0,0, ,0,0,0,0, ,0,0,0,0, ,0,0,0,0, ,0,0,0, ,0,0,0,0, 
11855,BEL,7,Van Gestel Celine ,OH,9,0,4,6.56,13,9,4,17,30,16.67,0,5,4,9,-55.56,4,0,18,22,18.18,12,0,20,32,37.50,18,4,22,63.64,0,0,0,0, 
11855,BEL,9,Demeyer Nel ,L,0,0,0, ,0,0,0,0,0, ,0,0,0,0, ,0,0,0,0, ,0,0,0,0, ,0,0,0, ,0,0,0,0, 
11855,BEL,10,Sobolska Dominika ,MB,1,0,0,-23.53,1,1,0,5,6,16.67,0,5,2,7,-71.43,0,0,4,4,0.00,0,0,0,0, ,1,0,1,100.00,0,0,0,0, 
11855,BEL,13,Janssens Marlies ,MB,8,5,2,10.20,15,8,1,5,14,50.00,5,7,4,16,-12.50,2,2,15,19,0.00,0,0,0,0, ,5,0,6,83.33,0,1,0,1,-100.00
11855,BEL,14,De Valkeneer Lise ,OH,0,0,0, ,0,0,0,0,0, ,0,0,0,0, ,0,0,0,0, ,0,0,0,0, ,0,0,0, ,0,0,0,0, 
11855,BEL,15,Van De Vyver Jutta ,S,0,0,0, ,0,0,0,0,0, ,0,0,0,0, ,0,0,0,0, ,0,0,0,0, ,0,0,0, ,0,0,0,0, 
11855,BEL,17,Van De Vyver Ilka ,S,0,0,4,-6.06,4,0,0,3,3,0.00,0,5,3,8,-62.50,4,1,17,22,13.64,0,0,2,2,0.00,16,5,21,52.38,22,0,0,22,100.00
11855,BEL,18,Rampelberg Britt ,L,0,0,0, ,0,0,0,0,0, ,0,0,0,0, ,0,0,0,0, ,14,2,18,34,35.29,11,5,16,37.50,1,1,0,2,0.00
11855,BEL,19,Van Avermaet Silke ,MB,1,0,0,0.00,1,1,0,0,1,100.00,0,1,0,1,-100.00,0,0,0,0, ,0,0,0,0, ,0,0,0, ,0,0,0,0, 
11855,BEL,21,Stragier Manon ,OH,0,0,0,0.00,0,0,0,0,0, ,0,0,0,0, ,0,0,3,3,0.00,0,0,0,0, ,0,0,0, ,0,0,0,0, 
11855,DOM,1,Vargas Valdez Annerys Victoria ,MB,0,0,0,-100.00,0,0,0,0,0, ,0,2,0,2,-100.00,0,0,0,0, ,0,0,0,0, ,0,0,0, ,0,0,0,0, 
11855,DOM,3,Eve Mejia Lisvel Elisa ,U,3,2,0,-11.90,5,3,2,1,6,16.67,2,6,7,15,-26.67,0,2,19,21,-9.52,9,6,7,22,13.64,15,3,19,63.16,0,0,0,0, 
11855,DOM,5,Castillo Brenda ,L,0,0,0, ,0,0,0,0,0, ,0,0,0,0, ,0,0,0,0, ,8,0,22,30,26.67,23,5,30,60.00,0,0,0,0, 
11855,DOM,6,Dominguez Martinez Camil Inmaculada ,S,0,0,0, ,0,0,0,0,0, ,0,0,0,0, ,0,0,0,0, ,0,0,0,0, ,1,0,1,100.00,0,0,0,0, 
11855,DOM,7,Marte Frica Niverka Dharlenis ,S,0,0,0,-13.04,0,0,0,4,4,0.00,0,2,2,4,-50.00,0,1,14,15,-6.67,0,0,0,0, ,6,3,10,30.00,15,2,1,18,72.22
11855,DOM,11,Rodriguez Marifranchi ,MB,0,0,0, ,0,0,0,0,0, ,0,0,0,0, ,0,0,0,0, ,0,0,0,0, ,0,0,0, ,0,0,0,0, 
11855,DOM,14,Rivera Brens Prisilla ,OH,16,1,1,6.90,18,16,7,15,38,23.68,1,3,3,7,-28.57,1,4,8,13,-23.08,0,3,15,18,-16.67,5,3,9,22.22,0,0,0,0, 
11855,DOM,16,PeÃ±a Isabel Yonkaira Paola ,OH,0,0,0,0.00,0,0,0,2,2,0.00,0,0,0,0, ,0,0,0,0, ,1,1,5,7,0.00,1,1,2,0.00,0,0,0,0, 
11855,DOM,17,Mambru Casilla Gina Altagracia ,O,0,0,0, ,0,0,0,0,0, ,0,0,0,0, ,0,0,0,0, ,0,0,0,0, ,0,0,0, ,0,0,0,0, 
11855,DOM,18,De La Cruz De PeÃ±a Bethania ,OH,16,0,1,14.06,17,16,3,23,42,30.95,0,3,3,6,-50.00,1,2,13,16,-6.25,5,1,20,26,15.38,9,4,15,33.33,0,0,0,0, 
11855,DOM,20,Martinez Brayelin Elizabeth ,OH,3,0,0,20.00,3,3,1,5,9,22.22,0,0,0,0, ,0,0,1,1,0.00,0,0,3,3,0.00,2,0,2,100.00,0,0,0,0, 
11855,DOM,21,Martinez Jineiry ,MB,11,4,0,5.00,15,11,3,8,22,36.36,4,6,11,21,-9.52,0,3,14,17,-17.65,0,0,1,1,0.00,5,0,6,83.33,0,0,0,0, 
11855,DOM,23,Gonzalez Lopez Gaila Ceneida ,O,25,2,1,22.08,28,25,3,20,48,45.83,2,4,1,7,-28.57,1,4,17,22,-13.64,0,0,0,0, ,14,4,18,55.56,0,0,0,0, 
11855,DOM,25,Martinez Caro Larysmer ,OH,0,0,0, ,0,0,0,0,0, ,0,0,0,0, ,0,0,0,0, ,0,0,0,0, ,0,0,0, ,0,0,0,0, 
11856,CHN,3,Diao Linyu ,S,0,1,1,20.00,2,0,0,0,0, ,1,0,0,1,100.00,1,1,2,4,0.00,0,0,0,0, ,0,0,0, ,6,0,0,6,100.00
11856,CHN,4,Yang Hanyu ,MB,10,4,0,6.67,14,10,2,5,17,47.06,4,7,1,12,-25.00,0,2,14,16,-12.50,1,0,1,2,50.00,1,1,2,0.00,0,0,0,0, 
11856,CHN,5,Gao Yi ,MB,5,1,0,15.00,6,5,0,2,7,71.43,1,3,2,6,-33.33,0,0,7,7,0.00,0,0,0,0, ,3,1,4,50.00,0,0,0,0, 
11856,CHN,7,Wang Yuanyuan ,MB,2,0,0,0.00,2,2,0,2,4,50.00,0,1,0,1,-100.00,0,1,6,7,-14.29,0,0,0,0, ,0,2,2,-100.00,0,0,0,0, 
11856,CHN,8,Li Yao ,OH,9,2,0,6.12,11,9,4,20,33,15.15,2,1,0,3,33.33,0,3,10,13,-23.08,1,0,0,1,100.00,3,2,5,20.00,0,0,0,0, 
11856,CHN,9,Zhang Changning ,OH,16,5,2,16.00,23,16,8,22,46,17.39,5,2,3,10,30.00,2,1,16,19,5.26,6,1,17,24,20.83,11,4,16,43.75,0,0,0,0, 
11856,CHN,10,Liu Xiaotong ,OH,9,0,0,1.79,9,9,2,24,35,20.00,0,4,0,4,-100.00,0,2,15,17,-11.76,12,2,17,31,32.26,4,3,7,14.29,0,0,0,0, 
11856,CHN,11,Yao Di ,S,0,2,1,-4.76,3,0,1,2,3,-33.33,2,2,0,4,0.00,1,1,12,14,0.00,0,0,0,0, ,2,2,4,0.00,13,1,1,15,80.00
11856,CHN,14,Zheng Yixin ,MB,0,0,0, ,0,0,0,0,0, ,0,0,0,0, ,0,0,0,0, ,0,0,0,0, ,0,0,0, ,0,0,0,0, 
11856,CHN,15,Lin Li ,L,0,0,0, ,0,0,0,0,0, ,0,0,0,0, ,0,0,0,0, ,9,1,8,18,44.44,9,4,13,38.46,1,0,1,2,50.00
11856,CHN,18,Wang Mengjie ,L,0,0,0, ,0,0,0,0,0, ,0,0,0,0, ,0,0,0,0, ,5,2,7,14,21.43,6,5,11,9.09,1,0,0,1,100.00
11856,CHN,19,Liu Yanhan ,OH,5,0,0,8.70,5,5,1,7,13,30.77,0,2,0,2,-100.00,0,0,8,8,0.00,1,1,0,2,0.00,0,1,1,-100.00,0,0,0,0, 
11856,CHN,22,Duan Fang ,OH,0,0,0, ,0,0,0,0,0, ,0,0,0,0, ,0,0,0,0, ,0,0,0,0, ,0,0,0, ,0,0,0,0, 
11856,GER,1,Bock Linda ,L,0,0,0, ,0,0,0,0,0, ,0,0,0,0, ,0,0,0,0, ,0,0,0,0, ,0,0,0, ,0,0,0,0, 
11856,GER,2,KÃ¤stner Pia ,S,0,0,0,0.00,0,0,0,0,0, ,0,0,0,0, ,0,0,4,4,0.00,0,0,0,0, ,0,2,2,-100.00,4,0,0,4,100.00
11856,GER,4,Imoudu Denise ,S,3,0,0,-4.00,3,3,0,3,6,50.00,0,2,2,4,-50.00,0,2,13,15,-13.33,0,0,0,0, ,8,2,10,60.00,10,1,0,11,81.82
11856,GER,6,Janiska Jennifer ,OH,2,1,0,11.11,3,2,0,2,4,50.00,1,1,0,2,0.00,0,1,2,3,-33.33,3,0,0,3,100.00,0,1,1,-100.00,0,0,0,0, 
11856,GER,7,Vanjak Ivana ,OH,1,0,0,-60.00,1,1,3,0,4,-50.00,0,1,0,1,-100.00,0,0,0,0, ,0,0,0,0, ,0,0,0, ,0,0,0,0, 
11856,GER,8,Drewniok Kimberly ,O,10,0,0,-4.76,10,10,7,11,28,10.71,0,2,2,4,-50.00,0,3,7,10,-30.00,0,0,0,0, ,6,2,8,50.00,1,0,0,1,100.00
11856,GER,9,Alsmeier Lina ,OH,13,2,1,8.33,16,13,7,14,34,17.65,2,3,0,5,-20.00,1,1,19,21,0.00,21,1,13,35,57.14,7,3,10,40.00,1,0,0,1,100.00
11856,GER,10,Stigrot Lena ,OH,9,1,0,24.14,10,9,3,9,21,28.57,1,0,1,2,50.00,0,0,6,6,0.00,6,1,6,13,38.46,2,1,3,33.33,0,0,0,0, 
11856,GER,12,Orthmann Hanna ,OH,18,2,3,25.93,23,18,5,12,35,37.14,2,1,3,6,16.67,3,3,7,13,0.00,6,1,14,21,23.81,4,5,9,-11.11,0,0,0,0, 
11856,GER,14,SchÃ¶lzel Marie ,MB,5,3,1,14.71,9,5,3,7,15,13.33,3,0,4,7,42.86,1,1,10,12,0.00,3,1,0,4,50.00,2,0,3,66.67,0,0,0,0, 
11856,GER,17,Pogany Anna ,L,0,0,0, ,0,0,0,0,0, ,0,0,0,0, ,0,0,0,0, ,9,0,9,18,50.00,20,9,30,36.67,0,1,3,4,-25.00
11856,GER,20,Bock Josepha ,MB,0,0,0, ,0,0,0,0,0, ,0,0,0,0, ,0,0,0,0, ,0,0,0,0, ,0,0,0, ,0,0,0,0, 
11856,GER,21,Weitzel Camilla ,MB,7,4,2,8.89,13,7,2,2,11,45.45,4,4,4,12,0.00,2,3,17,22,-4.55,0,0,0,0, ,0,2,2,-100.00,0,0,0,0, 
11856,GER,24,Cekulaev Anastasia ,MB,0,0,0, ,0,0,0,0,0, ,0,0,0,0, ,0,0,0,0, ,0,0,0,0, ,0,0,0, ,0,0,0,0, 
11857,BRA,2,De Oliveira Saad Gattaz Caroline ,MB,2,1,1,0.00,4,2,0,2,4,50.00,1,4,0,5,-60.00,1,0,7,8,12.50,0,0,0,0, ,3,0,3,100.00,0,0,1,1,0.00
11857,BRA,5,Da Silva Adenizia ,MB,0,0,0, ,0,0,0,0,0, ,0,0,0,0, ,0,0,0,0, ,0,0,0,0, ,0,0,0, ,0,0,0,0, 
11857,BRA,6,Alexandre Costa Nunes Nyeme Victoria ,L,0,0,0, ,0,0,0,0,0, ,0,0,0,0, ,0,0,0,0, ,0,0,0,0, ,0,0,0, ,0,0,0,0, 
11857,BRA,7,Montibeller Rosamaria ,OH,3,0,0,28.57,3,3,1,2,6,33.33,0,0,1,1,0.00,0,0,0,0, ,0,0,0,0, ,0,0,0, ,0,0,0,0, 
11857,BRA,8,Silva Carneiro Macris Fernanda ,S,1,2,0,0.00,3,1,0,0,1,100.00,2,3,1,6,-16.67,0,0,14,14,0.00,0,0,0,0, ,6,2,8,50.00,27,0,55,82,32.93
11857,BRA,9,Ratzke Roberta Silva ,S,0,0,0,0.00,0,0,0,0,0, ,0,0,0,0, ,0,0,1,1,0.00,0,0,0,0, ,3,0,3,100.00,1,0,8,9,11.11
11857,BRA,10,Braga Guimaraes Gabriela ,OH,8,1,1,4.65,10,8,5,6,19,15.79,1,2,4,7,-14.29,1,1,15,17,0.00,1,0,5,6,16.67,14,1,15,86.67,0,0,3,3,0.00
11857,BRA,11,Caixeta Tandara ,OH,11,3,0,18.00,14,11,3,13,27,29.63,3,2,5,10,10.00,0,0,13,13,0.00,0,0,0,0, ,3,1,4,50.00,0,0,1,1,0.00
11857,BRA,13,Castro De Paula Blassioli Sheilla ,O,0,0,0, ,0,0,0,0,0, ,0,0,0,0, ,0,0,0,0, ,0,0,0,0, ,0,0,0, ,0,0,0,0, 
11857,BRA,15,Da Silva Ana Carolina ,MB,4,4,1,9.09,9,4,2,5,11,18.18,4,3,4,11,9.09,1,1,9,11,0.00,0,0,0,0, ,1,1,2,0.00,0,0,2,2,0.00
11857,BRA,16,Rodrigues Fernanda ,OH,21,0,0,21.05,21,21,4,13,38,44.74,0,4,6,10,-40.00,0,1,8,9,-11.11,12,1,11,24,45.83,7,4,12,25.00,0,0,0,0, 
11857,BRA,18,Brait Camila ,L,0,0,0, ,0,0,0,0,0, ,0,0,0,0, ,0,0,0,0, ,13,1,8,22,54.55,16,1,19,78.95,0,0,5,5,0.00
11857,BRA,20,Correa Ana Beatriz ,MB,0,0,0, ,0,0,0,0,0, ,0,0,0,0, ,0,0,0,0, ,0,0,0,0, ,0,0,0, ,0,0,0,0, 
11857,BRA,24,Geraldo Teixeira Lorenne ,O,0,0,0, ,0,0,0,0,0, ,0,0,0,0, ,0,0,0,0, ,0,0,0,0, ,0,0,0, ,0,0,0,0, 
11857,JPN,1,Kurogo Ai ,OH,8,0,0,2.33,8,8,4,20,32,12.50,0,2,1,3,-66.67,0,1,7,8,-12.50,4,1,7,12,25.00,6,3,11,27.27,0,0,0,0, 
11857,JPN,2,Koga Sarina ,OH,12,1,0,6.12,13,12,3,18,33,27.27,1,5,2,8,-50.00,0,2,6,8,-25.00,5,0,9,14,35.71,6,0,6,100.00,0,0,4,4,0.00
11857,JPN,3,Shimamura Haruyo ,MB,1,2,1,0.00,4,1,1,6,8,0.00,2,3,1,6,-16.67,1,0,6,7,14.29,1,0,0,1,100.00,2,0,3,66.67,1,0,3,4,25.00
11857,JPN,5,Araki Erika ,MB,0,0,0, ,0,0,0,0,0, ,0,0,0,0, ,0,0,0,0, ,0,0,0,0, ,0,0,0, ,0,0,0,0, 
11857,JPN,7,Ishii Yuki ,OH,0,0,0,0.00,0,0,0,0,0, ,0,0,0,0, ,0,0,1,1,0.00,1,0,1,2,50.00,0,0,0, ,0,0,0,0, 
11857,JPN,8,Ishikawa Mayu ,OH,10,0,1,5.56,11,10,7,6,23,13.04,0,1,1,2,-50.00,1,1,9,11,0.00,17,2,11,30,50.00,8,1,9,77.78,0,0,1,1,0.00
11857,JPN,9,Tashiro Kanami ,S,0,0,0, ,0,0,0,0,0, ,0,0,0,0, ,0,0,0,0, ,0,0,0,0, ,3,0,3,100.00,1,0,4,5,20.00
11857,JPN,10,Akutagawa Aika ,MB,0,0,0, ,0,0,0,0,0, ,0,0,0,0, ,0,0,0,0, ,0,0,0,0, ,0,0,0, ,0,0,0,0, 
11857,JPN,13,Okumura Mai ,MB,2,2,0,-3.33,4,2,1,9,12,8.33,2,4,0,6,-33.33,0,0,12,12,0.00,0,0,1,1,0.00,1,0,3,33.33,0,0,2,2,0.00
11857,JPN,14,Kobata Mako ,L,0,0,0, ,0,0,0,0,0, ,0,0,0,0, ,0,0,0,0, ,1,0,3,4,25.00,8,1,10,70.00,0,0,7,7,0.00
11857,JPN,15,Inoue Kotoe ,L,0,0,0, ,0,0,0,0,0, ,0,0,0,0, ,0,0,0,0, ,0,0,1,1,0.00,1,3,4,-50.00,0,0,5,5,0.00
11857,JPN,20,Seki Nanami ,S,0,0,0,-25.00,0,0,0,2,2,0.00,0,1,0,1,-100.00,0,0,1,1,0.00,1,0,0,1,100.00,2,0,2,100.00,1,0,1,2,50.00
11857,JPN,21,Hayashi Kotona ,OH,1,0,0,50.00,1,1,0,0,1,100.00,0,0,1,1,0.00,0,0,0,0, ,3,0,1,4,75.00,0,0,0, ,0,0,0,0, 
11857,JPN,24,Momii Aki ,S,0,0,0,-30.77,0,0,1,1,2,-50.00,0,2,0,2,-100.00,0,1,8,9,-11.11,0,0,0,0, ,9,1,11,72.73,18,0,67,85,21.18
11858,CAN,1,Bujan Cassandra ,L,0,0,0, ,0,0,0,0,0, ,0,0,0,0, ,0,0,0,0, ,5,0,12,17,29.41,21,4,30,56.67,0,0,12,12,0.00
11858,CAN,3,Van Ryk Kiera ,OH,24,1,2,11.76,27,24,12,24,60,20.00,1,2,6,9,-11.11,2,3,11,16,-6.25,4,0,12,16,25.00,13,3,19,52.63,0,0,4,4,0.00
11858,CAN,6,White Jazmine  Ruth ,MB,0,0,0, ,0,0,0,0,0, ,0,0,0,0, ,0,0,0,0, ,0,0,0,0, ,0,0,0, ,0,0,0,0, 
11858,CAN,8,Ogoms Alicia ,MB,0,0,0, ,0,0,0,0,0, ,0,0,0,0, ,0,0,0,0, ,0,0,0,0, ,0,0,0, ,0,0,0,0, 
11858,CAN,9,Gray Alexa ,OH,0,0,0, ,0,0,0,0,0, ,0,0,0,0, ,0,0,0,0, ,1,0,5,6,16.67,2,0,3,66.67,0,0,1,1,0.00
11858,CAN,11,Mitrovic Andrea ,OH,12,2,1,15.69,15,12,1,13,26,42.31,2,4,5,11,-18.18,1,2,11,14,-7.14,4,0,20,24,16.67,3,1,4,50.00,0,0,2,2,0.00
11858,CAN,12,Cross Jennifer ,MB,4,2,1,-7.55,7,4,3,6,13,7.69,2,7,9,18,-27.78,1,1,20,22,0.00,0,2,2,4,-50.00,3,0,5,60.00,0,0,1,1,0.00
11858,CAN,13,King Brie ,S,3,1,0,0.00,4,3,0,1,4,75.00,1,3,3,7,-28.57,0,1,20,21,-4.76,0,0,0,0, ,15,6,23,39.13,28,0,101,129,21.71
11858,CAN,14,Howe Hilary ,OH,11,2,2,21.15,15,11,3,16,30,26.67,2,0,4,6,33.33,2,1,13,16,6.25,1,1,28,30,0.00,10,4,19,31.58,0,0,5,5,0.00
11858,CAN,15,Joseph Shainah ,O,2,0,0,-25.00,2,2,1,3,6,16.67,0,2,0,2,-100.00,0,2,2,4,-50.00,0,0,0,0, ,1,1,2,0.00,0,0,0,0, 
11858,CAN,16,Livingston Caroline ,OH,0,0,0, ,0,0,0,0,0, ,0,0,0,0, ,0,0,0,0, ,0,0,0,0, ,0,0,0, ,0,0,0,0, 
11858,CAN,18,Robitaille Kim ,S,0,0,0, ,0,0,0,0,0, ,0,0,0,0, ,0,0,0,0, ,0,0,0,0, ,0,0,0, ,0,0,0,0, 
11858,CAN,19,Maglio Emily ,MB,8,5,0,5.36,13,8,2,10,20,30.00,5,6,10,21,-4.76,0,2,13,15,-13.33,1,0,1,2,50.00,3,2,6,16.67,0,0,4,4,0.00
11858,CAN,22,Snape Kennedy Brooklyn ,L,0,0,0, ,0,0,0,0,0, ,0,0,0,0, ,0,0,0,0, ,0,0,0,0, ,0,0,0, ,0,0,0,0, 
11858,TUR,2,Akoz Simge Sebnem ,L,0,0,0, ,0,0,0,0,0, ,0,0,0,0, ,0,0,0,0, ,6,1,7,14,35.71,24,7,35,48.57,0,0,15,15,0.00
11858,TUR,3,Ãzbay Cansu ,S,1,0,2,0.00,3,1,0,1,2,50.00,0,2,1,3,-66.67,2,1,13,16,6.25,0,0,0,0, ,14,1,16,81.25,20,2,65,87,20.69
11858,TUR,4,Senoglu Tugba ,OH,10,2,0,9.26,12,10,3,17,30,23.33,2,4,5,11,-18.18,0,0,13,13,0.00,6,0,28,34,17.65,12,4,16,50.00,0,0,0,0, 
11858,TUR,5,Ercan Seyma ,OH,0,0,0,-13.33,0,0,1,1,2,-50.00,0,1,0,1,-100.00,0,0,12,12,0.00,2,0,3,5,40.00,1,0,1,100.00,0,0,0,0, 
11858,TUR,6,Caliskan Kubra ,MB,6,2,0,-3.23,8,6,4,3,13,15.38,2,4,4,10,-20.00,0,1,7,8,-12.50,0,0,0,0, ,0,0,0, ,0,0,4,4,0.00
11858,TUR,7,Baladin Hande ,OH,14,2,0,15.09,16,14,5,12,31,29.03,2,2,3,7,0.00,0,1,14,15,-6.67,3,3,18,24,0.00,6,0,7,85.71,0,0,1,1,0.00
11858,TUR,8,Guveli Yasemin ,MB,1,0,0,-14.29,1,1,0,0,1,100.00,0,2,2,4,-50.00,0,0,2,2,0.00,0,0,0,0, ,0,0,0, ,0,0,1,1,0.00
11858,TUR,9,Ismailoglu Meliha ,OH,1,1,1,-12.50,3,1,3,3,7,-28.57,1,2,0,3,-33.33,1,0,5,6,16.67,2,2,11,15,0.00,5,0,7,71.43,0,0,1,1,0.00
11858,TUR,10,Aykac Ayca ,L,0,0,0, ,0,0,0,0,0, ,0,0,0,0, ,0,0,0,0, ,0,0,0,0, ,0,0,0, ,0,0,0,0, 
11858,TUR,11,Aydemir Akyol Naz ,S,2,1,0,11.11,3,2,0,1,3,66.67,1,1,2,4,0.00,0,1,1,2,-50.00,0,0,1,1,0.00,5,2,8,37.50,13,0,50,63,20.63
11858,TUR,13,Boz Meryem ,O,9,2,0,6.98,11,9,5,17,31,12.90,2,2,1,5,0.00,0,1,6,7,-14.29,0,0,1,1,0.00,5,0,5,100.00,0,0,0,0, 
11858,TUR,14,Erdem DÃ¼ndar Eda ,MB,2,2,0,-16.67,4,2,3,6,11,-9.09,2,7,8,17,-29.41,0,0,8,8,0.00,1,0,1,2,50.00,4,0,4,100.00,0,1,0,1,-100.00
11858,TUR,19,Kalac Asli ,MB,1,2,0,-5.26,3,1,0,1,2,50.00,2,3,3,8,-12.50,0,1,8,9,-11.11,0,0,0,0, ,3,1,4,50.00,0,0,0,0, 
11858,TUR,99,Karakurt Ebrar ,OH,19,2,0,27.78,21,19,4,18,41,36.59,2,1,2,5,20.00,0,1,7,8,-12.50,0,0,0,0, ,8,0,8,100.00,0,0,0,0, 
11859,KOR,1,Lee Soyoung ,OH,3,0,1,-10.00,4,3,4,4,11,-9.09,0,2,0,2,-100.00,1,0,6,7,14.29,4,0,10,14,28.57,3,0,4,75.00,0,0,0,0, 
11859,KOR,2,Lee Dahyeon ,MB,5,2,0,10.00,7,5,1,1,7,57.14,2,3,2,7,-14.29,0,1,5,6,-16.67,0,0,0,0, ,0,1,2,-50.00,0,0,1,1,0.00
11859,KOR,3,Yeum Hye Seon ,S,0,0,0,-25.00,0,0,0,0,0, ,0,1,1,2,-50.00,0,2,8,10,-20.00,0,0,0,0, ,8,2,10,60.00,14,0,63,77,18.18
11859,KOR,5,Han Dahye ,L,0,0,0, ,0,0,0,0,0, ,0,0,0,0, ,0,0,0,0, ,3,0,11,14,21.43,12,2,15,66.67,0,0,2,2,0.00
11859,KOR,6,Kim Dain ,S,0,0,0,0.00,0,0,0,0,0, ,0,0,0,0, ,0,0,3,3,0.00,0,0,0,0, ,2,1,4,25.00,5,0,9,14,35.71
11859,KOR,8,Park Eunjin ,MB,3,1,0,20.00,4,3,1,0,4,50.00,1,0,1,2,50.00,0,1,3,4,-25.00,0,1,0,1,-100.00,0,1,2,-50.00,0,0,0,0, 
11859,KOR,9,Oh Jiyoung ,L,0,0,0, ,0,0,0,0,0, ,0,0,0,0, ,0,0,0,0, ,0,0,0,0, ,0,0,0, ,0,0,0,0, 
11859,KOR,10,Kim Yeon Koung ,OH,0,0,0, ,0,0,0,0,0, ,0,0,0,0, ,0,0,0,0, ,0,0,0,0, ,0,0,0, ,0,0,0,0, 
11859,KOR,12,Han Songyi ,MB,1,0,0,-33.33,1,1,0,2,3,33.33,0,5,0,5,-100.00,0,0,4,4,0.00,1,0,0,1,100.00,2,0,2,100.00,0,0,1,1,0.00
11859,KOR,13,Park Jeongah ,OH,7,1,0,8.33,8,7,3,18,28,14.29,1,0,0,1,100.00,0,2,5,7,-28.57,2,2,5,9,0.00,4,3,7,14.29,0,0,0,0, 
11859,KOR,14,Yang Hyo Jin ,MB,0,0,0, ,0,0,0,0,0, ,0,0,0,0, ,0,0,0,0, ,0,0,0,0, ,0,0,0, ,0,0,0,0, 
11859,KOR,15,Yuk Seoyoung ,OH,1,0,0,0.00,1,1,1,4,6,0.00,0,0,1,1,0.00,0,0,1,1,0.00,0,0,0,0, ,0,0,0, ,0,0,0,0, 
11859,KOR,16,Jeong Jiyun ,O,5,1,0,9.09,6,5,4,10,19,5.26,1,0,0,1,100.00,0,0,2,2,0.00,0,0,0,0, ,3,2,5,20.00,0,0,0,0, 
11859,KOR,19,Pyo Seungju ,OH,7,0,2,7.89,9,7,4,10,21,14.29,0,2,0,2,-100.00,2,0,13,15,13.33,9,3,17,29,20.69,4,2,8,25.00,0,0,0,0, 
11859,POL,1,Nowicka Julia ,S,1,0,3,10.71,4,1,0,2,3,33.33,0,0,0,0, ,3,1,21,25,8.00,0,0,1,1,0.00,7,1,8,75.00,20,1,47,68,27.94
11859,POL,3,Alagierska Klaudia ,MB,4,2,0,12.00,6,4,0,3,7,57.14,2,3,4,9,-11.11,0,0,9,9,0.00,0,0,0,0, ,2,0,2,100.00,0,0,2,2,0.00
11859,POL,5,Kakolewska Agnieszka ,MB,0,0,0, ,0,0,0,0,0, ,0,0,0,0, ,0,0,0,0, ,0,0,0,0, ,0,0,0, ,0,0,0,0, 
11859,POL,8,Stenzel Maria ,L,0,0,0, ,0,0,0,0,0, ,0,0,0,0, ,0,0,0,0, ,6,0,11,17,35.29,4,2,7,28.57,0,0,2,2,0.00
11859,POL,9,Stysiak Magdalena ,O,16,1,0,29.73,17,16,3,6,25,52.00,1,1,0,2,0.00,0,2,8,10,-20.00,4,0,7,11,36.36,3,2,5,20.00,0,0,0,0, 
11859,POL,10,Efimienko-Mlotkowska Zuzanna ,MB,3,1,0,0.00,4,3,0,3,6,50.00,1,4,4,9,-33.33,0,0,8,8,0.00,0,0,0,0, ,2,2,5,0.00,0,0,0,0, 
11859,POL,11,Lukasik Martyna ,O,6,0,2,12.90,8,6,3,9,18,16.67,0,1,1,2,-50.00,2,0,9,11,18.18,4,2,10,16,12.50,10,3,13,53.85,0,0,3,3,0.00
11859,POL,13,Jagla Monika ,L,0,0,0, ,0,0,0,0,0, ,0,0,0,0, ,0,0,0,0, ,0,0,0,0, ,8,4,13,30.77,0,0,2,2,0.00
11859,POL,17,Smarzek Malwina ,O,11,6,1,20.00,18,11,6,9,26,19.23,6,1,5,12,41.67,1,2,4,7,-14.29,2,1,3,6,16.67,6,0,7,85.71,0,0,3,3,0.00
11859,POL,19,Fedusio Monika ,OH,0,0,0,-33.33,0,0,1,2,3,-33.33,0,0,0,0, ,0,0,0,0, ,1,0,1,2,50.00,1,0,1,100.00,0,0,1,1,0.00
11859,POL,27,Åazowska Martyna ,S,0,0,0,0.00,0,0,0,0,0, ,0,0,0,0, ,0,0,2,2,0.00,0,0,0,0, ,0,0,0, ,2,1,7,10,10.00
11859,POL,30,Rozanski Olivia ,OH,4,0,0,33.33,4,4,0,0,4,100.00,0,2,0,2,-100.00,0,0,0,0, ,0,0,0,0, ,0,0,0, ,0,0,0,0, 
11859,POL,78,Gryka Aleksandra ,MB,0,0,0,0.00,0,0,0,0,0, ,0,0,0,0, ,0,0,1,1,0.00,0,0,0,0, ,0,0,0, ,0,0,0,0, 
11859,POL,88,Gorecka Zuzanna ,OH,0,0,0, ,0,0,0,0,0, ,0,0,0,0, ,0,0,0,0, ,0,0,0,0, ,0,0,0, ,0,0,0,0, 
11860,SRB,2,Lazovic Katarina ,OH,8,2,2,14.29,12,8,3,10,21,23.81,2,2,4,8,0.00,2,2,2,6,0.00,6,1,16,23,21.74,5,2,8,37.50,0,0,0,0, 
11860,SRB,6,Uzelac Aleksandra ,OH,8,0,0,0.00,8,8,7,8,23,4.35,0,1,0,1,-100.00,0,0,11,11,0.00,3,3,8,14,0.00,4,2,9,22.22,0,1,3,4,-25.00
11860,SRB,7,Jaksic Ana ,S,0,0,0,-20.00,0,0,1,0,1,-100.00,0,1,3,4,-25.00,0,0,5,5,0.00,0,1,0,1,-100.00,7,3,12,33.33,5,0,66,71,7.04
11860,SRB,21,Kocic Jovana ,MB,0,0,0, ,0,0,0,0,0, ,0,0,0,0, ,0,0,0,0, ,0,0,0,0, ,0,0,0, ,0,0,0,0, 
11860,SRB,22,Lozo Sara ,O,0,0,0,0.00,0,0,0,1,1,0.00,0,0,0,0, ,0,0,0,0, ,0,0,0,0, ,0,0,0, ,0,0,0,0, 
11860,SRB,23,Djordjevic Mila ,S,0,0,0, ,0,0,0,0,0, ,0,0,0,0, ,0,0,0,0, ,0,0,0,0, ,2,2,6,0.00,0,1,15,16,-6.25
11860,SRB,24,Medic Sofija ,MB,2,2,1,9.52,5,2,1,4,7,14.29,2,2,5,9,0.00,1,0,4,5,20.00,0,0,0,0, ,3,0,3,100.00,0,0,2,2,0.00
11860,SRB,26,Savic Vanja ,O,1,0,0,-24.24,1,1,5,16,22,-18.18,0,3,3,6,-50.00,0,1,4,5,-20.00,0,0,0,0, ,3,0,5,60.00,0,0,0,0, 
11860,SRB,27,Bukilic Vanja ,O,1,0,0,-22.22,1,1,3,8,12,-16.67,0,2,1,3,-66.67,0,0,3,3,0.00,0,0,0,0, ,2,0,4,50.00,0,0,0,0, 
11860,SRB,28,Delic Jelena ,MB,0,1,0,-11.76,1,0,0,4,4,0.00,1,3,2,6,-33.33,0,0,7,7,0.00,0,0,0,0, ,1,1,2,0.00,0,0,1,1,0.00
11860,SRB,31,Djurdjevic Sanja ,L,0,0,0, ,0,0,0,0,0, ,0,0,0,0, ,0,0,0,0, ,0,0,0,0, ,0,0,0, ,0,0,0,0, 
11860,SRB,32,Gocanin Bojana ,L,0,0,0, ,0,0,0,0,0, ,0,0,0,0, ,0,0,0,0, ,4,0,6,10,40.00,13,3,20,50.00,0,0,6,6,0.00
11860,SRB,33,Cvetkovic Jovana ,OH,0,0,0,0.00,0,0,0,0,0, ,0,0,0,0, ,0,0,2,2,0.00,0,0,0,0, ,0,0,0, ,0,0,0,0, 
11860,SRB,34,Mirosavljevic Jovana ,OH,3,0,0,11.11,3,3,0,6,9,33.33,0,1,2,3,-33.33,0,0,6,6,0.00,3,0,9,12,25.00,4,1,5,60.00,0,0,1,1,0.00
11860,USA,1,Hancock Micha ,S,0,0,0, ,0,0,0,0,0, ,0,0,0,0, ,0,0,0,0, ,0,0,0,0, ,0,0,0, ,0,0,0,0, 
11860,USA,2,Poulter Jordyn ,S,2,1,0,9.52,3,2,0,1,3,66.67,1,1,5,7,0.00,0,0,11,11,0.00,0,0,0,0, ,6,0,7,85.71,29,1,52,82,34.15
11860,USA,4,Wong-Orantes Justine ,L,0,0,0, ,0,0,0,0,0, ,0,0,0,0, ,0,0,0,0, ,0,0,0,0, ,0,0,0, ,0,0,0,0, 
11860,USA,6,Dixon Tetori ,MB,0,0,0, ,0,0,0,0,0, ,0,0,0,0, ,0,0,0,0, ,0,0,0,0, ,0,0,0, ,0,0,0,0, 
11860,USA,10,Larson Jordan ,OH,0,0,0, ,0,0,0,0,0, ,0,0,0,0, ,0,0,0,0, ,0,0,0,0, ,0,0,0, ,0,0,0,0, 
11860,USA,11,Drews Andrea ,O,0,0,0, ,0,0,0,0,0, ,0,0,0,0, ,0,0,0,0, ,0,0,0,0, ,0,0,0, ,0,0,0,0, 
11860,USA,12,Thompson Jordan ,O,15,0,2,27.66,17,15,1,12,28,50.00,0,2,3,5,-40.00,2,1,11,14,7.14,0,0,0,0, ,9,3,14,42.86,0,0,5,5,0.00
11860,USA,14,Bartsch-Hackley Michelle ,OH,9,1,1,13.89,11,9,4,9,22,22.73,1,0,1,2,50.00,1,2,9,12,-8.33,5,2,15,22,13.64,3,0,4,75.00,0,0,2,2,0.00
11860,USA,15,Hill Kimberly ,OH,5,0,0,0.00,5,5,2,16,23,13.04,0,2,1,3,-66.67,0,1,12,13,-7.69,2,0,4,6,33.33,11,0,12,91.67,0,0,1,1,0.00
11860,USA,16,Akinradewo Foluke ,MB,0,0,0, ,0,0,0,0,0, ,0,0,0,0, ,0,0,0,0, ,0,0,0,0, ,0,0,0, ,0,0,0,0, 
11860,USA,17,Courtney Megan ,OH,0,0,0, ,0,0,0,0,0, ,0,0,0,0, ,0,0,0,0, ,5,1,13,19,21.05,22,0,23,95.65,0,0,4,4,0.00
11860,USA,22,Washington Haleigh ,MB,6,4,1,7.69,11,6,1,5,12,41.67,4,4,5,13,0.00,1,3,10,14,-14.29,0,0,0,0, ,4,1,5,60.00,0,0,0,0, 
11860,USA,23,Robinson Kelsey ,OH,0,0,0, ,0,0,0,0,0, ,0,0,0,0, ,0,0,0,0, ,0,0,0,0, ,0,0,0, ,0,0,0,0, 
11860,USA,24,Ogbogu Chiaka ,MB,6,2,1,-8.11,9,6,0,8,14,42.86,2,7,6,15,-33.33,1,5,2,8,-50.00,0,0,0,0, ,2,1,3,33.33,0,0,0,0, 
11861,RUS,2,Malygina Daria ,O,0,0,0, ,0,0,0,0,0, ,0,0,0,0, ,0,0,0,0, ,0,0,0,0, ,0,0,0, ,0,0,0,0, 
11861,RUS,4,Pilipenko Daria ,L,0,0,0, ,0,0,0,0,0, ,0,0,0,0, ,0,0,0,0, ,3,1,10,14,14.29,12,5,17,41.18,0,0,5,5,0.00
11861,RUS,5,Fedorovtseva Arina ,OH,13,2,3,36.84,18,13,2,9,24,45.83,2,2,0,4,0.00,3,0,7,10,30.00,3,0,5,8,37.50,3,1,4,50.00,0,0,0,0, 
11861,RUS,6,Koroleva Irina ,MB,4,2,0,4.17,6,4,0,3,7,57.14,2,4,2,8,-25.00,0,1,8,9,-11.11,0,0,0,0, ,2,0,2,100.00,0,0,0,0, 
11861,RUS,8,Goncharova Nataliya ,O,7,3,0,20.59,10,7,3,11,21,19.05,3,0,5,8,37.50,0,0,5,5,0.00,0,0,0,0, ,1,1,2,0.00,0,0,1,1,0.00
11861,RUS,11,Brovkina Yulia ,MB,0,0,0, ,0,0,0,0,0, ,0,0,0,0, ,0,0,0,0, ,0,0,0,0, ,0,0,0, ,0,0,0,0, 
11861,RUS,13,Startseva Evgeniya ,S,1,0,0,-20.83,1,1,0,1,2,50.00,0,2,3,5,-40.00,0,4,13,17,-23.53,0,0,0,0, ,6,5,12,8.33,9,1,68,78,10.26
11861,RUS,14,Fetisova Irina ,MB,3,1,1,3.33,5,3,0,1,4,75.00,1,3,4,8,-25.00,1,1,16,18,0.00,0,0,0,0, ,3,2,5,20.00,0,1,1,2,-50.00
11861,RUS,15,Kosheleva Tatyana ,OH,10,1,0,25.93,11,10,1,5,16,56.25,1,2,0,3,-33.33,0,1,7,8,-12.50,7,2,26,35,14.29,4,3,8,12.50,0,0,0,0, 
11861,RUS,16,Voronkova Irina ,OH,3,0,0,-12.50,3,3,4,6,13,-7.69,0,0,0,0, ,0,1,2,3,-33.33,0,1,2,3,-33.33,4,1,5,60.00,0,0,0,0, 
11861,RUS,20,Lazareva Ekaterina ,S,0,0,0, ,0,0,0,0,0, ,0,0,0,0, ,0,0,0,0, ,0,0,0,0, ,0,0,0, ,0,0,0,0, 
11861,RUS,22,Zaytseva Tamara ,L,0,0,0, ,0,0,0,0,0, ,0,0,0,0, ,0,0,0,0, ,0,1,2,3,-33.33,0,1,1,-100.00,0,0,0,0, 
11861,RUS,23,Kapustina Irina ,OH,0,0,0,-50.00,0,0,0,0,0, ,0,0,0,0, ,0,1,1,2,-50.00,0,0,0,0, ,0,0,0, ,0,0,0,0, 
11861,RUS,25,Smirnova Kseniia ,OH,0,0,0,-20.00,0,0,0,0,0, ,0,0,0,0, ,0,1,4,5,-20.00,0,0,0,0, ,1,0,1,100.00,0,0,0,0, 
11861,ITA,2,Bosio Francesca ,S,0,0,1,-25.00,1,0,0,1,1,0.00,0,5,1,6,-83.33,1,0,8,9,11.11,0,0,0,0, ,3,2,5,20.00,23,1,62,86,25.58
11861,ITA,4,Bonifacio Sara ,MB,5,1,1,20.00,7,5,0,1,6,83.33,1,2,2,5,-20.00,1,1,7,9,0.00,0,0,0,0, ,2,0,2,100.00,0,0,1,1,0.00
11861,ITA,12,Guerra Anastasia ,OH,9,0,0,6.45,9,9,6,6,21,14.29,0,0,1,1,0.00,0,1,8,9,-11.11,11,1,25,37,27.03,11,3,15,53.33,0,0,4,4,0.00
11861,ITA,15,Nwakalor Sylvia Chinelo ,O,18,2,2,12.73,22,18,6,9,33,36.36,2,3,2,7,-14.29,2,6,7,15,-26.67,0,0,0,0, ,2,3,6,-16.67,0,0,1,1,0.00
11861,ITA,19,Mingardi Camilla ,OH,0,0,0, ,0,0,0,0,0, ,0,0,0,0, ,0,0,0,0, ,0,0,0,0, ,0,0,0, ,0,0,0,0, 
11861,ITA,21,Lubian Marina ,MB,2,2,0,25.00,4,2,1,2,5,20.00,2,0,2,4,50.00,0,0,3,3,0.00,0,0,0,0, ,1,0,1,100.00,0,0,0,0, 
11861,ITA,23,De Bortoli Chiara ,L,0,0,0, ,0,0,0,0,0, ,0,0,0,0, ,0,0,0,0, ,0,0,2,2,0.00,0,0,1,0.00,0,0,1,1,0.00
11861,ITA,24,Mazzaro Alessia ,MB,4,0,1,3.70,5,4,2,0,6,33.33,0,2,1,3,-66.67,1,0,17,18,5.56,0,0,0,0, ,4,2,6,33.33,0,0,2,2,0.00
11861,ITA,26,Battistoni Ilaria ,S,0,0,0, ,0,0,0,0,0, ,0,0,0,0, ,0,0,0,0, ,0,0,0,0, ,0,0,0, ,0,0,0,0, 
11861,ITA,27,Furlan Eleonora ,MB,0,0,0, ,0,0,0,0,0, ,0,0,0,0, ,0,0,0,0, ,0,0,0,0, ,0,0,0, ,0,0,0,0, 
11861,ITA,28,Melli Giulia ,OH,0,0,0,0.00,0,0,0,0,0, ,0,0,0,0, ,0,0,1,1,0.00,0,0,0,0, ,0,0,0, ,0,0,0,0, 
11861,ITA,29,D'Odorico Sofia ,OH,2,0,0,-16.67,2,2,4,13,19,-10.53,0,0,0,0, ,0,2,3,5,-40.00,0,0,3,3,0.00,4,1,5,60.00,0,0,0,0, 
11861,ITA,31,Fersino Eleonora ,L,0,0,0, ,0,0,0,0,0, ,0,0,0,0, ,0,0,0,0, ,4,0,14,18,22.22,9,5,16,25.00,0,0,5,5,0.00
11861,ITA,32,Omoruyi Oghosasere Loveth ,OH,5,0,0,12.50,5,5,3,4,12,16.67,0,0,0,0, ,0,0,4,4,0.00,2,3,2,7,-14.29,4,2,6,33.33,0,0,1,1,0.00
11862,TUR,2,Akoz Simge Sebnem ,L,0,0,0, ,0,0,0,0,0, ,0,0,0,0, ,0,0,0,0, ,5,2,4,11,27.27,15,1,18,77.78,0,0,9,9,0.00
11862,TUR,3,Ãzbay Cansu ,S,0,0,1,-33.33,1,0,0,0,0, ,0,4,1,5,-80.00,1,1,5,7,0.00,0,0,0,0, ,3,3,6,0.00,14,0,32,46,30.43
11862,TUR,4,Senoglu Tugba ,OH,0,0,0, ,0,0,0,0,0, ,0,0,0,0, ,0,0,0,0, ,0,0,0,0, ,0,0,0, ,0,0,0,0, 
11862,TUR,5,Ercan Seyma ,OH,0,0,0,-20.00,0,0,1,1,2,-50.00,0,0,0,0, ,0,0,3,3,0.00,0,0,2,2,0.00,2,1,3,33.33,0,0,0,0, 
11862,TUR,6,Caliskan Kubra ,MB,1,1,0,0.00,2,1,1,0,2,0.00,1,0,6,7,14.29,0,1,3,4,-25.00,0,0,0,0, ,2,0,3,66.67,0,0,0,0, 
11862,TUR,7,Baladin Hande ,OH,9,0,0,28.57,9,9,1,7,17,47.06,0,0,3,3,0.00,0,0,8,8,0.00,1,0,11,12,8.33,9,2,12,58.33,0,0,0,0, 
11862,TUR,8,Guveli Yasemin ,MB,0,0,0, ,0,0,0,0,0, ,0,0,0,0, ,0,0,0,0, ,0,0,0,0, ,0,0,0, ,0,0,0,0, 
11862,TUR,9,Ismailoglu Meliha ,OH,3,1,1,3.03,5,3,0,8,11,27.27,1,4,2,7,-42.86,1,0,14,15,6.67,9,5,11,25,16.00,6,0,6,100.00,0,0,3,3,0.00
11862,TUR,10,Aykac Ayca ,L,0,0,0, ,0,0,0,0,0, ,0,0,0,0, ,0,0,0,0, ,0,0,0,0, ,0,0,0, ,0,0,0,0, 
11862,TUR,11,Aydemir Akyol Naz ,S,0,1,2,14.29,3,0,0,1,1,0.00,1,1,0,2,0.00,2,0,9,11,18.18,0,0,0,0, ,5,0,5,100.00,3,0,24,27,11.11
11862,TUR,13,Boz Meryem ,O,0,0,0, ,0,0,0,0,0, ,0,0,0,0, ,0,0,0,0, ,0,0,0,0, ,0,0,0, ,0,0,0,0, 
11862,TUR,14,Erdem DÃ¼ndar Eda ,MB,10,1,0,29.63,11,10,1,5,16,56.25,1,1,3,5,0.00,0,1,5,6,-16.67,0,0,0,0, ,1,0,1,100.00,0,0,1,1,0.00
11862,TUR,19,Kalac Asli ,MB,0,0,0,-45.45,0,0,3,2,5,-60.00,0,1,1,2,-50.00,0,1,3,4,-25.00,0,0,0,0, ,0,0,0, ,0,0,0,0, 
11862,TUR,99,Karakurt Ebrar ,OH,17,2,2,17.46,21,17,4,16,37,35.14,2,4,5,11,-18.18,2,2,11,15,0.00,0,0,0,0, ,6,3,9,33.33,0,0,2,2,0.00
11862,GER,1,Bock Linda ,L,0,0,0, ,0,0,0,0,0, ,0,0,0,0, ,0,0,0,0, ,0,0,0,0, ,0,0,0, ,0,0,0,0, 
11862,GER,2,KÃ¤stner Pia ,S,0,0,0,0.00,0,0,0,0,0, ,0,0,0,0, ,0,0,2,2,0.00,0,0,0,0, ,0,1,1,-100.00,3,0,1,4,75.00
11862,GER,4,Imoudu Denise ,S,1,0,1,-15.00,2,1,1,2,4,0.00,0,2,5,7,-28.57,1,2,6,9,-11.11,0,0,0,0, ,7,1,12,50.00,15,0,61,76,19.74
11862,GER,5,Poll Jana Franziska ,OH,3,1,0,0.00,4,3,3,3,9,0.00,1,1,2,4,0.00,0,0,2,2,0.00,0,0,6,6,0.00,2,0,2,100.00,0,0,1,1,0.00
11862,GER,7,Vanjak Ivana ,OH,5,0,1,5.56,6,5,3,3,11,18.18,0,1,3,4,-25.00,1,1,1,3,0.00,0,0,1,1,0.00,2,0,2,100.00,0,0,1,1,0.00
11862,GER,8,Drewniok Kimberly ,O,2,0,0,25.00,2,2,0,5,7,28.57,0,0,0,0, ,0,0,1,1,0.00,0,0,0,0, ,2,1,3,33.33,0,0,0,0, 
11862,GER,9,Alsmeier Lina ,OH,6,1,0,-7.69,7,6,1,4,11,45.45,1,5,0,6,-66.67,0,3,6,9,-33.33,7,4,22,33,9.09,4,2,6,33.33,0,0,1,1,0.00
11862,GER,10,Stigrot Lena ,OH,0,0,0,-50.00,0,0,0,2,2,0.00,0,3,0,3,-100.00,0,0,1,1,0.00,1,1,1,3,0.00,1,0,2,50.00,0,0,0,0, 
11862,GER,12,Orthmann Hanna ,OH,12,1,1,10.00,14,12,4,8,24,33.33,1,2,1,4,-25.00,1,4,7,12,-25.00,3,1,10,14,14.29,6,1,9,55.56,0,0,0,0, 
11862,GER,14,SchÃ¶lzel Marie ,MB,6,1,0,0.00,7,6,2,5,13,30.77,1,4,3,8,-37.50,0,1,9,10,-10.00,0,0,0,0, ,4,0,6,66.67,0,0,1,1,0.00
11862,GER,17,Pogany Anna ,L,0,0,0, ,0,0,0,0,0, ,0,0,0,0, ,0,0,0,0, ,1,0,9,10,10.00,8,1,9,77.78,0,0,6,6,0.00
11862,GER,20,Bock Josepha ,MB,0,0,0,0.00,0,0,0,0,0, ,0,0,0,0, ,0,0,1,1,0.00,0,0,0,0, ,0,0,0, ,0,0,0,0, 
11862,GER,21,Weitzel Camilla ,MB,3,0,4,-3.12,7,3,0,6,9,33.33,0,5,4,9,-55.56,4,3,7,14,7.14,0,0,0,0, ,2,0,2,100.00,0,0,0,0, 
11862,GER,24,Cekulaev Anastasia ,MB,0,0,0, ,0,0,0,0,0, ,0,0,0,0, ,0,0,0,0, ,0,0,0,0, ,0,0,0, ,0,0,0,0, 
11863,DOM,1,Vargas Valdez Annerys Victoria ,MB,5,1,0,-8.33,6,5,1,1,7,57.14,1,5,2,8,-50.00,0,2,7,9,-22.22,0,0,0,0, ,3,0,3,100.00,0,0,0,0, 
11863,DOM,3,Eve Mejia Lisvel Elisa ,U,0,0,0, ,0,0,0,0,0, ,0,0,0,0, ,0,0,0,0, ,0,0,0,0, ,0,0,0, ,0,0,0,0, 
11863,DOM,5,Castillo Brenda ,L,0,0,0, ,0,0,0,0,0, ,0,0,0,0, ,0,0,0,0, ,6,0,5,11,54.55,5,3,9,22.22,0,0,10,10,0.00
11863,DOM,7,Marte Frica Niverka Dharlenis ,S,1,0,1,-12.50,2,1,0,0,1,100.00,0,4,4,8,-50.00,1,1,13,15,0.00,0,0,0,0, ,5,2,9,33.33,16,1,56,73,20.55
11863,DOM,11,Rodriguez Marifranchi ,MB,0,0,0, ,0,0,0,0,0, ,0,0,0,0, ,0,0,0,0, ,0,0,0,0, ,0,0,0, ,0,0,1,1,0.00
11863,DOM,12,Perez Flores Yokaty ,S,0,0,0, ,0,0,0,0,0, ,0,0,0,0, ,0,0,0,0, ,0,0,0,0, ,0,0,0, ,0,0,0,0, 
11863,DOM,14,Rivera Brens Prisilla ,OH,0,0,0,0.00,0,0,0,1,1,0.00,0,0,0,0, ,0,0,3,3,0.00,0,0,1,1,0.00,2,1,3,33.33,0,0,0,0, 
11863,DOM,16,PeÃ±a Isabel Yonkaira Paola ,OH,15,1,0,19.57,16,15,6,7,28,32.14,1,0,4,5,20.00,0,1,12,13,-7.69,12,3,13,28,32.14,6,2,9,44.44,0,0,2,2,0.00
11863,DOM,17,Mambru Casilla Gina Altagracia ,O,0,0,0,0.00,0,0,0,0,0, ,0,0,0,0, ,0,0,2,2,0.00,0,0,0,0, ,0,0,0, ,0,0,0,0, 
11863,DOM,18,De La Cruz De PeÃ±a Bethania ,OH,0,0,0, ,0,0,0,0,0, ,0,0,0,0, ,0,0,0,0, ,0,0,0,0, ,0,0,0, ,0,0,0,0, 
11863,DOM,20,Martinez Brayelin Elizabeth ,OH,14,1,1,25.64,16,14,2,11,27,44.44,1,1,2,4,0.00,1,3,4,8,-25.00,3,2,14,19,5.26,15,2,17,76.47,0,0,1,1,0.00
11863,DOM,21,Martinez Jineiry ,MB,3,0,1,-3.57,4,3,2,3,8,12.50,0,1,3,4,-25.00,1,2,13,16,-6.25,0,0,0,0, ,2,0,2,100.00,0,0,1,1,0.00
11863,DOM,23,Gonzalez Lopez Gaila Ceneida ,O,11,3,1,15.56,15,11,3,9,23,34.78,3,3,6,12,0.00,1,2,7,10,-10.00,0,0,0,0, ,7,2,9,55.56,0,0,3,3,0.00
11863,DOM,25,Martinez Caro Larysmer ,OH,0,0,0, ,0,0,0,0,0, ,0,0,0,0, ,0,0,0,0, ,0,0,0,0, ,0,0,0, ,0,0,0,0, 
11863,KOR,1,Lee Soyoung ,OH,3,0,0,-4.76,3,3,2,7,12,8.33,0,1,0,1,-100.00,0,1,7,8,-12.50,4,1,12,17,17.65,5,0,5,100.00,0,0,1,1,0.00
11863,KOR,2,Lee Dahyeon ,MB,0,0,0, ,0,0,0,0,0, ,0,0,0,0, ,0,0,0,0, ,0,0,0,0, ,0,0,0, ,0,0,0,0, 
11863,KOR,3,Yeum Hye Seon ,S,1,0,3,5.26,4,1,0,0,1,100.00,0,1,2,3,-33.33,3,2,10,15,6.67,0,0,1,1,0.00,8,1,11,63.64,6,0,52,58,10.34
11863,KOR,5,Han Dahye ,L,0,0,0, ,0,0,0,0,0, ,0,0,0,0, ,0,0,0,0, ,0,0,0,0, ,0,0,0, ,0,0,1,1,0.00
11863,KOR,6,Kim Dain ,S,0,0,0, ,0,0,0,0,0, ,0,0,0,0, ,0,0,0,0, ,0,0,0,0, ,2,0,2,100.00,1,0,11,12,8.33
11863,KOR,8,Park Eunjin ,MB,1,1,1,0.00,3,1,1,7,9,0.00,1,2,1,4,-25.00,1,0,11,12,8.33,0,0,0,0, ,1,1,2,0.00,0,0,0,0, 
11863,KOR,9,Oh Jiyoung ,L,0,0,0, ,0,0,0,0,0, ,0,0,0,0, ,0,0,0,0, ,7,1,15,23,26.09,13,4,17,52.94,1,0,9,10,10.00
11863,KOR,10,Kim Yeon Koung ,OH,13,1,0,20.93,14,13,2,16,31,35.48,1,2,0,3,-33.33,0,1,8,9,-11.11,4,2,8,14,14.29,8,4,12,33.33,0,0,7,7,0.00
11863,KOR,12,Han Songyi ,MB,0,0,0, ,0,0,0,0,0, ,0,0,0,0, ,0,0,0,0, ,0,0,0,0, ,0,0,0, ,0,0,0,0, 
11863,KOR,13,Park Jeongah ,OH,9,0,0,0.00,9,9,2,11,22,31.82,0,3,0,3,-100.00,0,4,7,11,-36.36,0,0,2,2,0.00,6,3,9,33.33,3,0,11,14,21.43
11863,KOR,14,Yang Hyo Jin ,MB,4,2,0,14.29,6,4,0,4,8,50.00,2,2,0,4,0.00,0,1,8,9,-11.11,0,0,0,0, ,0,2,2,-100.00,0,0,1,1,0.00
11863,KOR,15,Yuk Seoyoung ,OH,0,0,0, ,0,0,0,0,0, ,0,0,0,0, ,0,0,0,0, ,0,0,0,0, ,0,0,0, ,0,0,0,0, 
11863,KOR,16,Jeong Jiyun ,O,1,0,0,-16.67,1,1,1,3,5,0.00,0,1,0,1,-100.00,0,0,0,0, ,0,0,0,0, ,0,1,1,-100.00,0,0,0,0, 
11863,KOR,19,Pyo Seungju ,OH,3,0,1,-22.73,4,3,6,6,15,-20.00,0,2,0,2,-100.00,1,1,3,5,0.00,4,0,4,8,50.00,2,0,2,100.00,0,0,2,2,0.00
11864,BEL,2,Van Sas Elise ,S,0,0,0, ,0,0,0,0,0, ,0,0,0,0, ,0,0,0,0, ,0,0,0,0, ,0,0,0, ,0,0,0,0, 
11864,BEL,3,Herbots Britt ,OH,19,0,1,6.33,20,19,8,26,53,20.75,0,5,5,10,-50.00,1,2,13,16,-6.25,0,0,3,3,0.00,9,3,17,35.29,0,0,5,5,0.00
11864,BEL,4,Lemmens Nathalie ,MB,0,0,0, ,0,0,0,0,0, ,0,0,0,0, ,0,0,0,0, ,0,0,0,0, ,0,0,0, ,0,0,0,0, 
11864,BEL,5,Guilliams Jodie ,OH,11,0,0,-9.38,11,11,6,13,30,16.67,0,8,2,10,-80.00,0,3,21,24,-12.50,6,0,14,20,30.00,12,0,14,85.71,0,0,3,3,0.00
11864,BEL,6,Gilson Helena ,OH,2,0,0,20.00,2,2,1,2,5,20.00,0,0,0,0, ,0,0,0,0, ,0,0,0,0, ,0,0,0, ,0,0,0,0, 
11864,BEL,7,Van Gestel Celine ,OH,12,2,1,16.36,15,12,4,16,32,25.00,2,2,6,10,0.00,1,0,12,13,7.69,11,1,37,49,20.41,13,4,18,50.00,0,0,1,1,0.00
11864,BEL,9,Demeyer Nel ,L,0,0,0, ,0,0,0,0,0, ,0,0,0,0, ,0,0,0,0, ,0,0,0,0, ,0,0,0, ,0,0,0,0, 
11864,BEL,10,Sobolska Dominika ,MB,1,0,0,-22.22,1,1,2,4,7,-14.29,0,3,4,7,-42.86,0,0,4,4,0.00,0,1,0,1,-100.00,2,0,2,100.00,0,0,0,0, 
11864,BEL,13,Janssens Marlies ,MB,9,7,3,25.00,19,9,4,6,19,26.32,7,3,4,14,28.57,3,0,12,15,20.00,0,0,1,1,0.00,4,1,5,60.00,0,0,1,1,0.00
11864,BEL,15,Van De Vyver Jutta ,S,0,0,0, ,0,0,0,0,0, ,0,0,0,0, ,0,0,0,0, ,0,0,0,0, ,0,0,0, ,0,0,0,0, 
11864,BEL,17,Van De Vyver Ilka ,S,0,0,1,0.00,1,0,0,0,0, ,0,1,4,5,-20.00,1,0,17,18,5.56,0,0,0,0, ,9,3,14,42.86,31,0,105,136,22.79
11864,BEL,18,Rampelberg Britt ,L,0,0,0, ,0,0,0,0,0, ,0,0,0,0, ,0,0,0,0, ,4,0,9,13,30.77,17,5,27,44.44,0,0,10,10,0.00
11864,BEL,19,Van Avermaet Silke ,MB,7,1,2,32.00,10,7,0,1,8,87.50,1,1,2,4,0.00,2,1,10,13,7.69,0,1,0,1,-100.00,5,0,6,83.33,0,0,0,0, 
11864,BEL,21,Stragier Manon ,OH,0,0,0,0.00,0,0,0,0,0, ,0,0,0,0, ,0,0,1,1,0.00,0,0,0,0, ,0,1,1,-100.00,0,0,0,0, 
11864,POL,1,Nowicka Julia ,S,0,0,1,-6.06,1,0,0,3,3,0.00,0,2,5,7,-28.57,1,1,21,23,0.00,0,0,0,0, ,11,3,17,47.06,20,1,92,113,16.81
11864,POL,3,Alagierska Klaudia ,MB,8,4,0,6.98,12,8,2,1,11,54.55,4,5,7,16,-6.25,0,2,14,16,-12.50,0,0,1,1,0.00,7,1,8,75.00,0,0,1,1,0.00
11864,POL,5,Kakolewska Agnieszka ,MB,0,0,0, ,0,0,0,0,0, ,0,0,0,0, ,0,0,0,0, ,0,0,0,0, ,0,0,0, ,0,0,0,0, 
11864,POL,8,Stenzel Maria ,L,0,0,0, ,0,0,0,0,0, ,0,0,0,0, ,0,0,0,0, ,5,4,26,35,2.86,10,0,11,90.91,0,0,16,16,0.00
11864,POL,9,Stysiak Magdalena ,O,19,2,0,7.35,21,19,11,17,47,17.02,2,3,1,6,-16.67,0,2,13,15,-13.33,0,2,11,13,-15.38,4,4,9,0.00,0,0,1,1,0.00
11864,POL,10,Efimienko-Mlotkowska Zuzanna ,MB,4,2,2,2.50,8,4,1,4,9,33.33,2,5,7,14,-21.43,2,1,14,17,5.88,0,1,0,1,-100.00,6,0,6,100.00,0,0,0,0, 
11864,POL,11,Lukasik Martyna ,O,7,1,0,0.00,8,7,5,11,23,8.70,1,2,2,5,-20.00,0,1,12,13,-7.69,6,1,27,34,14.71,7,2,12,41.67,0,0,0,0, 
11864,POL,13,Jagla Monika ,L,0,0,0, ,0,0,0,0,0, ,0,0,0,0, ,0,0,0,0, ,0,0,0,0, ,6,8,15,-13.33,0,0,6,6,0.00
11864,POL,17,Smarzek Malwina ,O,17,2,0,14.71,19,17,5,28,50,24.00,2,4,4,10,-20.00,0,0,8,8,0.00,0,0,1,1,0.00,6,2,12,33.33,0,0,1,1,0.00
11864,POL,19,Fedusio Monika ,OH,0,0,0,-20.00,0,0,0,3,3,0.00,0,1,0,1,-100.00,0,0,1,1,0.00,1,0,8,9,11.11,2,2,4,0.00,0,0,0,0, 
11864,POL,20,Czyrnianska Martyna ,OH,1,0,0,-14.29,1,1,0,4,5,20.00,0,2,0,2,-100.00,0,0,0,0, ,0,0,0,0, ,0,0,0, ,0,0,0,0, 
11864,POL,27,Åazowska Martyna ,S,0,0,0,-50.00,0,0,0,0,0, ,0,0,0,0, ,0,1,1,2,-50.00,0,0,0,0, ,2,0,2,100.00,3,0,6,9,33.33
11864,POL,30,Rozanski Olivia ,OH,0,0,0,-100.00,0,0,1,0,1,-100.00,0,0,0,0, ,0,0,0,0, ,0,0,0,0, ,0,0,0, ,0,0,0,0, 
11864,POL,88,Gorecka Zuzanna ,OH,1,0,0,33.33,1,1,0,1,2,50.00,0,0,0,0, ,0,0,1,1,0.00,0,0,4,4,0.00,2,0,3,66.67,0,0,0,0, 
11865,SRB,2,Lazovic Katarina ,OH,14,0,0,16.67,14,14,2,12,28,42.86,0,2,0,2,-100.00,0,2,16,18,-11.11,8,0,12,20,40.00,14,0,15,93.33,1,0,1,2,50.00
11865,SRB,3,Caric Sara ,O,8,6,0,5.66,14,8,7,16,31,3.23,6,3,3,12,25.00,0,1,9,10,-10.00,0,0,0,0, ,13,2,17,64.71,0,0,0,0, 
11865,SRB,6,Uzelac Aleksandra ,OH,0,0,0, ,0,0,0,0,0, ,0,0,0,0, ,0,0,0,0, ,0,0,0,0, ,0,0,0, ,0,0,0,0, 
11865,SRB,7,Jaksic Ana ,S,3,2,1,28.57,6,3,0,3,6,50.00,2,0,3,5,40.00,1,0,9,10,10.00,0,0,0,0, ,3,0,4,75.00,14,1,75,90,14.44
11865,SRB,21,Kocic Jovana ,MB,4,5,0,8.11,9,4,1,4,9,33.33,5,4,6,15,6.67,0,1,12,13,-7.69,1,0,1,2,50.00,2,0,3,66.67,0,0,1,1,0.00
11865,SRB,22,Lozo Sara ,O,3,0,3,8.33,6,3,4,9,16,-6.25,0,0,0,0, ,3,0,5,8,37.50,3,2,9,14,7.14,5,0,5,100.00,0,0,1,1,0.00
11865,SRB,23,Djordjevic Mila ,S,1,0,0,0.00,1,1,0,0,1,100.00,0,1,0,1,-100.00,0,0,1,1,0.00,0,0,0,0, ,1,0,1,100.00,2,0,12,14,14.29
11865,SRB,24,Medic Sofija ,MB,1,3,0,-4.00,4,1,3,3,7,-28.57,3,0,7,10,30.00,0,2,6,8,-25.00,0,0,0,0, ,1,0,1,100.00,0,0,0,0, 
11865,SRB,26,Savic Vanja ,O,0,0,0, ,0,0,0,0,0, ,0,0,0,0, ,0,0,0,0, ,0,0,0,0, ,0,0,0, ,0,0,0,0, 
11865,SRB,28,Delic Jelena ,MB,0,0,0, ,0,0,0,0,0, ,0,0,0,0, ,0,0,0,0, ,0,0,0,0, ,0,0,0, ,0,0,0,0, 
11865,SRB,31,Djurdjevic Sanja ,L,0,0,0, ,0,0,0,0,0, ,0,0,0,0, ,0,0,0,0, ,1,2,8,11,-9.09,17,1,21,76.19,0,0,3,3,0.00
11865,SRB,32,Gocanin Bojana ,L,0,0,0, ,0,0,0,0,0, ,0,0,0,0, ,0,0,0,0, ,0,0,0,0, ,0,0,0, ,0,0,0,0, 
11865,SRB,33,Cvetkovic Jovana ,OH,0,0,0, ,0,0,0,0,0, ,0,0,0,0, ,0,0,0,0, ,0,0,0,0, ,0,0,0, ,0,0,0,0, 
11865,SRB,34,Mirosavljevic Jovana ,OH,6,2,0,15.38,8,6,3,9,18,16.67,2,0,1,3,66.67,0,1,4,5,-20.00,8,1,9,18,38.89,5,2,7,42.86,0,0,0,0, 
11865,THA,2,Pannoy Piyanut ,L,0,0,0, ,0,0,0,0,0, ,0,0,0,0, ,0,0,0,0, ,6,0,6,12,50.00,12,2,15,66.67,0,0,4,4,0.00
11865,THA,3,ManaKij Sirima ,S,1,0,0,-20.00,1,1,1,0,2,0.00,0,1,1,2,-50.00,0,0,1,1,0.00,0,0,0,0, ,0,0,0, ,0,0,7,7,0.00
11865,THA,5,Thinkaow Pleumjit ,MB,6,1,1,4.17,8,6,3,18,27,11.11,1,3,4,8,-25.00,1,0,12,13,7.69,1,0,1,2,50.00,4,1,5,60.00,0,0,1,1,0.00
11865,THA,6,Sittirak Onuma ,OH,12,0,1,14.00,13,12,4,21,37,21.62,0,1,0,1,-100.00,1,1,10,12,0.00,4,0,11,15,26.67,10,3,15,46.67,0,0,4,4,0.00
11865,THA,9,Chuewulim Sutadta ,OH,5,0,1,-11.11,6,5,6,6,17,-5.88,0,3,0,3,-100.00,1,0,6,7,14.29,2,0,6,8,25.00,5,1,6,66.67,0,0,0,0, 
11865,THA,10,Apinyapong Wilavan ,L,0,0,0, ,0,0,0,0,0, ,0,0,0,0, ,0,0,0,0, ,0,0,0,0, ,8,1,10,70.00,0,0,2,2,0.00
11865,THA,11,Hyapha Amporn ,MB,0,0,0, ,0,0,0,0,0, ,0,0,0,0, ,0,0,0,0, ,0,0,0,0, ,0,0,0, ,0,0,0,0, 
11865,THA,12,Chaisri Tapaphaipun ,L,0,0,1,-25.00,1,0,2,2,4,-50.00,0,1,0,1,-100.00,1,0,2,3,33.33,1,0,2,3,33.33,5,0,5,100.00,0,0,2,2,0.00
11865,THA,13,Tomkom Nootsara ,S,0,0,0,-20.00,0,0,2,1,3,-66.67,0,1,2,3,-33.33,0,0,9,9,0.00,0,0,1,1,0.00,9,2,11,63.64,10,0,97,107,9.35
11865,THA,14,Juangjan Pattiya ,OH,3,0,0,18.18,3,3,1,4,8,25.00,0,0,0,0, ,0,0,3,3,0.00,2,0,2,4,50.00,1,1,2,0.00,0,0,0,0, 
11865,THA,15,Kanthong Malika ,O,1,0,0,-19.05,1,1,5,9,15,-26.67,0,0,0,0, ,0,0,6,6,0.00,1,4,5,10,-30.00,5,2,10,30.00,0,0,1,1,0.00
11865,THA,19,Krause Karina ,MB,3,0,0,13.33,3,3,1,3,7,28.57,0,0,2,2,0.00,0,0,6,6,0.00,1,0,1,2,50.00,1,0,1,100.00,0,0,1,1,0.00
11865,THA,22,Nilapa Chatsuda ,OH,0,0,0,-33.33,0,0,2,5,7,-28.57,0,1,0,1,-100.00,0,1,3,4,-25.00,3,0,5,8,37.50,1,0,1,100.00,0,0,0,0, 
11865,THA,24,Nuanjam Watchareeya ,MB,0,0,1,-30.00,1,0,2,3,5,-40.00,0,2,0,2,-100.00,1,0,2,3,33.33,0,0,1,1,0.00,1,0,1,100.00,0,0,0,0, 
11866,CHN,3,Diao Linyu ,S,0,0,0,-50.00,0,0,1,0,1,-100.00,0,0,0,0, ,0,0,1,1,0.00,0,0,0,0, ,1,1,2,0.00,2,0,29,31,6.45
11866,CHN,4,Yang Hanyu ,MB,3,1,1,-9.68,5,3,1,8,12,16.67,1,5,2,8,-50.00,1,2,8,11,-9.09,0,0,0,0, ,0,0,0, ,1,0,1,2,50.00
11866,CHN,5,Gao Yi ,MB,2,0,1,8.33,3,2,0,6,8,25.00,0,1,2,3,-33.33,1,0,12,13,7.69,0,1,0,1,-100.00,3,1,4,50.00,0,0,1,1,0.00
11866,CHN,7,Wang Yuanyuan ,MB,8,0,1,12.12,9,8,1,8,17,41.18,0,4,0,4,-100.00,1,0,11,12,8.33,0,0,0,0, ,1,1,2,0.00,0,0,0,0, 
11866,CHN,8,Li Yao ,OH,9,0,0,6.98,9,9,4,15,28,17.86,0,2,3,5,-40.00,0,0,10,10,0.00,0,0,1,1,0.00,6,2,8,50.00,0,0,3,3,0.00
11866,CHN,9,Zhang Changning ,OH,18,2,2,12.68,22,18,10,21,49,16.33,2,2,0,4,0.00,2,1,15,18,5.56,9,1,12,22,36.36,8,2,12,50.00,0,0,1,1,0.00
11866,CHN,10,Liu Xiaotong ,OH,3,0,1,-9.68,4,3,4,11,18,-5.56,0,3,1,4,-75.00,1,0,8,9,11.11,2,3,11,16,-6.25,2,7,9,-55.56,0,0,0,0, 
11866,CHN,11,Yao Di ,S,1,0,1,-20.00,2,1,0,1,2,50.00,0,4,1,5,-80.00,1,2,10,13,-7.69,0,0,0,0, ,10,3,13,53.85,11,0,105,116,9.48
11866,CHN,14,Zheng Yixin ,MB,0,0,0, ,0,0,0,0,0, ,0,0,0,0, ,0,0,0,0, ,0,0,0,0, ,0,0,0, ,0,0,0,0, 
11866,CHN,15,Lin Li ,L,0,0,0, ,0,0,0,0,0, ,0,0,0,0, ,0,0,0,0, ,0,0,0,0, ,0,0,0, ,0,0,0,0, 
11866,CHN,18,Wang Mengjie ,L,0,0,0, ,0,0,0,0,0, ,0,0,0,0, ,0,0,0,0, ,10,0,12,22,45.45,15,4,19,57.89,0,1,11,12,-8.33
11866,CHN,19,Liu Yanhan ,OH,4,0,0,3.70,4,4,1,14,19,15.79,0,2,2,4,-50.00,0,0,4,4,0.00,0,0,0,0, ,1,0,1,100.00,0,1,0,1,-100.00
11866,CHN,22,Duan Fang ,OH,6,3,1,18.18,10,6,3,8,17,17.65,3,1,1,5,40.00,1,0,10,11,9.09,9,4,13,26,19.23,7,2,12,41.67,0,0,3,3,0.00
11866,CAN,1,Bujan Cassandra ,L,0,0,0, ,0,0,0,0,0, ,0,0,0,0, ,0,0,0,0, ,8,2,15,25,24.00,12,10,25,8.00,0,0,11,11,0.00
11866,CAN,3,Van Ryk Kiera ,OH,18,5,2,9.76,25,18,10,25,53,15.09,5,3,4,12,16.67,2,4,11,17,-11.76,0,0,0,0, ,7,0,7,100.00,1,0,1,2,50.00
11866,CAN,5,Smith Danielle ,S,0,0,0, ,0,0,0,0,0, ,0,0,0,0, ,0,0,0,0, ,0,0,0,0, ,0,0,0, ,1,0,9,10,10.00
11866,CAN,7,Van Buskirk Layne ,MB,0,0,0, ,0,0,0,0,0, ,0,0,0,0, ,0,0,0,0, ,0,0,0,0, ,0,0,0, ,0,0,0,0, 
11866,CAN,8,Ogoms Alicia ,MB,0,0,0, ,0,0,0,0,0, ,0,0,0,0, ,0,0,0,0, ,0,0,0,0, ,0,0,0, ,0,0,0,0, 
11866,CAN,9,Gray Alexa ,OH,0,0,0, ,0,0,0,0,0, ,0,0,0,0, ,0,0,0,0, ,0,0,2,2,0.00,0,1,1,-100.00,0,0,0,0, 
11866,CAN,11,Mitrovic Andrea ,OH,17,0,0,12.90,17,17,4,24,45,28.89,0,3,2,5,-60.00,0,2,10,12,-16.67,12,2,20,34,29.41,4,3,9,11.11,0,0,1,1,0.00
11866,CAN,12,Cross Jennifer ,MB,7,4,2,11.36,13,7,3,4,14,28.57,4,3,5,12,8.33,2,2,14,18,0.00,0,0,1,1,0.00,0,0,0, ,0,0,0,0, 
11866,CAN,13,King Brie ,S,2,1,3,14.81,6,2,1,3,6,16.67,1,0,3,4,25.00,3,1,13,17,11.76,0,1,0,1,-100.00,10,6,16,25.00,12,0,116,128,9.38
11866,CAN,14,Howe Hilary ,OH,11,2,1,15.79,14,11,2,18,31,29.03,2,3,0,5,-20.00,1,0,20,21,4.76,15,3,15,33,36.36,6,3,11,27.27,0,0,3,3,0.00
11866,CAN,15,Joseph Shainah ,O,0,0,0, ,0,0,0,0,0, ,0,0,0,0, ,0,0,0,0, ,0,0,0,0, ,0,0,0, ,0,0,0,0, 
11866,CAN,16,Livingston Caroline ,OH,0,0,0, ,0,0,0,0,0, ,0,0,0,0, ,0,0,0,0, ,0,0,0,0, ,0,0,0, ,0,0,0,0, 
11866,CAN,19,Maglio Emily ,MB,4,2,1,-10.26,7,4,2,6,12,16.67,2,6,4,12,-33.33,1,3,11,15,-13.33,0,0,1,1,0.00,1,1,2,0.00,0,0,2,2,0.00
11866,CAN,22,Snape Kennedy Brooklyn ,L,0,0,0, ,0,0,0,0,0, ,0,0,0,0, ,0,0,0,0, ,0,0,0,0, ,0,0,0, ,0,0,0,0, 
11867,USA,1,Hancock Micha ,S,3,0,2,0.00,5,3,0,2,5,60.00,0,1,1,2,-50.00,2,4,7,13,-15.38,0,0,0,0, ,11,3,15,53.33,34,2,58,94,34.04
11867,USA,4,Wong-Orantes Justine ,L,0,0,0, ,0,0,0,0,0, ,0,0,0,0, ,0,0,0,0, ,9,0,5,14,64.29,14,3,21,52.38,0,0,12,12,0.00
11867,USA,6,Dixon Tetori ,MB,3,0,2,0.00,5,3,1,7,11,18.18,0,3,4,7,-42.86,2,1,8,11,9.09,0,0,0,0, ,3,1,4,50.00,0,0,0,0, 
11867,USA,7,Carlini Lauren ,S,0,0,0, ,0,0,0,0,0, ,0,0,0,0, ,0,0,0,0, ,0,0,0,0, ,0,0,0, ,0,0,0,0, 
11867,USA,8,Tapp Hannah ,MB,0,0,0, ,0,0,0,0,0, ,0,0,0,0, ,0,0,0,0, ,0,0,0,0, ,0,0,0, ,0,0,0,0, 
11867,USA,10,Larson Jordan ,OH,8,1,1,11.11,10,8,2,21,31,19.35,1,1,2,4,0.00,1,2,7,10,-10.00,7,0,5,12,58.33,14,2,16,75.00,0,0,2,2,0.00
11867,USA,11,Drews Andrea ,O,9,2,0,6.38,11,9,4,12,25,20.00,2,2,5,9,0.00,0,2,11,13,-15.38,0,0,0,0, ,12,1,13,84.62,0,0,0,0, 
11867,USA,12,Thompson Jordan ,O,0,0,0, ,0,0,0,0,0, ,0,0,0,0, ,0,0,0,0, ,0,0,0,0, ,0,0,0, ,0,0,0,0, 
11867,USA,14,Bartsch-Hackley Michelle ,OH,0,0,0, ,0,0,0,0,0, ,0,0,0,0, ,0,0,0,0, ,0,0,0,0, ,0,0,0, ,0,0,0,0, 
11867,USA,15,Hill Kimberly ,OH,0,0,0, ,0,0,0,0,0, ,0,0,0,0, ,0,0,0,0, ,0,0,0,0, ,0,0,0, ,0,0,0,0, 
11867,USA,16,Akinradewo Foluke ,MB,8,1,0,6.45,9,8,3,3,14,35.71,1,4,2,7,-42.86,0,0,10,10,0.00,0,0,0,0, ,2,1,3,33.33,0,0,0,0, 
11867,USA,17,Courtney Megan ,OH,0,0,0, ,0,0,0,0,0, ,0,0,0,0, ,0,0,0,0, ,0,0,0,0, ,0,0,0, ,0,0,0,0, 
11867,USA,22,Washington Haleigh ,MB,0,0,0, ,0,0,0,0,0, ,0,0,0,0, ,0,0,0,0, ,0,0,0,0, ,0,0,0, ,0,0,0,0, 
11867,USA,23,Robinson Kelsey ,OH,10,1,2,12.77,13,10,5,13,28,17.86,1,2,0,3,-33.33,2,0,14,16,12.50,9,0,10,19,47.37,15,0,16,93.75,0,0,4,4,0.00
11867,NED,1,Knip Kirsten ,L,0,0,0, ,0,0,0,0,0, ,0,0,0,0, ,0,0,0,0, ,0,0,0,0, ,0,0,0, ,0,0,0,0, 
11867,NED,2,Savelkoel Fleur ,OH,0,0,0, ,0,0,0,0,0, ,0,0,0,0, ,0,0,0,0, ,0,0,0,0, ,0,0,0, ,0,0,0,0, 
11867,NED,7,Lohuis Juliet ,MB,0,0,0,-11.11,0,0,0,2,2,0.00,0,0,0,0, ,0,1,6,7,-14.29,0,0,0,0, ,1,0,1,100.00,0,0,0,0, 
11867,NED,8,Korevaar Demi ,MB,0,0,0,0.00,0,0,0,0,0, ,0,0,0,0, ,0,0,1,1,0.00,0,0,0,0, ,0,0,0, ,0,0,0,0, 
11867,NED,9,Schoot Myrthe ,L,0,0,0, ,0,0,0,0,0, ,0,0,0,0, ,0,0,0,0, ,4,0,5,9,44.44,13,6,19,36.84,0,0,11,11,0.00
11867,NED,10,van Aalen Sarah ,S,0,0,0, ,0,0,0,0,0, ,0,0,0,0, ,0,0,0,0, ,0,0,0,0, ,0,0,0, ,0,0,0,0, 
11867,NED,11,Buijs Anne ,OH,5,4,0,6.25,9,5,2,24,31,9.68,4,4,1,9,0.00,0,0,8,8,0.00,9,3,11,23,26.09,11,2,15,60.00,0,0,6,6,0.00
11867,NED,12,Bongaerts Britt ,S,0,0,0,-31.25,0,0,0,0,0, ,0,3,4,7,-42.86,0,2,7,9,-22.22,0,1,0,1,-100.00,6,5,11,9.09,20,0,74,94,21.28
11867,NED,16,Baijens Indy ,MB,7,0,0,25.00,7,7,0,2,9,77.78,0,1,1,2,-50.00,0,2,3,5,-40.00,1,0,0,1,100.00,2,0,2,100.00,0,0,0,0, 
11867,NED,18,Jasper Marrit ,OH,1,0,0,0.00,1,1,0,3,4,25.00,0,0,1,1,0.00,0,1,1,2,-50.00,2,1,5,8,12.50,3,2,6,16.67,0,0,0,0, 
11867,NED,19,Daalderop Nika ,OH,6,0,0,-11.63,6,6,7,20,33,-3.03,0,3,1,4,-75.00,0,1,5,6,-16.67,5,2,13,20,15.00,4,2,7,28.57,0,0,2,2,0.00
11867,NED,23,Timmerman Eline ,MB,3,1,0,-16.13,4,3,2,5,10,10.00,1,5,8,14,-28.57,0,2,5,7,-28.57,0,0,0,0, ,3,1,5,40.00,0,0,0,0, 
11867,NED,26,Dambrink Elles ,O,6,0,0,-5.13,6,6,3,15,24,12.50,0,2,1,3,-66.67,0,3,9,12,-25.00,1,0,1,2,50.00,12,3,16,56.25,0,0,2,2,0.00
11867,NED,27,Scholten Iris ,O,0,0,0, ,0,0,0,0,0, ,0,0,0,0, ,0,0,0,0, ,0,0,0,0, ,0,0,0, ,0,0,0,0, 
11868,ITA,2,Bosio Francesca ,S,1,2,1,3.12,4,1,0,2,3,33.33,2,2,4,8,0.00,1,1,19,21,0.00,0,0,0,0, ,7,1,8,75.00,14,0,124,138,10.14
11868,ITA,4,Bonifacio Sara ,MB,7,2,0,9.52,9,7,1,6,14,42.86,2,4,2,8,-25.00,0,0,20,20,0.00,0,0,0,0, ,2,2,4,0.00,0,0,2,2,0.00
11868,ITA,12,Guerra Anastasia ,OH,20,5,1,28.79,26,20,5,25,50,30.00,5,1,0,6,66.67,1,1,8,10,0.00,3,2,12,17,5.88,9,3,12,50.00,0,0,1,1,0.00
11868,ITA,15,Nwakalor Sylvia Chinelo ,O,22,1,1,6.67,24,22,11,20,53,20.75,1,6,1,8,-62.50,1,2,11,14,-7.14,0,0,0,0, ,6,6,14,0.00,0,0,4,4,0.00
11868,ITA,19,Mingardi Camilla ,OH,1,0,0,33.33,1,1,0,1,2,50.00,0,0,0,0, ,0,0,1,1,0.00,0,0,0,0, ,0,1,1,-100.00,0,0,0,0, 
11868,ITA,21,Lubian Marina ,MB,0,0,0, ,0,0,0,0,0, ,0,0,0,0, ,0,0,0,0, ,0,0,0,0, ,0,0,0, ,0,0,0,0, 
11868,ITA,23,De Bortoli Chiara ,L,0,0,0, ,0,0,0,0,0, ,0,0,0,0, ,0,0,0,0, ,4,0,3,7,57.14,2,2,4,0.00,0,0,4,4,0.00
11868,ITA,24,Mazzaro Alessia ,MB,8,0,1,14.29,9,8,2,6,16,37.50,0,1,1,2,-50.00,1,1,15,17,0.00,0,0,1,1,0.00,1,4,5,-60.00,0,0,0,0, 
11868,ITA,26,Battistoni Ilaria ,S,0,0,0, ,0,0,0,0,0, ,0,0,0,0, ,0,0,0,0, ,0,0,0,0, ,0,0,0, ,0,0,4,4,0.00
11868,ITA,27,Furlan Eleonora ,MB,0,0,0, ,0,0,0,0,0, ,0,0,0,0, ,0,0,0,0, ,0,0,0,0, ,0,0,0, ,0,0,0,0, 
11868,ITA,28,Melli Giulia ,OH,3,1,1,25.00,5,3,1,4,8,25.00,1,0,0,1,100.00,1,0,6,7,14.29,4,0,5,9,44.44,3,1,4,50.00,0,0,0,0, 
11868,ITA,29,D'Odorico Sofia ,OH,7,0,2,8.33,9,7,1,9,17,35.29,0,1,0,1,-100.00,2,4,12,18,-11.11,15,4,17,36,30.56,8,5,13,23.08,0,0,0,0, 
11868,ITA,31,Fersino Eleonora ,L,0,0,0, ,0,0,0,0,0, ,0,0,0,0, ,0,0,0,0, ,11,0,15,26,42.31,18,7,26,42.31,0,0,9,9,0.00
11868,ITA,32,Omoruyi Oghosasere Loveth ,OH,0,0,0, ,0,0,0,0,0, ,0,0,0,0, ,0,0,0,0, ,0,0,0,0, ,0,0,0, ,0,0,0,0, 
11868,JPN,1,Kurogo Ai ,OH,14,0,1,9.09,15,14,6,19,39,20.51,0,0,0,0, ,1,4,11,16,-18.75,10,0,11,21,47.62,11,4,16,43.75,0,0,0,0, 
11868,JPN,2,Koga Sarina ,OH,21,1,1,18.67,23,21,7,22,50,28.00,1,1,0,2,0.00,1,1,21,23,0.00,12,3,6,21,42.86,1,1,2,0.00,0,0,1,1,0.00
11868,JPN,3,Shimamura Haruyo ,MB,1,0,0,-36.36,1,1,1,2,4,0.00,0,4,0,4,-100.00,0,0,3,3,0.00,0,1,0,1,-100.00,1,0,1,100.00,0,0,1,1,0.00
11868,JPN,5,Araki Erika ,MB,11,2,3,9.26,16,11,3,6,20,40.00,2,8,3,13,-46.15,3,0,18,21,14.29,0,0,0,0, ,2,1,3,33.33,0,1,0,1,-100.00
11868,JPN,7,Ishii Yuki ,OH,1,0,0,0.00,1,1,1,0,2,0.00,0,0,0,0, ,0,0,0,0, ,3,1,2,6,33.33,0,0,0, ,0,0,1,1,0.00
11868,JPN,8,Ishikawa Mayu ,OH,17,2,1,25.00,20,17,2,23,42,35.71,2,3,0,5,-20.00,1,0,12,13,7.69,15,2,10,27,48.15,9,5,14,28.57,0,0,0,0, 
11868,JPN,9,Tashiro Kanami ,S,0,1,0,25.00,1,0,0,1,1,0.00,1,0,0,1,100.00,0,0,2,2,0.00,0,0,0,0, ,1,0,1,100.00,1,0,19,20,5.00
11868,JPN,10,Akutagawa Aika ,MB,0,0,0, ,0,0,0,0,0, ,0,0,0,0, ,0,0,0,0, ,0,0,0,0, ,0,0,0, ,0,0,0,0, 
11868,JPN,11,Nabeya Yurie ,OH,0,0,0,0.00,0,0,0,0,0, ,0,0,0,0, ,0,0,1,1,0.00,0,0,0,0, ,0,0,0, ,0,0,0,0, 
11868,JPN,13,Okumura Mai ,MB,1,0,0,-19.05,1,1,0,5,6,16.67,0,5,3,8,-62.50,0,0,7,7,0.00,0,0,0,0, ,0,2,2,-100.00,0,0,0,0, 
11868,JPN,14,Kobata Mako ,L,0,0,0, ,0,0,0,0,0, ,0,0,0,0, ,0,0,0,0, ,18,0,5,23,78.26,9,10,20,-5.00,0,0,5,5,0.00
11868,JPN,15,Inoue Kotoe ,L,0,0,0, ,0,0,0,0,0, ,0,0,0,0, ,0,0,0,0, ,0,0,0,0, ,0,0,0, ,0,0,0,0, 
11868,JPN,21,Hayashi Kotona ,OH,0,0,0,-25.00,0,0,0,1,1,0.00,0,0,0,0, ,0,1,2,3,-33.33,0,0,0,0, ,0,1,1,-100.00,0,0,0,0, 
11868,JPN,24,Momii Aki ,S,2,0,0,-12.50,2,2,2,3,7,0.00,0,2,1,3,-66.67,0,1,13,14,-7.14,0,0,0,0, ,0,4,4,-100.00,8,0,127,135,5.93
11869,BRA,2,De Oliveira Saad Gattaz Caroline ,MB,7,2,1,13.33,10,7,1,5,13,46.15,2,4,7,13,-15.38,1,1,2,4,0.00,1,0,0,1,100.00,5,0,5,100.00,0,0,3,3,0.00
11869,BRA,3,Rodrigues Lins Dos Santos Danielle ,S,0,0,0,-75.00,0,0,0,0,0, ,0,2,0,2,-100.00,0,1,1,2,-50.00,0,0,0,0, ,3,0,4,75.00,4,0,9,13,30.77
11869,BRA,6,Alexandre Costa Nunes Nyeme Victoria ,L,0,0,0, ,0,0,0,0,0, ,0,0,0,0, ,0,0,0,0, ,0,0,0,0, ,0,0,0, ,0,0,0,0, 
11869,BRA,7,Montibeller Rosamaria ,OH,0,0,0, ,0,0,0,0,0, ,0,0,0,0, ,0,0,0,0, ,0,0,0,0, ,0,0,0, ,0,0,0,0, 
11869,BRA,8,Silva Carneiro Macris Fernanda ,S,0,0,1,-20.00,1,0,0,1,1,0.00,0,2,0,2,-100.00,1,1,5,7,0.00,0,0,0,0, ,5,0,6,83.33,32,0,40,72,44.44
11869,BRA,10,Braga Guimaraes Gabriela ,OH,1,1,0,-10.00,2,1,4,11,16,-18.75,1,1,2,4,0.00,0,0,10,10,0.00,4,1,11,16,18.75,16,2,19,73.68,0,0,0,0, 
11869,BRA,11,Caixeta Tandara ,OH,11,2,1,28.57,14,11,3,10,24,33.33,2,0,1,3,66.67,1,1,6,8,0.00,0,0,0,0, ,3,1,5,40.00,0,0,0,0, 
11869,BRA,13,Castro De Paula Blassioli Sheilla ,O,3,0,0,0.00,3,3,2,1,6,16.67,0,1,1,2,-50.00,0,0,1,1,0.00,0,0,0,0, ,1,0,1,100.00,0,0,0,0, 
11869,BRA,15,Da Silva Ana Carolina ,MB,8,1,6,23.91,15,8,1,7,16,43.75,1,2,2,5,-20.00,6,1,18,25,20.00,0,0,0,0, ,2,1,3,33.33,0,0,5,5,0.00
11869,BRA,16,Rodrigues Fernanda ,OH,11,1,0,16.28,12,11,3,11,25,32.00,1,1,3,5,0.00,0,1,12,13,-7.69,6,0,4,10,60.00,10,2,14,57.14,0,0,2,2,0.00
11869,BRA,18,Brait Camila ,L,0,0,0, ,0,0,0,0,0, ,0,0,0,0, ,0,0,0,0, ,10,0,10,20,50.00,13,2,16,68.75,0,0,4,4,0.00
11869,BRA,20,Correa Ana Beatriz ,MB,0,0,0, ,0,0,0,0,0, ,0,0,0,0, ,0,0,0,0, ,0,0,0,0, ,0,0,0, ,0,0,0,0, 
11869,BRA,24,Geraldo Teixeira Lorenne ,O,1,0,0,0.00,1,1,0,0,1,100.00,0,0,0,0, ,0,1,3,4,-25.00,0,0,0,0, ,0,0,1,0.00,0,0,0,0, 
11869,BRA,28,Araujo De Souza Mayany Cristina ,MB,0,0,0, ,0,0,0,0,0, ,0,0,0,0, ,0,0,0,0, ,0,0,0,0, ,0,0,0, ,0,0,0,0, 
11869,RUS,2,Malygina Daria ,O,2,0,0,0.00,2,2,0,4,6,33.33,0,1,1,2,-50.00,0,1,6,7,-14.29,0,0,0,0, ,2,0,2,100.00,0,0,1,1,0.00
11869,RUS,4,Pilipenko Daria ,L,0,0,0, ,0,0,0,0,0, ,0,0,0,0, ,0,0,0,0, ,2,2,4,8,0.00,10,3,14,50.00,0,0,6,6,0.00
11869,RUS,5,Fedorovtseva Arina ,OH,6,1,0,0.00,7,6,4,10,20,10.00,1,2,0,3,-33.33,0,1,6,7,-14.29,1,2,3,6,-16.67,3,2,6,16.67,0,0,0,0, 
11869,RUS,6,Koroleva Irina ,MB,0,1,0,0.00,1,0,0,2,2,0.00,1,1,1,3,0.00,0,0,7,7,0.00,0,1,1,2,-50.00,1,1,2,0.00,0,0,1,1,0.00
11869,RUS,9,Gorbunova Valeriia ,O,0,0,0, ,0,0,0,0,0, ,0,0,0,0, ,0,0,0,0, ,0,0,0,0, ,0,0,0, ,0,0,0,0, 
11869,RUS,10,Matveeva Polina ,S,0,0,0,0.00,0,0,0,2,2,0.00,0,0,0,0, ,0,0,2,2,0.00,0,0,1,1,0.00,4,2,6,33.33,3,0,40,43,6.98
11869,RUS,11,Brovkina Yulia ,MB,1,2,0,10.00,3,1,0,2,3,33.33,2,2,1,5,0.00,0,0,2,2,0.00,0,0,0,0, ,1,0,1,100.00,0,0,0,0, 
11869,RUS,15,Kosheleva Tatyana ,OH,5,0,1,10.00,6,5,0,3,8,62.50,0,4,0,4,-100.00,1,0,7,8,12.50,7,2,18,27,18.52,6,1,9,55.56,0,1,0,1,-100.00
11869,RUS,16,Voronkova Irina ,OH,5,1,0,7.41,6,5,4,12,21,4.76,1,0,0,1,100.00,0,0,5,5,0.00,3,1,4,8,25.00,2,2,6,0.00,0,0,0,0, 
11869,RUS,20,Lazareva Ekaterina ,S,0,0,0,-20.00,0,0,0,0,0, ,0,1,1,2,-50.00,0,0,3,3,0.00,0,0,0,0, ,7,2,10,50.00,1,3,42,46,-4.35
11869,RUS,22,Zaytseva Tamara ,L,0,0,0, ,0,0,0,0,0, ,0,0,0,0, ,0,0,0,0, ,0,0,4,4,0.00,5,3,11,18.18,0,0,6,6,0.00
11869,RUS,23,Kapustina Irina ,OH,0,0,0,-33.33,0,0,0,1,1,0.00,0,0,0,0, ,0,1,1,2,-50.00,0,0,5,5,0.00,0,0,0, ,0,1,0,1,-100.00
11869,RUS,24,Pipunyrova Ekaterina ,OH,0,0,0,-40.00,0,0,2,2,4,-50.00,0,0,1,1,0.00,0,0,0,0, ,0,1,4,5,-20.00,2,0,2,100.00,0,0,0,0, 
11869,RUS,25,Smirnova Kseniia ,OH,8,0,0,4.88,8,8,5,20,33,9.09,0,1,0,1,-100.00,0,0,7,7,0.00,1,0,0,1,100.00,6,3,9,33.33,0,0,1,1,0.00
11870,BEL,3,Herbots Britt ,OH,26,4,2,20.00,32,26,5,39,70,30.00,4,5,10,19,-5.26,2,1,13,16,6.25,6,1,11,18,27.78,6,2,10,40.00,0,0,6,6,0.00
11870,BEL,4,Lemmens Nathalie ,MB,0,0,0,-33.33,0,0,0,2,2,0.00,0,3,1,4,-75.00,0,0,3,3,0.00,0,0,0,0, ,0,0,0, ,0,0,0,0, 
11870,BEL,5,Guilliams Jodie ,OH,12,0,0,8.00,12,12,3,12,27,33.33,0,3,3,6,-50.00,0,2,15,17,-11.76,14,0,10,24,58.33,15,3,19,63.16,0,1,3,4,-25.00
11870,BEL,6,Gilson Helena ,OH,0,0,0, ,0,0,0,0,0, ,0,0,0,0, ,0,0,0,0, ,0,0,0,0, ,0,0,0, ,0,0,0,0, 
11870,BEL,7,Van Gestel Celine ,OH,13,2,0,8.20,15,13,8,17,38,13.16,2,1,2,5,20.00,0,1,17,18,-5.56,2,0,7,9,22.22,13,3,17,58.82,0,0,3,3,0.00
11870,BEL,9,Demeyer Nel ,L,0,0,0, ,0,0,0,0,0, ,0,0,0,0, ,0,0,0,0, ,0,0,0,0, ,0,0,0, ,0,0,0,0, 
11870,BEL,10,Sobolska Dominika ,MB,0,0,0, ,0,0,0,0,0, ,0,0,0,0, ,0,0,0,0, ,0,0,0,0, ,0,0,0, ,0,0,0,0, 
11870,BEL,13,Janssens Marlies ,MB,12,1,1,11.11,14,12,2,6,20,50.00,1,5,5,11,-36.36,1,2,11,14,-7.14,0,0,0,0, ,3,1,5,40.00,0,0,0,0, 
11870,BEL,14,De Valkeneer Lise ,OH,0,0,0, ,0,0,0,0,0, ,0,0,0,0, ,0,0,0,0, ,0,0,0,0, ,0,0,0, ,0,0,0,0, 
11870,BEL,15,Van De Vyver Jutta ,S,0,0,0,0.00,0,0,0,0,0, ,0,0,0,0, ,0,0,2,2,0.00,0,0,0,0, ,1,0,1,100.00,0,1,8,9,-11.11
11870,BEL,17,Van De Vyver Ilka ,S,0,1,0,-30.30,1,0,0,0,0, ,1,9,2,12,-66.67,0,2,19,21,-9.52,0,0,0,0, ,13,2,17,64.71,22,0,121,143,15.38
11870,BEL,18,Rampelberg Britt ,L,0,0,0, ,0,0,0,0,0, ,0,0,0,0, ,0,0,0,0, ,17,2,21,40,37.50,19,8,27,40.74,1,0,8,9,11.11
11870,BEL,19,Van Avermaet Silke ,MB,5,0,1,0.00,6,5,0,10,15,33.33,0,5,4,9,-55.56,1,1,13,15,0.00,1,0,0,1,100.00,2,1,5,20.00,0,0,2,2,0.00
11870,BEL,21,Stragier Manon ,OH,0,0,0, ,0,0,0,0,0, ,0,0,0,0, ,0,0,0,0, ,0,0,0,0, ,0,0,0, ,0,0,0,0, 
11870,KOR,1,Lee Soyoung ,OH,23,0,0,14.49,23,23,4,17,44,43.18,0,6,2,8,-75.00,0,3,14,17,-17.65,9,2,29,40,17.50,18,3,25,60.00,0,0,3,3,0.00
11870,KOR,2,Lee Dahyeon ,MB,0,0,0, ,0,0,0,0,0, ,0,0,0,0, ,0,0,0,0, ,0,0,0,0, ,0,0,0, ,0,0,0,0, 
11870,KOR,3,Yeum Hye Seon ,S,0,0,0,-14.29,0,0,0,1,1,0.00,0,0,0,0, ,0,2,11,13,-15.38,0,0,0,0, ,7,1,8,75.00,7,0,70,77,9.09
11870,KOR,5,Han Dahye ,L,0,0,0, ,0,0,0,0,0, ,0,0,0,0, ,0,0,0,0, ,0,0,0,0, ,0,0,0, ,0,0,0,0, 
11870,KOR,6,Kim Dain ,S,0,0,0,-7.14,0,0,1,1,2,-50.00,0,0,0,0, ,0,0,12,12,0.00,0,0,0,0, ,8,1,9,77.78,7,1,55,63,9.52
11870,KOR,8,Park Eunjin ,MB,0,0,0,-33.33,0,0,0,3,3,0.00,0,6,1,7,-85.71,0,0,8,8,0.00,0,0,0,0, ,1,2,3,-33.33,0,0,1,1,0.00
11870,KOR,9,Oh Jiyoung ,L,0,0,0, ,0,0,0,0,0, ,0,0,0,0, ,0,0,0,0, ,6,0,18,24,25.00,16,4,22,54.55,0,0,12,12,0.00
11870,KOR,10,Kim Yeon Koung ,OH,24,1,2,23.94,27,24,6,18,48,37.50,1,3,4,8,-25.00,2,1,12,15,6.67,12,2,19,33,30.30,15,3,21,57.14,0,0,8,8,0.00
11870,KOR,12,Han Songyi ,MB,0,0,0,0.00,0,0,0,2,2,0.00,0,0,0,0, ,0,0,7,7,0.00,0,0,0,0, ,1,0,2,50.00,0,0,0,0, 
11870,KOR,13,Park Jeongah ,OH,5,1,1,-4.76,7,5,6,17,28,-3.57,1,2,6,9,-11.11,1,1,3,5,0.00,0,0,0,0, ,3,1,4,50.00,0,0,5,5,0.00
11870,KOR,14,Yang Hyo Jin ,MB,6,3,0,-3.92,9,6,2,6,14,28.57,3,7,9,19,-21.05,0,2,16,18,-11.11,0,0,0,0, ,4,1,8,37.50,0,0,1,1,0.00
11870,KOR,15,Yuk Seoyoung ,OH,0,0,0, ,0,0,0,0,0, ,0,0,0,0, ,0,0,0,0, ,0,0,0,0, ,0,0,0, ,0,0,0,0, 
11870,KOR,16,Jeong Jiyun ,O,8,2,0,0.00,10,8,4,14,26,15.38,2,5,5,12,-25.00,0,1,6,7,-14.29,0,0,0,0, ,6,3,12,25.00,0,0,1,1,0.00
11870,KOR,19,Pyo Seungju ,OH,0,0,0, ,0,0,0,0,0, ,0,0,0,0, ,0,0,0,0, ,0,0,0,0, ,0,0,0, ,0,0,0,0, 
11871,THA,2,Pannoy Piyanut ,L,0,0,0, ,0,0,0,0,0, ,0,0,0,0, ,0,0,0,0, ,4,1,5,10,30.00,5,7,13,-15.38,0,0,7,7,0.00
11871,THA,3,ManaKij Sirima ,S,0,0,0,0.00,0,0,0,0,0, ,0,0,0,0, ,0,0,2,2,0.00,0,0,0,0, ,0,2,2,-100.00,2,0,26,28,7.14
11871,THA,5,Thinkaow Pleumjit ,MB,4,0,0,3.70,4,4,0,12,16,25.00,0,3,0,3,-100.00,0,0,8,8,0.00,0,0,0,0, ,2,1,3,33.33,0,0,2,2,0.00
11871,THA,6,Sittirak Onuma ,OH,7,0,0,0.00,7,7,5,12,24,8.33,0,0,0,0, ,0,2,7,9,-22.22,3,4,17,24,-4.17,2,1,3,33.33,0,0,4,4,0.00
11871,THA,8,Sang-Ob Tirawan ,MB,0,0,0,0.00,0,0,0,1,1,0.00,0,0,0,0, ,0,0,0,0, ,0,0,0,0, ,0,0,0, ,0,0,0,0, 
11871,THA,9,Chuewulim Sutadta ,OH,4,0,0,16.67,4,4,1,8,13,23.08,0,0,0,0, ,0,0,5,5,0.00,0,0,8,8,0.00,2,1,3,33.33,0,0,1,1,0.00
11871,THA,10,Apinyapong Wilavan ,L,0,0,0, ,0,0,0,0,0, ,0,0,0,0, ,0,0,0,0, ,0,0,0,0, ,1,0,1,100.00,0,0,0,0, 
11871,THA,12,Chaisri Tapaphaipun ,L,1,0,0,-12.50,1,1,2,3,6,-16.67,0,0,0,0, ,0,0,2,2,0.00,0,0,4,4,0.00,2,2,4,0.00,0,0,1,1,0.00
11871,THA,13,Tomkom Nootsara ,S,0,0,0,0.00,0,0,0,0,0, ,0,0,0,0, ,0,0,4,4,0.00,0,0,0,0, ,0,2,2,-100.00,0,0,49,49,0.00
11871,THA,14,Juangjan Pattiya ,OH,1,0,0,0.00,1,1,1,0,2,0.00,0,0,0,0, ,0,0,1,1,0.00,0,0,0,0, ,0,0,0, ,0,0,0,0, 
11871,THA,15,Kanthong Malika ,O,3,1,0,5.26,4,3,3,7,13,0.00,1,0,0,1,100.00,0,0,5,5,0.00,4,2,9,15,13.33,4,1,5,60.00,0,0,1,1,0.00
11871,THA,19,Krause Karina ,MB,4,0,0,-5.26,4,4,2,4,10,20.00,0,1,0,1,-100.00,0,2,6,8,-25.00,0,0,0,0, ,0,1,1,-100.00,0,0,0,0, 
11871,THA,22,Nilapa Chatsuda ,OH,1,0,0,0.00,1,1,1,3,5,0.00,0,0,0,0, ,0,0,1,1,0.00,0,0,2,2,0.00,0,0,0, ,0,0,1,1,0.00
11871,THA,24,Nuanjam Watchareeya ,MB,1,0,0,0.00,1,1,1,2,4,0.00,0,0,0,0, ,0,0,4,4,0.00,0,0,0,0, ,0,1,1,-100.00,0,0,1,1,0.00
11871,USA,1,Hancock Micha ,S,1,2,1,4.17,4,1,0,4,5,20.00,2,1,1,4,25.00,1,2,12,15,-6.67,0,0,0,0, ,1,1,2,0.00,27,1,52,80,32.50
11871,USA,4,Wong-Orantes Justine ,L,0,0,0, ,0,0,0,0,0, ,0,0,0,0, ,0,0,0,0, ,0,0,0,0, ,0,0,0, ,0,0,0,0, 
11871,USA,6,Dixon Tetori ,MB,0,0,0, ,0,0,0,0,0, ,0,0,0,0, ,0,0,0,0, ,0,0,0,0, ,0,0,0, ,0,0,0,0, 
11871,USA,7,Carlini Lauren ,S,0,0,0, ,0,0,0,0,0, ,0,0,0,0, ,0,0,0,0, ,0,0,0,0, ,0,0,0, ,0,0,0,0, 
11871,USA,8,Tapp Hannah ,MB,6,0,1,4.35,7,6,1,2,9,55.56,0,3,0,3,-100.00,1,2,8,11,-9.09,1,0,0,1,100.00,3,0,3,100.00,0,0,1,1,0.00
11871,USA,10,Larson Jordan ,OH,0,0,0, ,0,0,0,0,0, ,0,0,0,0, ,0,0,0,0, ,0,0,0,0, ,0,0,0, ,0,0,0,0, 
11871,USA,11,Drews Andrea ,O,0,0,0, ,0,0,0,0,0, ,0,0,0,0, ,0,0,0,0, ,0,0,0,0, ,0,0,0, ,0,0,0,0, 
11871,USA,12,Thompson Jordan ,O,14,3,0,26.32,17,14,2,9,25,48.00,3,2,1,6,16.67,0,3,4,7,-42.86,0,0,0,0, ,5,1,6,66.67,0,0,0,0, 
11871,USA,14,Bartsch-Hackley Michelle ,OH,11,3,4,24.49,18,11,1,8,20,50.00,3,4,0,7,-14.29,4,1,17,22,13.64,9,0,8,17,52.94,3,4,7,-14.29,0,0,2,2,0.00
11871,USA,15,Hill Kimberly ,OH,9,2,0,15.79,11,9,4,12,25,20.00,2,0,2,4,50.00,0,1,8,9,-11.11,6,0,4,10,60.00,5,4,9,11.11,0,0,0,0, 
11871,USA,17,Courtney Megan ,OH,0,0,0, ,0,0,0,0,0, ,0,0,0,0, ,0,0,0,0, ,9,0,7,16,56.25,5,4,9,11.11,0,0,4,4,0.00
11871,USA,22,Washington Haleigh ,MB,6,1,1,16.00,8,6,0,4,10,60.00,1,3,2,6,-33.33,1,1,7,9,0.00,0,0,1,1,0.00,0,1,1,-100.00,0,0,0,0, 
11871,USA,23,Robinson Kelsey ,OH,0,0,0, ,0,0,0,0,0, ,0,0,0,0, ,0,0,0,0, ,0,0,0,0, ,0,0,0, ,0,0,0,0, 
11871,USA,24,Ogbogu Chiaka ,MB,0,0,0, ,0,0,0,0,0, ,0,0,0,0, ,0,0,0,0, ,0,0,0,0, ,0,0,0, ,0,0,0,0, 
11872,GER,1,Bock Linda ,L,0,0,0, ,0,0,0,0,0, ,0,0,0,0, ,0,0,0,0, ,0,0,0,0, ,0,0,0, ,0,0,0,0, 
11872,GER,2,KÃ¤stner Pia ,S,0,0,1,10.00,1,0,0,0,0, ,0,0,0,0, ,1,0,9,10,10.00,0,1,0,1,-100.00,2,1,3,33.33,3,1,41,45,4.44
11872,GER,4,Imoudu Denise ,S,1,1,0,33.33,2,1,0,2,3,33.33,1,0,0,1,100.00,0,0,2,2,0.00,0,0,0,0, ,2,2,5,0.00,3,2,37,42,2.38
11872,GER,5,Poll Jana Franziska ,OH,3,0,0,12.50,3,3,1,6,10,20.00,0,0,1,1,0.00,0,0,5,5,0.00,11,3,8,22,36.36,3,2,6,16.67,0,0,0,0, 
11872,GER,7,Vanjak Ivana ,OH,12,3,1,19.15,16,12,4,12,28,28.57,3,1,1,5,40.00,1,2,11,14,-7.14,0,0,0,0, ,5,0,6,83.33,0,0,0,0, 
11872,GER,8,Drewniok Kimberly ,O,1,0,0,0.00,1,1,1,1,3,0.00,0,0,0,0, ,0,0,0,0, ,0,0,0,0, ,0,0,0, ,0,0,0,0, 
11872,GER,9,Alsmeier Lina ,OH,2,0,0,-7.69,2,2,1,4,7,14.29,0,0,1,1,0.00,0,2,3,5,-40.00,3,1,4,8,25.00,2,1,3,33.33,0,0,0,0, 
11872,GER,10,Stigrot Lena ,OH,5,0,0,7.69,5,5,2,0,7,42.86,0,1,1,2,-50.00,0,1,3,4,-25.00,5,0,6,11,45.45,0,0,1,0.00,0,0,0,0, 
11872,GER,12,Orthmann Hanna ,OH,8,0,0,4.35,8,8,1,6,15,46.67,0,2,0,2,-100.00,0,4,2,6,-66.67,3,1,10,14,14.29,4,1,5,60.00,0,0,0,0, 
11872,GER,14,SchÃ¶lzel Marie ,MB,3,2,0,-8.33,5,3,3,4,10,0.00,2,3,2,7,-14.29,0,1,6,7,-14.29,0,0,0,0, ,2,1,4,25.00,0,0,1,1,0.00
11872,GER,17,Pogany Anna ,L,0,0,0, ,0,0,0,0,0, ,0,0,0,0, ,0,0,0,0, ,10,0,8,18,55.56,6,6,13,0.00,0,0,5,5,0.00
11872,GER,20,Bock Josepha ,MB,0,0,0,-50.00,0,0,1,0,1,-100.00,0,0,0,0, ,0,0,1,1,0.00,0,0,0,0, ,0,0,0, ,0,0,0,0, 
11872,GER,21,Weitzel Camilla ,MB,5,1,1,-13.16,7,5,1,5,11,36.36,1,8,3,12,-58.33,1,3,11,15,-13.33,0,0,0,0, ,2,0,2,100.00,0,0,1,1,0.00
11872,GER,24,Cekulaev Anastasia ,MB,0,0,0, ,0,0,0,0,0, ,0,0,0,0, ,0,0,0,0, ,0,0,0,0, ,0,0,0, ,0,0,0,0, 
11872,CAN,1,Bujan Cassandra ,L,0,0,0, ,0,0,0,0,0, ,0,0,0,0, ,0,0,0,0, ,9,1,12,22,36.36,6,3,11,27.27,0,0,5,5,0.00
11872,CAN,3,Van Ryk Kiera ,OH,16,0,2,10.00,18,16,8,11,35,22.86,0,2,1,3,-66.67,2,3,7,12,-8.33,0,0,1,1,0.00,2,0,3,66.67,0,0,3,3,0.00
11872,CAN,5,Smith Danielle ,S,0,0,0, ,0,0,0,0,0, ,0,0,0,0, ,0,0,0,0, ,0,0,0,0, ,0,0,0, ,0,0,0,0, 
11872,CAN,6,White Jazmine  Ruth ,MB,0,0,0, ,0,0,0,0,0, ,0,0,0,0, ,0,0,0,0, ,0,0,0,0, ,0,0,0, ,0,0,0,0, 
11872,CAN,8,Ogoms Alicia ,MB,0,0,0, ,0,0,0,0,0, ,0,0,0,0, ,0,0,0,0, ,0,0,0,0, ,0,0,0, ,0,0,0,0, 
11872,CAN,9,Gray Alexa ,OH,0,0,0, ,0,0,0,0,0, ,0,0,0,0, ,0,0,0,0, ,1,0,1,2,50.00,1,1,2,0.00,0,0,0,0, 
11872,CAN,11,Mitrovic Andrea ,OH,7,0,2,5.13,9,7,6,9,22,4.55,0,0,2,2,0.00,2,1,12,15,6.67,5,1,9,15,26.67,6,0,6,100.00,0,0,2,2,0.00
11872,CAN,12,Cross Jennifer ,MB,7,4,1,24.24,12,7,1,1,9,66.67,4,3,4,11,9.09,1,0,12,13,7.69,0,0,1,1,0.00,5,0,5,100.00,0,0,4,4,0.00
11872,CAN,13,King Brie ,S,3,0,1,-4.00,4,3,0,1,4,75.00,0,5,1,6,-83.33,1,0,14,15,6.67,0,0,0,0, ,12,2,16,62.50,10,2,62,74,10.81
11872,CAN,14,Howe Hilary ,OH,4,2,0,8.00,6,4,1,5,10,30.00,2,1,3,6,16.67,0,2,7,9,-22.22,1,1,13,15,0.00,1,3,5,-40.00,0,0,3,3,0.00
11872,CAN,15,Joseph Shainah ,O,0,0,0, ,0,0,0,0,0, ,0,0,0,0, ,0,0,0,0, ,0,0,0,0, ,0,0,0, ,0,0,0,0, 
11872,CAN,16,Livingston Caroline ,OH,0,0,0, ,0,0,0,0,0, ,0,0,0,0, ,0,0,0,0, ,0,0,0,0, ,0,0,0, ,0,0,0,0, 
11872,CAN,19,Maglio Emily ,MB,7,1,0,5.26,8,7,0,4,11,63.64,1,6,4,11,-45.45,0,0,16,16,0.00,0,0,0,0, ,4,1,6,50.00,0,0,2,2,0.00
11872,CAN,22,Snape Kennedy Brooklyn ,L,0,0,0, ,0,0,0,0,0, ,0,0,0,0, ,0,0,0,0, ,0,0,0,0, ,0,0,0, ,0,0,0,0, 
11873,JPN,1,Kurogo Ai ,OH,9,0,2,7.69,11,9,5,12,26,15.38,0,1,1,2,-50.00,2,2,7,11,0.00,0,0,1,1,0.00,2,3,5,-20.00,0,1,2,3,-33.33
11873,JPN,2,Koga Sarina ,OH,18,0,3,25.00,21,18,3,20,41,36.59,0,1,1,2,-50.00,3,2,12,17,5.88,8,1,9,18,38.89,6,4,11,18.18,0,0,1,1,0.00
11873,JPN,5,Araki Erika ,MB,2,2,1,8.00,5,2,2,4,8,0.00,2,0,1,3,66.67,1,1,12,14,0.00,1,0,0,1,100.00,1,1,2,0.00,0,0,2,2,0.00
11873,JPN,7,Ishii Yuki ,OH,0,0,0, ,0,0,0,0,0, ,0,0,0,0, ,0,0,0,0, ,0,0,0,0, ,0,0,0, ,0,0,0,0, 
11873,JPN,8,Ishikawa Mayu ,OH,19,0,1,39.13,20,19,1,12,32,56.25,0,1,0,1,-100.00,1,0,12,13,7.69,11,0,4,15,73.33,7,1,8,75.00,0,0,2,2,0.00
11873,JPN,9,Tashiro Kanami ,S,0,0,0,0.00,0,0,0,0,0, ,0,0,0,0, ,0,0,1,1,0.00,0,0,0,0, ,0,0,0, ,0,0,6,6,0.00
11873,JPN,10,Akutagawa Aika ,MB,0,0,0, ,0,0,0,0,0, ,0,0,0,0, ,0,0,0,0, ,0,0,0,0, ,0,0,0, ,0,0,0,0, 
11873,JPN,11,Nabeya Yurie ,OH,0,0,0, ,0,0,0,0,0, ,0,0,0,0, ,0,0,0,0, ,0,0,0,0, ,0,0,0, ,0,0,0,0, 
11873,JPN,13,Okumura Mai ,MB,0,0,0, ,0,0,0,0,0, ,0,0,0,0, ,0,0,0,0, ,0,0,0,0, ,0,0,0, ,0,0,0,0, 
11873,JPN,14,Kobata Mako ,L,0,0,0, ,0,0,0,0,0, ,0,0,0,0, ,0,0,0,0, ,0,0,0,0, ,0,0,0, ,0,0,1,1,0.00
11873,JPN,15,Inoue Kotoe ,L,0,0,0, ,0,0,0,0,0, ,0,0,0,0, ,0,0,0,0, ,10,1,8,19,47.37,13,5,20,40.00,0,0,7,7,0.00
11873,JPN,19,Yamada Nichika ,MB,5,1,0,16.67,6,5,2,8,15,20.00,1,0,1,2,50.00,0,0,7,7,0.00,1,0,1,2,50.00,1,3,4,-50.00,0,0,0,0, 
11873,JPN,21,Hayashi Kotona ,OH,0,0,0,0.00,0,0,0,0,0, ,0,0,1,1,0.00,0,0,0,0, ,0,0,2,2,0.00,0,0,0, ,0,0,0,0, 
11873,JPN,24,Momii Aki ,S,0,0,0,-7.69,0,0,0,0,0, ,0,0,2,2,0.00,0,1,10,11,-9.09,0,0,0,0, ,4,2,6,33.33,14,0,86,100,14.00
11873,RUS,2,Malygina Daria ,O,0,0,0, ,0,0,0,0,0, ,0,0,0,0, ,0,0,0,0, ,0,0,0,0, ,0,0,0, ,0,0,0,0, 
11873,RUS,4,Pilipenko Daria ,L,0,0,0, ,0,0,0,0,0, ,0,0,0,0, ,0,0,0,0, ,6,1,14,21,23.81,10,6,16,25.00,0,0,8,8,0.00
11873,RUS,5,Fedorovtseva Arina ,OH,4,0,0,6.25,4,4,1,5,10,30.00,0,0,0,0, ,0,2,4,6,-33.33,2,2,6,10,0.00,1,0,1,100.00,0,0,1,1,0.00
11873,RUS,6,Koroleva Irina ,MB,5,1,0,13.04,6,5,0,5,10,50.00,1,3,1,5,-40.00,0,0,8,8,0.00,0,0,0,0, ,1,0,1,100.00,0,0,0,0, 
11873,RUS,8,Goncharova Nataliya ,O,12,1,0,13.73,13,12,2,21,35,28.57,1,4,1,6,-50.00,0,0,10,10,0.00,0,0,0,0, ,3,3,6,0.00,0,0,0,0, 
11873,RUS,10,Matveeva Polina ,S,0,0,0, ,0,0,0,0,0, ,0,0,0,0, ,0,0,0,0, ,0,0,0,0, ,0,0,0, ,0,0,0,0, 
11873,RUS,11,Brovkina Yulia ,MB,0,0,0, ,0,0,0,0,0, ,0,0,0,0, ,0,0,0,0, ,0,0,0,0, ,0,0,0, ,0,0,0,0, 
11873,RUS,13,Startseva Evgeniya ,S,1,1,1,-11.11,3,1,0,1,2,50.00,1,4,0,5,-60.00,1,1,9,11,0.00,0,0,1,1,0.00,6,2,10,40.00,3,0,92,95,3.16
11873,RUS,14,Fetisova Irina ,MB,2,4,0,0.00,6,2,0,9,11,18.18,4,6,1,11,-18.18,0,0,8,8,0.00,0,0,0,0, ,1,5,6,-66.67,0,0,2,2,0.00
11873,RUS,15,Kosheleva Tatyana ,OH,5,1,0,6.45,6,5,2,14,21,14.29,1,2,0,3,-33.33,0,0,7,7,0.00,5,3,10,18,11.11,3,5,8,-25.00,0,0,2,2,0.00
11873,RUS,16,Voronkova Irina ,OH,10,0,1,16.67,11,10,2,10,22,36.36,0,2,1,3,-66.67,1,1,9,11,0.00,10,1,7,18,50.00,2,2,4,0.00,0,0,0,0, 
11873,RUS,22,Zaytseva Tamara ,L,0,0,0, ,0,0,0,0,0, ,0,0,0,0, ,0,0,0,0, ,0,0,0,0, ,0,0,0, ,0,0,0,0, 
11873,RUS,23,Kapustina Irina ,OH,0,0,0, ,0,0,0,0,0, ,0,0,0,0, ,0,0,0,0, ,0,0,0,0, ,0,0,0, ,0,0,0,0, 
11873,RUS,25,Smirnova Kseniia ,OH,0,0,0,-50.00,0,0,0,0,0, ,0,0,0,0, ,0,1,1,2,-50.00,0,0,0,0, ,0,0,0, ,0,0,0,0, 
11874,CHN,3,Diao Linyu ,S,0,0,0, ,0,0,0,0,0, ,0,0,0,0, ,0,0,0,0, ,0,0,0,0, ,0,0,0, ,0,0,0,0, 
11874,CHN,4,Yang Hanyu ,MB,1,0,0,-25.00,1,1,2,0,3,-33.33,0,2,1,3,-66.67,0,0,6,6,0.00,0,0,0,0, ,1,0,1,100.00,0,0,1,1,0.00
11874,CHN,5,Gao Yi ,MB,1,0,2,0.00,3,1,0,9,10,10.00,0,3,4,7,-42.86,2,0,8,10,20.00,0,0,1,1,0.00,2,0,2,100.00,0,0,2,2,0.00
11874,CHN,7,Wang Yuanyuan ,MB,2,0,1,-9.09,3,2,2,6,10,0.00,0,2,4,6,-33.33,1,1,4,6,0.00,0,0,0,0, ,1,0,1,100.00,0,0,1,1,0.00
11874,CHN,8,Li Yao ,OH,6,1,0,-2.56,7,6,5,15,26,3.85,1,2,3,6,-16.67,0,1,6,7,-14.29,4,0,5,9,44.44,9,2,11,63.64,0,0,2,2,0.00
11874,CHN,9,Zhang Changning ,OH,0,0,0, ,0,0,0,0,0, ,0,0,0,0, ,0,0,0,0, ,0,0,0,0, ,0,0,0, ,0,0,0,0, 
11874,CHN,10,Liu Xiaotong ,OH,0,0,0, ,0,0,0,0,0, ,0,0,0,0, ,0,0,0,0, ,1,0,3,4,25.00,0,1,1,-100.00,0,0,0,0, 
11874,CHN,11,Yao Di ,S,0,0,0,-7.69,0,0,0,0,0, ,0,1,2,3,-33.33,0,0,10,10,0.00,0,0,0,0, ,13,3,18,55.56,13,1,84,98,12.24
11874,CHN,14,Zheng Yixin ,MB,2,0,0,20.00,2,2,1,1,4,25.00,0,0,0,0, ,0,0,1,1,0.00,0,0,0,0, ,2,0,2,100.00,0,0,0,0, 
11874,CHN,15,Lin Li ,L,0,0,0, ,0,0,0,0,0, ,0,0,0,0, ,0,0,0,0, ,5,3,5,13,15.38,6,3,10,30.00,0,0,6,6,0.00
11874,CHN,18,Wang Mengjie ,L,0,0,0, ,0,0,0,0,0, ,0,0,0,0, ,0,0,0,0, ,2,0,6,8,25.00,4,1,5,60.00,0,0,1,1,0.00
11874,CHN,19,Liu Yanhan ,OH,8,0,1,11.36,9,8,3,21,32,15.62,0,1,0,1,-100.00,1,0,10,11,9.09,1,1,5,7,0.00,7,1,8,75.00,0,0,2,2,0.00
11874,CHN,22,Duan Fang ,OH,6,3,1,9.30,10,6,4,17,27,7.41,3,1,3,7,28.57,1,1,7,9,0.00,4,3,18,25,4.00,7,1,8,75.00,0,0,1,1,0.00
11874,TUR,2,Akoz Simge Sebnem ,L,0,0,0, ,0,0,0,0,0, ,0,0,0,0, ,0,0,0,0, ,0,0,0,0, ,0,0,0, ,0,0,0,0, 
11874,TUR,3,Ãzbay Cansu ,S,0,0,0, ,0,0,0,0,0, ,0,0,0,0, ,0,0,0,0, ,0,0,0,0, ,0,0,0, ,2,0,3,5,40.00
11874,TUR,4,Senoglu Tugba ,OH,1,0,0,0.00,1,1,0,0,1,100.00,0,0,0,0, ,0,1,1,2,-50.00,0,0,3,3,0.00,2,1,4,25.00,0,0,0,0, 
11874,TUR,5,Ercan Seyma ,OH,0,0,0, ,0,0,0,0,0, ,0,0,0,0, ,0,0,0,0, ,0,0,0,0, ,0,0,0, ,0,0,0,0, 
11874,TUR,6,Caliskan Kubra ,MB,3,3,1,-5.41,7,3,0,4,7,42.86,3,8,9,20,-25.00,1,1,8,10,0.00,0,0,0,0, ,1,0,2,50.00,0,0,2,2,0.00
11874,TUR,7,Baladin Hande ,OH,8,2,0,11.43,10,8,5,5,18,16.67,2,1,3,6,16.67,0,0,11,11,0.00,7,0,13,20,35.00,6,0,7,85.71,0,0,0,0, 
11874,TUR,8,Guveli Yasemin ,MB,0,0,0, ,0,0,0,0,0, ,0,0,0,0, ,0,0,0,0, ,0,0,0,0, ,0,0,0, ,0,0,0,0, 
11874,TUR,9,Ismailoglu Meliha ,OH,11,1,2,23.26,14,11,1,9,21,47.62,1,2,3,6,-16.67,2,1,13,16,6.25,4,3,8,15,6.67,9,1,11,72.73,0,0,2,2,0.00
11874,TUR,10,Aykac Ayca ,L,0,0,0, ,0,0,0,0,0, ,0,0,0,0, ,0,0,0,0, ,6,2,10,18,22.22,19,3,25,64.00,0,0,9,9,0.00
11874,TUR,11,Aydemir Akyol Naz ,S,1,0,2,12.50,3,1,0,2,3,33.33,0,0,4,4,0.00,2,0,15,17,11.76,0,0,0,0, ,11,0,13,84.62,24,1,53,78,29.49
11874,TUR,13,Boz Meryem ,O,0,0,0,-33.33,0,0,1,2,3,-33.33,0,0,0,0, ,0,0,0,0, ,0,0,0,0, ,0,0,0, ,0,0,0,0, 
11874,TUR,14,Erdem DÃ¼ndar Eda ,MB,7,5,1,25.71,13,7,1,3,11,54.55,5,2,8,15,20.00,1,1,7,9,0.00,0,0,1,1,0.00,2,0,2,100.00,0,0,4,4,0.00
11874,TUR,19,Kalac Asli ,MB,0,0,0, ,0,0,0,0,0, ,0,0,0,0, ,0,0,0,0, ,0,0,0,0, ,0,0,0, ,0,0,0,0, 
11874,TUR,99,Karakurt Ebrar ,OH,16,0,1,7.14,17,16,7,19,42,21.43,0,3,2,5,-60.00,1,3,5,9,-22.22,0,0,0,0, ,5,1,8,50.00,0,0,1,1,0.00
11875,POL,1,Nowicka Julia ,S,1,2,1,-6.06,4,1,1,6,8,0.00,2,4,0,6,-33.33,1,1,17,19,0.00,0,0,0,0, ,16,0,17,94.12,36,0,81,117,30.77
11875,POL,3,Alagierska Klaudia ,MB,9,0,0,6.98,9,9,1,4,14,57.14,0,3,4,7,-42.86,0,2,20,22,-9.09,0,0,1,1,0.00,5,2,7,42.86,0,0,1,1,0.00
11875,POL,5,Kakolewska Agnieszka ,MB,3,6,0,6.45,9,3,2,2,7,14.29,6,4,3,13,15.38,0,1,10,11,-9.09,0,0,0,0, ,5,3,11,18.18,0,0,1,1,0.00
11875,POL,8,Stenzel Maria ,L,0,0,0, ,0,0,0,0,0, ,0,0,0,0, ,0,0,0,0, ,14,1,11,26,50.00,10,3,16,43.75,0,0,13,13,0.00
11875,POL,9,Stysiak Magdalena ,O,21,4,1,3.41,26,21,12,27,60,15.00,4,7,5,16,-18.75,1,4,7,12,-25.00,0,0,0,0, ,14,1,16,81.25,0,0,2,2,0.00
11875,POL,11,Lukasik Martyna ,O,10,0,2,4.08,12,10,6,11,27,14.81,0,3,1,4,-75.00,2,1,15,18,5.56,3,1,16,20,10.00,10,0,11,90.91,0,0,3,3,0.00
11875,POL,13,Jagla Monika ,L,0,0,0, ,0,0,0,0,0, ,0,0,0,0, ,0,0,0,0, ,0,0,0,0, ,4,5,9,-11.11,0,0,6,6,0.00
11875,POL,19,Fedusio Monika ,OH,0,0,0, ,0,0,0,0,0, ,0,0,0,0, ,0,0,0,0, ,0,0,0,0, ,0,0,0, ,0,0,0,0, 
11875,POL,20,Czyrnianska Martyna ,OH,0,0,0, ,0,0,0,0,0, ,0,0,0,0, ,0,0,0,0, ,0,0,0,0, ,0,0,0, ,0,0,0,0, 
11875,POL,21,Druzkowska Karolina ,O,0,0,0, ,0,0,0,0,0, ,0,0,0,0, ,0,0,0,0, ,0,0,0,0, ,0,0,0, ,0,0,3,3,0.00
11875,POL,27,Åazowska Martyna ,S,0,0,0,0.00,0,0,0,0,0, ,0,0,0,0, ,0,0,1,1,0.00,0,0,0,0, ,0,0,0, ,0,0,0,0, 
11875,POL,30,Rozanski Olivia ,OH,0,0,0,-66.67,0,0,2,1,3,-66.67,0,0,0,0, ,0,0,0,0, ,0,0,0,0, ,1,0,1,100.00,0,0,0,0, 
11875,POL,78,Gryka Aleksandra ,MB,0,0,0, ,0,0,0,0,0, ,0,0,0,0, ,0,0,0,0, ,0,0,0,0, ,0,0,0, ,0,0,0,0, 
11875,POL,88,Gorecka Zuzanna ,OH,11,0,1,22.45,12,11,0,21,32,34.38,0,1,4,5,-20.00,1,0,11,12,8.33,13,4,24,41,21.95,9,1,12,66.67,0,0,1,1,0.00
11875,DOM,1,Vargas Valdez Annerys Victoria ,MB,5,4,0,6.45,9,5,0,6,11,45.45,4,5,3,12,-8.33,0,2,6,8,-25.00,0,0,0,0, ,4,2,6,33.33,0,0,1,1,0.00
11875,DOM,3,Eve Mejia Lisvel Elisa ,U,0,0,0, ,0,0,0,0,0, ,0,0,0,0, ,0,0,0,0, ,0,0,0,0, ,0,0,0, ,0,0,0,0, 
11875,DOM,5,Castillo Brenda ,L,0,0,0, ,0,0,0,0,0, ,0,0,0,0, ,0,0,0,0, ,6,1,7,14,35.71,26,8,38,47.37,0,0,21,21,0.00
11875,DOM,6,Dominguez Martinez Camil Inmaculada ,S,0,0,0, ,0,0,0,0,0, ,0,0,0,0, ,0,0,0,0, ,0,0,0,0, ,0,0,0, ,0,0,0,0, 
11875,DOM,7,Marte Frica Niverka Dharlenis ,S,1,0,0,-16.67,1,1,0,4,5,20.00,0,3,0,3,-100.00,0,2,14,16,-12.50,0,0,0,0, ,12,3,16,56.25,13,1,97,111,10.81
11875,DOM,11,Rodriguez Marifranchi ,MB,0,0,0,0.00,0,0,0,1,1,0.00,0,0,0,0, ,0,0,0,0, ,0,0,0,0, ,0,0,0, ,0,0,0,0, 
11875,DOM,14,Rivera Brens Prisilla ,OH,11,1,0,11.11,12,11,4,9,24,29.17,1,1,1,3,0.00,0,2,16,18,-11.11,2,3,33,38,-2.63,12,7,20,25.00,0,0,1,1,0.00
11875,DOM,16,PeÃ±a Isabel Yonkaira Paola ,OH,0,0,0,0.00,0,0,0,1,1,0.00,0,0,0,0, ,0,0,6,6,0.00,2,0,6,8,25.00,1,0,3,33.33,0,0,2,2,0.00
11875,DOM,17,Mambru Casilla Gina Altagracia ,O,0,0,0,0.00,0,0,0,0,0, ,0,0,0,0, ,0,0,2,2,0.00,0,0,0,0, ,0,0,0, ,0,0,0,0, 
11875,DOM,18,De La Cruz De PeÃ±a Bethania ,OH,21,2,3,16.05,26,21,9,24,54,22.22,2,3,2,7,-14.29,3,1,16,20,10.00,4,1,20,25,12.00,11,3,14,57.14,0,0,3,3,0.00
11875,DOM,20,Martinez Brayelin Elizabeth ,OH,18,1,2,22.22,21,18,5,23,46,28.26,1,0,4,5,20.00,2,2,8,12,0.00,0,0,1,1,0.00,7,2,10,50.00,0,0,7,7,0.00
11875,DOM,21,Martinez Jineiry ,MB,5,2,1,-4.35,8,5,2,3,10,30.00,2,6,11,19,-21.05,1,2,14,17,-5.88,0,0,0,0, ,3,2,5,20.00,0,0,3,3,0.00
11875,DOM,23,Gonzalez Lopez Gaila Ceneida ,O,0,0,0, ,0,0,0,0,0, ,0,0,0,0, ,0,0,0,0, ,0,0,0,0, ,0,0,0, ,0,0,0,0, 
11875,DOM,25,Martinez Caro Larysmer ,OH,0,0,0, ,0,0,0,0,0, ,0,0,0,0, ,0,0,0,0, ,0,0,0,0, ,0,0,0, ,0,0,0,0, 
11876,NED,1,Knip Kirsten ,L,0,0,0, ,0,0,0,0,0, ,0,0,0,0, ,0,0,0,0, ,0,0,0,0, ,0,0,0, ,0,0,0,0, 
11876,NED,2,Savelkoel Fleur ,OH,0,0,0, ,0,0,0,0,0, ,0,0,0,0, ,0,0,0,0, ,0,0,0,0, ,0,0,0, ,0,0,0,0, 
11876,NED,4,Plak Celeste ,OH,0,0,0,0.00,0,0,0,2,2,0.00,0,0,0,0, ,0,0,1,1,0.00,0,0,0,0, ,2,0,2,100.00,0,0,0,0, 
11876,NED,7,Lohuis Juliet ,MB,9,5,3,17.31,17,9,3,4,16,37.50,5,4,6,15,6.67,3,1,17,21,9.52,0,0,0,0, ,3,2,5,20.00,0,0,2,2,0.00
11876,NED,8,Korevaar Demi ,MB,0,0,0,0.00,0,0,0,0,0, ,0,0,0,0, ,0,0,3,3,0.00,0,0,0,0, ,0,1,1,-100.00,0,0,0,0, 
11876,NED,9,Schoot Myrthe ,L,0,0,0, ,0,0,0,0,0, ,0,0,0,0, ,0,0,0,0, ,6,0,8,14,42.86,21,5,30,53.33,0,0,6,6,0.00
11876,NED,10,van Aalen Sarah ,S,0,0,0, ,0,0,0,0,0, ,0,0,0,0, ,0,0,0,0, ,0,0,0,0, ,0,0,0, ,0,0,0,0, 
11876,NED,11,Buijs Anne ,OH,0,0,0, ,0,0,0,0,0, ,0,0,0,0, ,0,0,0,0, ,0,0,0,0, ,0,0,0, ,0,0,0,0, 
11876,NED,12,Bongaerts Britt ,S,1,2,0,4.17,3,1,0,2,3,33.33,2,2,5,9,0.00,0,0,12,12,0.00,0,0,0,0, ,9,3,13,46.15,28,1,94,123,21.95
11876,NED,16,Baijens Indy ,MB,1,0,0,100.00,1,1,0,0,1,100.00,0,0,0,0, ,0,0,0,0, ,0,0,0,0, ,0,0,0, ,0,0,0,0, 
11876,NED,18,Jasper Marrit ,OH,4,0,1,0.00,5,4,5,15,24,-4.17,0,0,1,1,0.00,1,0,13,14,7.14,8,0,9,17,47.06,15,1,17,82.35,0,0,2,2,0.00
11876,NED,19,Daalderop Nika ,OH,15,3,2,14.49,20,15,5,23,43,23.26,3,3,6,12,0.00,2,2,10,14,0.00,11,2,29,42,21.43,8,0,10,80.00,0,0,0,0, 
11876,NED,23,Timmerman Eline ,MB,6,4,1,-4.65,11,6,2,6,14,28.57,4,9,6,19,-26.32,1,2,7,10,-10.00,0,0,0,0, ,2,0,2,100.00,0,0,1,1,0.00
11876,NED,26,Dambrink Elles ,O,7,0,1,0.00,8,7,4,24,35,8.57,0,3,6,9,-33.33,1,1,15,17,0.00,0,1,0,1,-100.00,8,4,17,23.53,0,0,0,0, 
11876,SRB,2,Lazovic Katarina ,OH,14,0,2,12.96,16,14,6,16,36,22.22,0,0,3,3,0.00,2,3,10,15,-6.67,7,1,27,35,17.14,11,5,21,28.57,0,0,3,3,0.00
11876,SRB,3,Caric Sara ,O,7,0,0,-4.35,7,7,8,20,35,-2.86,0,1,2,3,-33.33,0,0,8,8,0.00,0,0,0,0, ,8,3,14,35.71,0,0,1,1,0.00
11876,SRB,6,Uzelac Aleksandra ,OH,1,0,0,-50.00,1,1,2,0,3,-33.33,0,0,0,0, ,0,1,0,1,-100.00,0,0,0,0, ,1,0,1,100.00,0,0,0,0, 
11876,SRB,7,Jaksic Ana ,S,0,0,0,-33.33,0,0,0,1,1,0.00,0,0,0,0, ,0,1,1,2,-50.00,0,0,0,0, ,2,0,2,100.00,3,0,21,24,12.50
11876,SRB,21,Kocic Jovana ,MB,7,7,0,18.37,14,7,0,7,14,50.00,7,5,10,22,9.09,0,0,13,13,0.00,0,0,2,2,0.00,4,0,5,80.00,0,0,4,4,0.00
11876,SRB,22,Lozo Sara ,O,7,1,0,-2.78,8,7,5,14,26,7.69,1,2,2,5,-20.00,0,2,3,5,-40.00,0,3,13,16,-18.75,3,2,5,20.00,0,0,3,3,0.00
11876,SRB,23,Djordjevic Mila ,S,0,0,0,-8.70,0,0,0,2,2,0.00,0,1,1,2,-50.00,0,1,18,19,-5.26,0,0,0,0, ,12,0,14,85.71,21,2,83,106,17.92
11876,SRB,24,Medic Sofija ,MB,4,3,0,-8.33,7,4,1,4,9,33.33,3,7,7,17,-23.53,0,2,8,10,-20.00,0,0,1,1,0.00,4,0,5,80.00,0,0,2,2,0.00
11876,SRB,26,Savic Vanja ,O,3,0,1,27.27,4,3,1,3,7,28.57,0,0,1,1,0.00,1,0,2,3,33.33,0,0,0,0, ,2,1,3,33.33,0,0,0,0, 
11876,SRB,27,Bukilic Vanja ,O,0,0,0, ,0,0,0,0,0, ,0,0,0,0, ,0,0,0,0, ,0,0,0,0, ,0,0,0, ,0,0,0,0, 
11876,SRB,28,Delic Jelena ,MB,0,0,0, ,0,0,0,0,0, ,0,0,0,0, ,0,0,0,0, ,0,0,0,0, ,0,0,0, ,0,0,0,0, 
11876,SRB,31,Djurdjevic Sanja ,L,0,0,0, ,0,0,0,0,0, ,0,0,0,0, ,0,0,0,0, ,4,4,20,28,0.00,22,2,26,76.92,0,0,9,9,0.00
11876,SRB,32,Gocanin Bojana ,L,0,0,0, ,0,0,0,0,0, ,0,0,0,0, ,0,0,0,0, ,0,0,0,0, ,0,0,0, ,0,0,0,0, 
11876,SRB,34,Mirosavljevic Jovana ,OH,11,0,0,22.58,11,11,2,7,20,45.00,0,1,1,2,-50.00,0,1,8,9,-11.11,3,0,1,4,75.00,6,3,9,33.33,0,0,0,0, 
11877,BRA,2,De Oliveira Saad Gattaz Caroline ,MB,0,0,0, ,0,0,0,0,0, ,0,0,0,0, ,0,0,0,0, ,0,0,0,0, ,0,0,0, ,0,0,0,0, 
11877,BRA,5,Da Silva Adenizia ,MB,0,0,0, ,0,0,0,0,0, ,0,0,0,0, ,0,0,0,0, ,0,0,0,0, ,0,0,0, ,0,0,0,0, 
11877,BRA,6,Alexandre Costa Nunes Nyeme Victoria ,L,0,0,0, ,0,0,0,0,0, ,0,0,0,0, ,0,0,0,0, ,0,0,0,0, ,0,0,0, ,0,0,0,0, 
11877,BRA,7,Montibeller Rosamaria ,OH,15,1,1,23.08,17,15,2,16,33,39.39,1,1,3,5,0.00,1,2,11,14,-7.14,5,0,12,17,29.41,10,5,16,31.25,0,0,1,1,0.00
11877,BRA,8,Silva Carneiro Macris Fernanda ,S,0,0,0,-33.33,0,0,0,0,0, ,0,1,0,1,-100.00,0,0,2,2,0.00,0,0,0,0, ,1,1,2,0.00,9,0,21,30,30.00
11877,BRA,9,Ratzke Roberta Silva ,S,0,0,0,-12.50,0,0,0,1,1,0.00,0,1,3,4,-25.00,0,1,10,11,-9.09,0,0,1,1,0.00,7,3,12,33.33,20,0,63,83,24.10
11877,BRA,10,Braga Guimaraes Gabriela ,OH,7,0,1,5.56,8,7,4,11,22,13.64,0,1,1,2,-50.00,1,1,10,12,0.00,12,0,10,22,54.55,14,1,17,76.47,0,0,2,2,0.00
11877,BRA,11,Caixeta Tandara ,OH,15,2,0,18.97,17,15,4,15,34,32.35,2,2,3,7,0.00,0,0,17,17,0.00,0,0,0,0, ,12,3,16,56.25,0,0,1,1,0.00
11877,BRA,15,Da Silva Ana Carolina ,MB,8,5,1,4.17,14,8,2,4,14,42.86,5,7,2,14,-14.29,1,3,16,20,-10.00,0,1,0,1,-100.00,2,2,4,0.00,0,0,5,5,0.00
11877,BRA,16,Rodrigues Fernanda ,OH,0,0,0, ,0,0,0,0,0, ,0,0,0,0, ,0,0,0,0, ,0,0,0,0, ,0,0,0, ,0,0,0,0, 
11877,BRA,17,Menezes Oliveira de Souza Ana Cristina ,OH,0,0,0,0.00,0,0,0,5,5,0.00,0,0,0,0, ,0,0,3,3,0.00,2,3,2,7,-14.29,0,0,1,0.00,0,0,0,0, 
11877,BRA,18,Brait Camila ,L,0,0,0, ,0,0,0,0,0, ,0,0,0,0, ,0,0,0,0, ,4,1,14,19,15.79,14,1,15,86.67,0,0,2,2,0.00
11877,BRA,20,Correa Ana Beatriz ,MB,6,4,1,0.00,11,6,1,7,14,35.71,4,8,1,13,-30.77,1,2,11,14,-7.14,0,0,1,1,0.00,2,0,3,66.67,0,0,1,1,0.00
11877,BRA,24,Geraldo Teixeira Lorenne ,O,1,0,0,20.00,1,1,0,3,4,25.00,0,0,1,1,0.00,0,0,0,0, ,0,0,0,0, ,1,0,1,100.00,0,0,0,0, 
11877,ITA,2,Bosio Francesca ,S,1,0,2,-13.04,3,1,0,1,2,50.00,0,5,2,7,-71.43,2,1,11,14,7.14,0,0,0,0, ,5,3,10,20.00,24,0,75,99,24.24
11877,ITA,4,Bonifacio Sara ,MB,6,2,0,0.00,8,6,2,1,9,44.44,2,4,6,12,-16.67,0,2,9,11,-18.18,0,0,0,0, ,5,0,5,100.00,0,0,2,2,0.00
11877,ITA,12,Guerra Anastasia ,OH,0,0,0,0.00,0,0,0,1,1,0.00,0,0,0,0, ,0,0,0,0, ,0,0,1,1,0.00,1,0,1,100.00,0,0,0,0, 
11877,ITA,15,Nwakalor Sylvia Chinelo ,O,0,0,0, ,0,0,0,0,0, ,0,0,0,0, ,0,0,0,0, ,0,0,0,0, ,0,0,0, ,0,0,0,0, 
11877,ITA,19,Mingardi Camilla ,OH,11,2,0,0.00,13,11,10,20,41,2.44,2,2,3,7,0.00,0,1,13,14,-7.14,0,0,0,0, ,14,5,23,39.13,0,0,3,3,0.00
11877,ITA,21,Lubian Marina ,MB,7,0,3,2.33,10,7,1,7,15,40.00,0,6,7,13,-46.15,3,2,10,15,6.67,0,0,0,0, ,2,0,2,100.00,0,0,3,3,0.00
11877,ITA,23,De Bortoli Chiara ,L,0,0,0, ,0,0,0,0,0, ,0,0,0,0, ,0,0,0,0, ,6,1,18,25,20.00,17,7,25,40.00,0,0,14,14,0.00
11877,ITA,24,Mazzaro Alessia ,MB,0,0,0, ,0,0,0,0,0, ,0,0,0,0, ,0,0,0,0, ,0,0,0,0, ,0,0,0, ,0,0,0,0, 
11877,ITA,26,Battistoni Ilaria ,S,0,0,0, ,0,0,0,0,0, ,0,0,0,0, ,0,0,0,0, ,0,0,0,0, ,0,0,0, ,1,0,7,8,12.50
11877,ITA,27,Furlan Eleonora ,MB,0,0,0,0.00,0,0,0,0,0, ,0,0,0,0, ,0,0,1,1,0.00,0,0,0,0, ,0,1,1,-100.00,0,0,0,0, 
11877,ITA,28,Melli Giulia ,OH,18,1,0,13.21,19,18,10,14,42,19.05,1,0,0,1,100.00,0,2,8,10,-20.00,4,1,20,25,12.00,2,4,8,-25.00,0,0,1,1,0.00
11877,ITA,29,D'Odorico Sofia ,OH,7,0,0,-2.33,7,7,4,17,28,10.71,0,1,1,2,-50.00,0,3,10,13,-23.08,5,1,18,24,16.67,6,4,11,18.18,0,0,3,3,0.00
11877,ITA,31,Fersino Eleonora ,L,0,0,0, ,0,0,0,0,0, ,0,0,0,0, ,0,0,0,0, ,3,1,3,7,28.57,2,0,3,66.67,0,0,1,1,0.00
11877,ITA,32,Omoruyi Oghosasere Loveth ,OH,0,0,0,0.00,0,0,0,0,0, ,0,0,0,0, ,0,0,1,1,0.00,1,0,1,2,50.00,1,0,3,33.33,0,0,0,0, 
11724,GER,1,Fromm Christian ,OH,0,0,0, ,0,0,0,0,0, ,0,0,0,0, ,0,0,0,0, ,0,0,0,0, ,0,0,0, ,0,0,0,0, 
11724,GER,3,Schott Ruben ,OH,6,1,1,-10.00,8,6,2,10,18,22.22,1,6,6,13,-38.46,1,5,13,19,-21.05,15,1,15,31,45.16,5,3,9,22.22,0,0,8,8,0.00
11724,GER,5,Reichert Moritz ,OH,9,0,0,4.88,9,9,3,8,20,30.00,0,2,0,2,-100.00,0,2,17,19,-10.53,11,1,15,27,37.04,3,1,5,40.00,0,1,3,4,-25.00
11724,GER,6,Kaliberda Denys ,OH,0,0,0, ,0,0,0,0,0, ,0,0,0,0, ,0,0,0,0, ,0,0,0,0, ,0,0,0, ,0,0,0,0, 
11724,GER,7,Sossenheimer David ,OH,3,1,0,8.33,4,3,1,1,5,40.00,1,1,0,2,0.00,0,1,4,5,-20.00,0,0,2,2,0.00,0,0,1,0.00,0,0,0,0, 
11724,GER,8,BÃ¶hme Marcus ,MB,4,1,0,-7.69,5,4,0,2,6,66.67,1,7,4,12,-50.00,0,0,8,8,0.00,0,0,0,0, ,0,0,1,0.00,0,0,0,0, 
11724,GER,10,Zenger Julian ,L,0,0,0, ,0,0,0,0,0, ,0,0,0,0, ,0,0,0,0, ,6,0,13,19,31.58,8,5,15,20.00,0,0,5,5,0.00
11724,GER,13,Hirsch Simon ,O,6,2,0,18.18,8,6,1,5,12,41.67,2,1,1,4,25.00,0,2,4,6,-33.33,0,0,0,0, ,0,0,0, ,0,0,0,0, 
11724,GER,16,BurggrÃ¤f Eric ,S,0,0,0,0.00,0,0,0,0,0, ,0,0,0,0, ,0,0,3,3,0.00,0,0,0,0, ,1,0,1,100.00,0,0,0,0, 
11724,GER,17,Zimmermann Jan ,S,0,2,1,-4.35,3,0,0,1,1,0.00,2,2,2,6,0.00,1,2,13,16,-6.25,0,0,0,0, ,9,5,15,26.67,19,1,75,95,18.95
11724,GER,18,Krage Florian ,MB,2,0,1,20.00,3,2,0,1,3,66.67,0,1,0,1,-100.00,1,0,5,6,16.67,0,0,0,0, ,0,0,1,0.00,0,0,0,0, 
11724,GER,19,RÃ¶hrs Erik ,OH,0,0,0, ,0,0,0,0,0, ,0,0,0,0, ,0,0,0,0, ,0,0,0,0, ,0,0,0, ,0,0,0,0, 
11724,GER,20,Weber Linus ,O,13,0,1,8.70,14,13,4,10,27,33.33,0,3,3,6,-50.00,1,3,9,13,-15.38,0,0,0,0, ,1,1,2,0.00,0,0,0,0, 
11724,GER,21,Krick Tobias ,MB,13,2,0,14.63,15,13,0,4,17,76.47,2,6,6,14,-28.57,0,3,7,10,-30.00,0,0,0,0, ,4,0,4,100.00,0,0,0,0, 
11724,ARG,2,Pereyra Federico ,O,20,1,1,20.00,22,20,4,9,33,48.48,1,2,1,4,-25.00,1,5,12,18,-22.22,0,0,0,0, ,6,1,7,71.43,0,0,0,0, 
11724,ARG,3,Martinez Franchi Jan ,OH,18,1,0,18.52,19,18,2,12,32,50.00,1,4,0,5,-60.00,0,3,14,17,-17.65,6,1,16,23,21.74,10,0,10,100.00,0,0,0,0, 
11724,ARG,5,Uriarte Nicolas ,S,0,0,0,0.00,0,0,0,0,0, ,0,0,0,0, ,0,0,3,3,0.00,0,0,0,0, ,1,1,2,0.00,2,1,4,7,14.29
11724,ARG,6,Poglajen Cristian ,OH,0,0,0, ,0,0,0,0,0, ,0,0,0,0, ,0,0,0,0, ,0,0,0,0, ,0,0,0, ,0,0,0,0, 
11724,ARG,7,Conte Facundo ,OH,0,0,0, ,0,0,0,0,0, ,0,0,0,0, ,0,0,0,0, ,0,0,0,0, ,0,0,0, ,0,0,0,0, 
11724,ARG,8,Loser Agustin ,MB,9,1,0,-11.90,10,9,2,3,14,50.00,1,8,3,12,-58.33,0,5,11,16,-31.25,1,0,0,1,100.00,4,0,4,100.00,0,0,1,1,0.00
11724,ARG,11,SolÃ© Sebastian ,MB,11,2,0,0.00,13,11,1,2,14,71.43,2,7,4,13,-38.46,0,5,12,17,-29.41,2,0,0,2,100.00,5,1,6,66.67,0,0,0,0, 
11724,ARG,13,Palacios Ezequiel ,OH,0,0,0,-66.67,0,0,2,1,3,-66.67,0,0,0,0, ,0,0,0,0, ,0,0,0,0, ,1,0,1,100.00,0,0,0,0, 
11724,ARG,14,Crer Pablo ,MB,0,0,0, ,0,0,0,0,0, ,0,0,0,0, ,0,0,0,0, ,0,0,0,0, ,0,0,0, ,0,0,0,0, 
11724,ARG,15,De Cecco Luciano ,S,3,0,1,-10.71,4,3,1,2,6,33.33,0,2,4,6,-33.33,1,4,11,16,-18.75,0,0,0,0, ,6,3,9,33.33,35,1,82,118,28.81
11724,ARG,16,Palonsky Luciano ,OH,1,0,0,0.00,1,1,0,2,3,33.33,0,0,0,0, ,0,1,1,2,-50.00,0,0,0,0, ,0,0,0, ,0,0,0,0, 
11724,ARG,17,Mendez Nicolas ,OH,8,3,0,3.85,11,8,5,17,30,10.00,3,1,2,6,33.33,0,3,13,16,-18.75,11,2,20,33,27.27,6,4,13,15.38,0,0,4,4,0.00
11724,ARG,18,Ramos Martin ,MB,0,0,0, ,0,0,0,0,0, ,0,0,0,0, ,0,0,0,0, ,0,0,0,0, ,0,0,0, ,0,0,0,0, 
11724,ARG,19,Massimino Franco ,L,0,0,0, ,0,0,0,0,0, ,0,0,0,0, ,0,0,0,0, ,13,1,14,28,42.86,12,2,16,62.50,0,0,2,2,0.00
11725,IRI,2,Ebadipour Ghara H. Milad ,OH,11,1,0,-2.22,12,11,5,7,23,26.09,1,5,0,6,-66.67,0,3,13,16,-18.75,7,1,16,24,25.00,10,3,13,53.85,0,0,0,0, 
11725,IRI,4,Marouflakrani Mir Saeid ,S,1,0,0,-7.14,1,1,0,0,1,100.00,0,1,1,2,-50.00,0,1,10,11,-9.09,0,0,0,0, ,6,3,10,30.00,35,1,49,85,40.00
11725,IRI,6,Mousavi Eraghi Seyed Mohammad ,MB,9,6,1,6.82,16,9,1,2,12,66.67,6,7,6,19,-5.26,1,5,7,13,-30.77,0,0,1,1,0.00,0,1,3,-33.33,0,0,3,3,0.00
11725,IRI,7,Fayazi D. Purya ,OH,0,0,0, ,0,0,0,0,0, ,0,0,0,0, ,0,0,0,0, ,0,0,0,0, ,0,0,0, ,0,0,0,0, 
11725,IRI,8,Hazratpourtalatappeh Mohammadreza ,L,0,0,0, ,0,0,0,0,0, ,0,0,0,0, ,0,0,0,0, ,8,0,8,16,50.00,1,3,5,-40.00,0,0,4,4,0.00
11725,IRI,9,Gholami Masoud ,MB,8,4,0,18.92,12,8,0,2,10,80.00,4,5,3,12,-8.33,0,0,15,15,0.00,0,0,0,0, ,2,1,4,25.00,0,0,3,3,0.00
11725,IRI,11,Kazemi Saber ,O,15,2,0,9.80,17,15,6,11,32,28.12,2,2,1,5,0.00,0,4,10,14,-28.57,0,1,0,1,-100.00,7,2,10,50.00,0,0,1,1,0.00
11725,IRI,15,Mojarad Aliasghar ,MB,0,0,0, ,0,0,0,0,0, ,0,0,0,0, ,0,0,0,0, ,0,0,0,0, ,0,0,0, ,0,0,0,0, 
11725,IRI,16,Shafiei Ali ,MB,0,0,0, ,0,0,0,0,0, ,0,0,0,0, ,0,0,0,0, ,0,0,0,0, ,0,0,0, ,0,0,0,0, 
11725,IRI,17,Salehi Meisam ,OH,9,1,4,12.50,14,9,2,5,16,43.75,1,2,2,5,-20.00,4,5,10,19,-5.26,10,1,23,34,26.47,3,1,4,50.00,0,0,1,1,0.00
11725,IRI,18,Vadi Mohammad Taher ,S,0,0,0, ,0,0,0,0,0, ,0,0,0,0, ,0,0,0,0, ,0,0,0,0, ,0,0,0, ,0,0,0,0, 
11725,IRI,21,Salehi Arman ,L,0,0,0, ,0,0,0,0,0, ,0,0,0,0, ,0,0,0,0, ,0,0,0,0, ,0,0,0, ,0,0,0,0, 
11725,IRI,22,Esfandiar Amirhossein ,OH,0,0,1,-12.50,1,0,0,0,0, ,0,0,0,0, ,1,2,5,8,-12.50,0,0,0,0, ,0,0,0, ,0,0,1,1,0.00
11725,IRI,23,Saadat Bardia ,O,2,0,0,100.00,2,2,0,0,2,100.00,0,0,0,0, ,0,0,0,0, ,0,0,0,0, ,0,0,0, ,0,0,0,0, 
11725,CAN,1,Sanders Tyler ,S,0,0,0,-25.00,0,0,0,0,0, ,0,1,0,1,-100.00,0,0,3,3,0.00,0,0,0,0, ,1,2,3,-33.33,12,1,18,31,35.48
11725,CAN,2,Perrin John Gordon ,OH,13,3,0,9.62,16,13,3,8,24,41.67,3,5,1,9,-22.22,0,3,16,19,-15.79,5,1,18,24,16.67,3,2,6,16.67,0,0,5,5,0.00
11725,CAN,3,Marshall Steven ,OH,0,0,0,-26.67,0,0,2,2,4,-50.00,0,1,1,2,-50.00,0,1,8,9,-11.11,1,0,5,6,16.67,3,0,4,75.00,0,0,0,0, 
11725,CAN,4,Hoag Nicholas ,OH,0,0,0,-20.00,0,0,0,0,0, ,0,0,0,0, ,0,1,4,5,-20.00,0,0,0,0, ,0,0,0, ,0,0,1,1,0.00
11725,CAN,6,Pereira Jordan ,OH,0,0,0, ,0,0,0,0,0, ,0,0,0,0, ,0,0,0,0, ,0,0,0,0, ,0,0,0, ,0,0,0,0, 
11725,CAN,8,Blankenau Jay ,S,2,0,0,-7.69,2,2,0,1,3,66.67,0,1,0,1,-100.00,0,2,7,9,-22.22,0,0,1,1,0.00,6,1,7,71.43,25,0,28,53,47.17
11725,CAN,10,Sclater Ryan Joseph ,O,16,0,1,1.67,17,16,7,14,37,24.32,0,6,5,11,-54.55,1,3,8,12,-16.67,0,0,1,1,0.00,8,2,10,60.00,0,0,0,0, 
11725,CAN,11,Jansen Vandoorn Daniel ,MB,0,0,0, ,0,0,0,0,0, ,0,0,0,0, ,0,0,0,0, ,0,0,0,0, ,0,0,0, ,0,0,0,0, 
11725,CAN,12,Van Berkel Lucas ,MB,7,2,0,9.09,9,7,1,2,10,60.00,2,5,5,12,-25.00,0,0,11,11,0.00,0,1,4,5,-20.00,4,2,6,33.33,0,0,3,3,0.00
11725,CAN,13,Vernon-Evans Sharone ,O,1,0,0,-40.00,1,1,1,1,3,0.00,0,0,0,0, ,0,2,0,2,-100.00,0,0,0,0, ,0,0,0, ,0,0,0,0, 
11725,CAN,14,Loeppky Eric ,OH,5,0,1,-4.17,6,5,3,5,13,15.38,0,2,1,3,-66.67,1,2,5,8,-12.50,3,3,8,14,0.00,1,1,2,0.00,0,0,1,1,0.00
11725,CAN,19,Bann Blair Cameron ,L,0,0,0, ,0,0,0,0,0, ,0,0,0,0, ,0,0,0,0, ,10,1,14,25,36.00,8,3,11,45.45,0,0,7,7,0.00
11725,CAN,20,Szwarc Arthur ,O,7,2,1,5.56,10,7,2,4,13,38.46,2,4,3,9,-22.22,1,2,11,14,-7.14,0,0,0,0, ,2,2,4,0.00,0,0,1,1,0.00
11725,CAN,23,Demyanenko Danny ,MB,0,0,0, ,0,0,0,0,0, ,0,0,0,0, ,0,0,0,0, ,0,0,0,0, ,0,0,0, ,0,0,0,0, 
11726,JPN,1,Shimizu Kunihiro ,O,12,1,0,25.81,13,12,3,6,21,42.86,1,2,0,3,-33.33,0,0,7,7,0.00,2,0,1,3,66.67,0,3,4,-75.00,0,1,1,2,-50.00
11726,JPN,2,Onodera Taishi ,MB,4,3,0,3.57,7,4,0,3,7,57.14,3,4,0,7,-14.29,0,2,12,14,-14.29,0,0,0,0, ,1,0,1,100.00,0,0,1,1,0.00
11726,JPN,3,Fujii Naonobu ,S,1,1,1,25.00,3,1,0,0,1,100.00,1,0,0,1,100.00,1,0,9,10,10.00,0,0,0,0, ,4,2,6,33.33,13,0,32,45,28.89
11726,JPN,4,Otake Issei ,O,8,0,1,-6.67,9,8,6,5,19,10.53,0,2,2,4,-50.00,1,3,3,7,-28.57,0,0,0,0, ,1,1,3,0.00,0,1,0,1,-100.00
11726,JPN,5,Fukuzawa Tatsuya ,OH,0,0,0, ,0,0,0,0,0, ,0,0,0,0, ,0,0,0,0, ,0,0,0,0, ,0,0,0, ,0,0,0,0, 
11726,JPN,6,Yamauchi Akihiro ,MB,6,1,0,14.29,7,6,0,2,8,75.00,1,2,0,3,-33.33,0,2,8,10,-20.00,0,0,0,0, ,2,1,3,33.33,0,0,0,0, 
11726,JPN,12,Sekita Masahiro ,S,0,0,0,0.00,0,0,0,2,2,0.00,0,0,0,0, ,0,0,5,5,0.00,0,0,0,0, ,1,1,2,0.00,9,1,41,51,15.69
11726,JPN,15,Ri Haku ,MB,0,0,0, ,0,0,0,0,0, ,0,0,0,0, ,0,0,0,0, ,0,0,0,0, ,0,0,0, ,0,0,0,0, 
11726,JPN,16,Takahashi Kentaro ,MB,1,0,0,0.00,1,1,0,2,3,33.33,0,1,0,1,-100.00,0,0,3,3,0.00,0,0,1,1,0.00,0,1,1,-100.00,0,0,0,0, 
11726,JPN,17,Takanashi Kenta ,OH,12,0,0,9.52,12,12,6,8,26,23.08,0,1,0,1,-100.00,0,1,14,15,-6.67,14,0,7,21,66.67,5,4,9,11.11,0,0,4,4,0.00
11726,JPN,19,Otsuka Tatsunori ,OH,4,1,0,10.53,5,4,2,7,13,15.38,1,1,0,2,0.00,0,0,4,4,0.00,5,0,11,16,31.25,1,2,3,-33.33,0,0,0,0, 
11726,JPN,20,Yamamoto Tomohiro ,L,0,0,0, ,0,0,0,0,0, ,0,0,0,0, ,0,0,0,0, ,7,1,8,16,37.50,11,5,16,37.50,0,0,3,3,0.00
11726,JPN,21,Takahashi Ran ,OH,6,0,0,0.00,6,6,3,6,15,20.00,0,0,0,0, ,0,3,6,9,-33.33,9,0,11,20,45.00,3,4,7,-14.29,0,0,5,5,0.00
11726,JPN,24,Ogawa Tomohiro ,L,0,0,0, ,0,0,0,0,0, ,0,0,0,0, ,0,0,0,0, ,0,0,0,0, ,0,0,0, ,0,0,0,0, 
11726,SRB,2,Kovacevic Uros ,OH,19,3,0,38.46,22,19,1,11,31,58.06,3,1,1,5,40.00,0,0,16,16,0.00,11,0,14,25,44.00,2,5,8,-37.50,0,0,3,3,0.00
11726,SRB,3,Kapur Milorad ,L,0,0,0, ,0,0,0,0,0, ,0,0,0,0, ,0,0,0,0, ,0,0,0,0, ,0,0,0, ,0,0,0,0, 
11726,SRB,6,Pekovic Nikola ,L,0,0,0, ,0,0,0,0,0, ,0,0,0,0, ,0,0,0,0, ,3,0,7,10,30.00,3,7,10,-40.00,0,0,2,2,0.00
11726,SRB,7,Krsmanovic Petar ,MB,10,4,0,11.90,14,10,2,4,16,50.00,4,5,1,10,-10.00,0,2,14,16,-12.50,0,0,1,1,0.00,1,0,1,100.00,0,0,1,1,0.00
11726,SRB,8,Ivovic Marko ,OH,11,2,1,7.89,14,11,3,2,16,50.00,2,4,1,7,-28.57,1,4,10,15,-20.00,20,2,14,36,50.00,4,2,6,33.33,0,0,4,4,0.00
11726,SRB,9,Jovovic Nikola ,S,2,2,0,8.33,4,2,0,0,2,100.00,2,2,0,4,0.00,0,0,18,18,0.00,0,0,1,1,0.00,5,2,7,42.86,34,0,48,82,41.46
11726,SRB,10,KujundÅ¾iÄ Miran ,OH,0,0,0, ,0,0,0,0,0, ,0,0,0,0, ,0,0,0,0, ,0,0,0,0, ,0,0,0, ,0,0,0,0, 
11726,SRB,12,Peric Pavle ,OH,0,0,0, ,0,0,0,0,0, ,0,0,0,0, ,0,0,0,0, ,0,0,0,0, ,0,0,0, ,0,0,0,0, 
11726,SRB,13,Simic Stevan ,MB,0,0,0, ,0,0,0,0,0, ,0,0,0,0, ,0,0,0,0, ,0,0,0,0, ,0,0,0, ,0,0,0,0, 
11726,SRB,14,Atanasijevic Aleksandar ,O,7,1,0,-7.69,8,7,4,7,18,16.67,1,3,4,8,-25.00,0,4,9,13,-30.77,0,0,0,0, ,2,0,2,100.00,0,0,2,2,0.00
11726,SRB,16,Luburic Drazen ,O,0,1,0,-30.00,1,0,0,5,5,0.00,1,2,0,3,-33.33,0,2,0,2,-100.00,0,0,0,0, ,0,0,0, ,0,0,3,3,0.00
11726,SRB,18,Podrascanin Marko ,MB,9,4,0,19.35,13,9,1,1,11,72.73,4,3,1,8,12.50,0,3,9,12,-25.00,0,0,0,0, ,1,1,2,0.00,0,0,1,1,0.00
11726,SRB,21,Todorovic Vuk ,S,0,0,0,-100.00,0,0,0,0,0, ,0,1,0,1,-100.00,0,0,0,0, ,0,0,0,0, ,0,0,0, ,1,0,2,3,33.33
11726,SRB,26,Kovac Davide ,OH,0,0,0, ,0,0,0,0,0, ,0,0,0,0, ,0,0,0,0, ,0,0,0,0, ,0,0,0, ,0,0,0,0, 
11727,BRA,1,Rezende Bruno Mossa ,S,0,1,0,-15.79,1,0,0,0,0, ,1,3,5,9,-22.22,0,1,9,10,-10.00,0,0,0,0, ,5,3,9,22.22,37,0,48,85,43.53
11727,BRA,5,Borges Almeida Silva Mauricio ,OH,0,0,0, ,0,0,0,0,0, ,0,0,0,0, ,0,0,0,0, ,0,0,1,1,0.00,0,0,0, ,0,0,0,0, 
11727,BRA,6,Gil Kreling Fernando ,S,0,0,0,0.00,0,0,0,0,0, ,0,0,0,0, ,0,0,1,1,0.00,0,0,0,0, ,1,0,1,100.00,2,0,5,7,28.57
11727,BRA,8,De Souza Wallace ,O,5,0,1,-4.17,6,5,5,3,13,0.00,0,1,0,1,-100.00,1,1,8,10,0.00,0,0,1,1,0.00,1,2,3,-33.33,0,0,2,2,0.00
11727,BRA,9,Leal Hidalgo Yoandy ,OH,11,1,0,24.24,12,11,2,8,21,42.86,1,1,1,3,0.00,0,1,8,9,-11.11,4,1,16,21,14.29,1,0,1,100.00,0,0,0,0, 
11727,BRA,10,Bispo dos Santos Matheus ,MB,2,0,0,0.00,2,2,2,0,4,0.00,0,0,0,0, ,0,0,3,3,0.00,0,1,0,1,-100.00,0,0,1,0.00,0,0,0,0, 
11727,BRA,11,Kavalkievicz Gabriel ,OH,0,0,0, ,0,0,0,0,0, ,0,0,0,0, ,0,0,0,0, ,0,0,0,0, ,0,0,0, ,0,0,0,0, 
11727,BRA,12,Santos Isac ,MB,5,3,2,-5.13,10,5,1,4,10,40.00,3,7,4,14,-28.57,2,4,9,15,-13.33,0,0,0,0, ,3,1,6,33.33,0,0,0,0, 
11727,BRA,14,Correia De Souza Douglas ,OH,6,0,0,25.00,6,6,2,0,8,50.00,0,0,1,1,0.00,0,1,2,3,-33.33,1,0,3,4,25.00,1,0,2,50.00,0,0,2,2,0.00
11727,BRA,15,Nascimento Maique Reis ,L,0,0,0, ,0,0,0,0,0, ,0,0,0,0, ,0,0,0,0, ,0,0,0,0, ,0,0,0, ,0,0,0,0, 
11727,BRA,17,Hoss Thales ,L,0,0,0, ,0,0,0,0,0, ,0,0,0,0, ,0,0,0,0, ,8,1,9,18,38.89,9,4,16,31.25,0,0,3,3,0.00
11727,BRA,18,Souza Ricardo Lucarelli ,OH,11,0,1,-6.00,12,11,5,9,25,24.00,0,4,4,8,-50.00,1,6,10,17,-29.41,10,0,18,28,35.71,7,2,10,50.00,0,0,0,0, 
11727,BRA,21,Souza Alan ,O,9,0,0,13.64,9,9,1,2,12,66.67,0,4,1,5,-80.00,0,1,4,5,-20.00,0,0,0,0, ,2,1,5,20.00,0,0,0,0, 
11727,BRA,23,Resende Gualberto Flavio ,MB,0,0,0,-27.59,0,0,2,5,7,-28.57,0,6,5,11,-54.55,0,0,11,11,0.00,0,0,1,1,0.00,3,0,3,100.00,0,0,0,0, 
11727,FRA,1,Chinenyeze BarthÃ©lÃ©my ,MB,6,1,0,-11.11,7,6,1,4,11,45.45,1,9,4,14,-57.14,0,1,10,11,-9.09,1,0,1,2,50.00,4,0,4,100.00,0,0,2,2,0.00
11727,FRA,2,Grebennikov Jenia ,L,0,0,0, ,0,0,0,0,0, ,0,0,0,0, ,0,0,0,0, ,7,1,14,22,27.27,13,6,22,31.82,0,0,4,4,0.00
11727,FRA,4,Patry Jean ,O,20,0,0,15.00,20,20,4,15,39,41.03,0,4,0,4,-100.00,0,3,14,17,-17.65,0,0,0,0, ,5,0,5,100.00,0,0,0,0, 
11727,FRA,6,Toniutti Benjamin ,S,0,1,0,-16.67,1,0,0,0,0, ,1,3,3,7,-28.57,0,1,10,11,-9.09,0,0,0,0, ,5,1,6,66.67,34,0,52,86,39.53
11727,FRA,7,Tillie Kevin ,OH,12,0,1,9.09,13,12,3,7,22,40.91,0,2,1,3,-66.67,1,4,14,19,-15.79,4,1,10,15,20.00,5,5,12,0.00,0,0,4,4,0.00
11727,FRA,9,Ngapeth Earvin ,OH,11,0,1,-2.44,12,11,1,12,24,41.67,0,5,0,5,-100.00,1,7,4,12,-50.00,6,2,15,23,17.39,6,1,8,62.50,0,0,5,5,0.00
11727,FRA,12,Boyer Stephen ,O,0,0,0, ,0,0,0,0,0, ,0,0,0,0, ,0,0,0,0, ,0,0,0,0, ,0,0,0, ,0,0,0,0, 
11727,FRA,14,Le Goff Nicolas ,MB,2,4,1,-3.03,7,2,1,1,4,25.00,4,6,4,14,-14.29,1,1,13,15,0.00,0,0,0,0, ,1,2,3,-33.33,0,0,2,2,0.00
11727,FRA,16,Bultor Daryl ,MB,0,0,0, ,0,0,0,0,0, ,0,0,0,0, ,0,0,0,0, ,0,0,0,0, ,0,0,0, ,0,0,0,0, 
11727,FRA,17,Clevenot Trevor ,OH,3,0,0,33.33,3,3,0,2,5,60.00,0,0,1,1,0.00,0,0,3,3,0.00,4,0,3,7,57.14,0,1,2,-50.00,0,0,0,0, 
11727,FRA,18,Rossard Thibault ,OH,0,0,0,-20.00,0,0,0,0,0, ,0,0,0,0, ,0,1,4,5,-20.00,0,0,0,0, ,2,0,2,100.00,0,0,0,0, 
11727,FRA,20,Diez Benjamin ,L,0,0,0, ,0,0,0,0,0, ,0,0,0,0, ,0,0,0,0, ,0,0,0,0, ,0,0,0, ,0,0,0,0, 
11727,FRA,23,Meyer LÃ©o ,S,0,0,0, ,0,0,0,0,0, ,0,0,0,0, ,0,0,0,0, ,0,0,0,0, ,0,0,0, ,0,0,0,0, 
11727,FRA,24,Gueye Mousse ,MB,0,0,0, ,0,0,0,0,0, ,0,0,0,0, ,0,0,0,0, ,0,0,0,0, ,0,0,0, ,0,0,0,0, 
11728,NED,2,Keemink Wessel ,S,0,1,0,-18.18,1,0,0,1,1,0.00,1,3,0,4,-50.00,0,0,6,6,0.00,0,1,1,2,-50.00,4,1,5,60.00,7,0,45,52,13.46
11728,NED,5,van der Ent Luuc ,MB,1,0,0,-44.44,1,1,0,2,3,33.33,0,3,0,3,-100.00,0,2,1,3,-66.67,0,0,0,0, ,0,0,0, ,0,0,0,0, 
11728,NED,6,Dronkers Just ,L,0,0,0, ,0,0,0,0,0, ,0,0,0,0, ,0,0,0,0, ,7,4,11,22,13.64,5,1,6,66.67,0,0,10,10,0.00
11728,NED,7,Jorna Gijs ,OH,0,0,0,-33.33,0,0,1,1,2,-50.00,0,0,0,0, ,0,0,1,1,0.00,0,0,2,2,0.00,0,0,0, ,0,0,0,0, 
11728,NED,8,Plak Fabian ,MB,2,0,0,-14.29,2,2,0,6,8,25.00,0,2,4,6,-33.33,0,3,4,7,-42.86,0,0,1,1,0.00,2,0,2,100.00,0,0,1,1,0.00
11728,NED,10,van Zeist Maikel ,MB,0,0,0, ,0,0,0,0,0, ,0,0,0,0, ,0,0,0,0, ,0,0,0,0, ,0,0,0, ,0,0,0,0, 
11728,NED,12,Tuinstra Bennie Junior ,OH,4,0,0,-5.88,4,4,1,4,9,33.33,0,1,0,1,-100.00,0,3,4,7,-42.86,2,0,11,13,15.38,0,1,1,-100.00,0,0,0,0, 
11728,NED,13,Ottevanger Steven ,L,0,0,0, ,0,0,0,0,0, ,0,0,0,0, ,0,0,0,0, ,0,0,0,0, ,0,0,0, ,0,0,0,0, 
11728,NED,14,Abdel-Aziz Nimir ,O,14,0,1,6.82,15,14,7,9,30,23.33,0,2,1,3,-66.67,1,3,7,11,-18.18,0,0,0,0, ,5,1,6,66.67,0,0,1,1,0.00
11728,NED,15,van Solkema Gijs ,S,0,0,0,0.00,0,0,0,0,0, ,0,0,0,0, ,0,0,1,1,0.00,0,0,0,0, ,1,0,1,100.00,0,1,7,8,-12.50
11728,NED,18,Andringa Robbert ,L,4,1,2,4.17,7,4,3,3,10,10.00,1,1,3,5,0.00,2,2,5,9,0.00,9,0,7,16,56.25,2,0,2,100.00,0,0,4,4,0.00
11728,NED,21,van Schie Stijn ,OH,2,1,0,9.09,3,2,2,3,7,0.00,1,0,1,2,50.00,0,0,2,2,0.00,1,1,3,5,0.00,1,1,2,0.00,0,0,0,0, 
11728,NED,22,Wiltenburg Twan ,MB,1,1,0,-10.00,2,1,1,1,3,0.00,1,2,1,4,-25.00,0,0,3,3,0.00,0,0,2,2,0.00,1,0,1,100.00,0,0,0,0, 
11728,NED,25,van Tilburg Stijn ,OH,0,0,0,-40.00,0,0,1,1,2,-50.00,0,1,0,1,-100.00,0,0,2,2,0.00,0,0,0,0, ,0,0,0, ,0,0,1,1,0.00
11728,SLO,1,Å tern TonÄek ,O,10,1,1,13.16,12,10,3,4,17,41.18,1,2,3,6,-16.67,1,2,12,15,-6.67,0,0,0,0, ,5,1,7,57.14,0,0,1,1,0.00
11728,SLO,2,Pajenk Alen ,MB,3,2,0,9.52,5,3,0,1,4,75.00,2,1,2,5,20.00,0,2,10,12,-16.67,0,0,0,0, ,2,1,3,33.33,0,0,2,2,0.00
11728,SLO,3,PernuÅ¡ Gregor ,S,0,1,0,0.00,1,0,0,0,0, ,1,0,0,1,100.00,0,1,0,1,-100.00,0,0,0,0, ,0,1,1,-100.00,0,0,8,8,0.00
11728,SLO,4,Kozamernik Jan ,MB,3,1,0,4.55,4,3,0,2,5,60.00,1,3,4,8,-25.00,0,0,9,9,0.00,0,0,0,0, ,0,0,0, ,0,0,1,1,0.00
11728,SLO,5,Å ket Alen ,O,0,0,0, ,0,0,0,0,0, ,0,0,0,0, ,0,0,0,0, ,0,0,0,0, ,0,0,0, ,0,0,0,0, 
11728,SLO,6,Gasparini Mitja ,O,0,0,0, ,0,0,0,0,0, ,0,0,0,0, ,0,0,0,0, ,0,0,0,0, ,0,0,0, ,0,0,0,0, 
11728,SLO,11,Å tern Å½iga ,OH,0,0,0, ,0,0,0,0,0, ,0,0,0,0, ,0,0,0,0, ,0,0,0,0, ,0,0,0, ,0,0,0,0, 
11728,SLO,12,Klobucar Jan ,L,0,0,0, ,0,0,0,0,0, ,0,0,0,0, ,0,0,0,0, ,0,0,0,0, ,0,0,0, ,0,0,0,0, 
11728,SLO,13,KovaÄiÄ Jani ,L,0,0,0, ,0,0,0,0,0, ,0,0,0,0, ,0,0,0,0, ,9,0,2,11,81.82,7,1,8,75.00,0,0,2,2,0.00
11728,SLO,15,VideÄnik Matic ,MB,1,0,0,12.50,1,1,0,1,2,50.00,0,0,2,2,0.00,0,0,4,4,0.00,0,0,0,0, ,1,0,1,100.00,0,0,0,0, 
11728,SLO,16,Ropret Gregor ,S,0,1,3,7.69,4,0,0,0,0, ,1,2,0,3,-33.33,3,1,6,10,20.00,0,0,1,1,0.00,9,2,13,53.85,11,1,37,49,20.41
11728,SLO,17,Urnaut Tine ,OH,8,0,1,10.00,9,8,0,6,14,57.14,0,3,0,3,-100.00,1,3,9,13,-15.38,7,2,12,21,23.81,3,0,4,75.00,0,0,7,7,0.00
11728,SLO,18,Äebulj Klemen ,OH,0,0,0, ,0,0,0,0,0, ,0,0,0,0, ,0,0,0,0, ,0,0,0,0, ,0,0,0, ,0,0,0,0, 
11728,SLO,19,MoÅ¾iÄ Rok ,OH,14,1,1,25.00,16,14,4,9,27,37.04,1,0,2,3,33.33,1,2,7,10,-10.00,2,1,3,6,16.67,2,2,4,0.00,0,1,0,1,-100.00
11729,AUS,1,Graham Beau ,MB,2,0,0,-16.67,2,2,3,3,8,-12.50,0,0,0,0, ,0,1,3,4,-25.00,0,1,0,1,-100.00,1,4,5,-60.00,0,0,1,1,0.00
11729,AUS,2,Dosanjh Arshdeep ,S,0,0,0,-25.00,0,0,0,2,2,0.00,0,0,1,1,0.00,0,2,3,5,-40.00,0,0,1,1,0.00,0,0,0, ,8,1,40,49,14.29
11729,AUS,7,Weir James ,MB,1,0,1,-30.77,2,1,2,2,5,-20.00,0,3,0,3,-100.00,1,1,3,5,0.00,0,0,0,0, ,0,1,1,-100.00,0,0,0,0, 
11729,AUS,8,O'Dea Trent ,MB,1,0,0,0.00,1,1,0,2,3,33.33,0,1,0,1,-100.00,0,0,3,3,0.00,0,2,0,2,-100.00,0,0,0, ,0,0,0,0, 
11729,AUS,11,Perry Luke ,L,0,0,0, ,0,0,0,0,0, ,0,0,0,0, ,0,0,0,0, ,10,2,8,20,40.00,2,1,3,33.33,0,0,7,7,0.00
11729,AUS,12,Mote Nehemiah ,MB,5,0,0,10.00,5,5,0,3,8,62.50,0,3,0,3,-100.00,0,0,9,9,0.00,1,0,0,1,100.00,2,0,2,100.00,0,0,1,1,0.00
11729,AUS,15,Smith Luke ,OH,5,0,0,-10.00,5,5,6,4,15,-6.67,0,0,0,0, ,0,1,4,5,-20.00,7,3,13,23,17.39,0,0,0, ,0,0,1,1,0.00
11729,AUS,21,Butler Nicholas ,S,0,0,0, ,0,0,0,0,0, ,0,0,0,0, ,0,0,0,0, ,0,0,0,0, ,0,0,0, ,0,0,8,8,0.00
11729,AUS,27,Senica Max ,OH,0,0,0, ,0,0,0,0,0, ,0,0,0,0, ,0,0,0,0, ,0,0,0,0, ,0,0,0, ,0,0,0,0, 
11729,AUS,28,Taylor Tim ,OH,1,0,0,-40.00,1,1,2,1,4,-25.00,0,0,0,0, ,0,1,0,1,-100.00,2,1,3,6,16.67,0,0,0, ,0,0,1,1,0.00
11729,AUS,29,Garrett Ethan ,OH,2,1,0,-31.58,3,2,5,4,11,-27.27,1,3,1,5,-40.00,0,1,2,3,-33.33,1,1,5,7,0.00,2,2,4,0.00,0,0,0,0, 
11729,AUS,31,Aubrey Matthew ,O,0,0,0, ,0,0,0,0,0, ,0,0,0,0, ,0,0,0,0, ,0,0,0,0, ,0,0,0, ,0,0,0,0, 
11729,AUS,32,Azeez Oluwatobi Elliot ,OH,3,0,0,0.00,3,3,0,7,10,30.00,0,1,0,1,-100.00,0,2,1,3,-66.67,0,0,0,0, ,1,1,2,0.00,0,0,0,0, 
11729,AUS,33,Flowerday Sam ,OH,0,0,0,-100.00,0,0,2,0,2,-100.00,0,0,0,0, ,0,1,0,1,-100.00,0,1,0,1,-100.00,0,0,0, ,0,0,0,0, 
11729,POL,1,Nowakowski Piotr ,MB,2,2,0,7.14,4,2,0,1,3,66.67,2,1,1,4,25.00,0,2,5,7,-28.57,0,0,0,0, ,1,0,1,100.00,0,0,0,0, 
11729,POL,5,Kaczmarek Lukasz ,O,10,6,1,32.43,17,10,2,6,18,44.44,6,3,1,10,30.00,1,0,8,9,11.11,0,0,0,0, ,3,1,4,50.00,0,0,0,0, 
11729,POL,6,Kurek Bartosz ,O,0,0,0, ,0,0,0,0,0, ,0,0,0,0, ,0,0,0,0, ,0,0,0,0, ,0,0,0, ,0,0,0,0, 
11729,POL,10,Wojtaszek Damian ,L,0,0,0, ,0,0,0,0,0, ,0,0,0,0, ,0,0,0,0, ,0,0,0,0, ,0,0,0, ,0,0,0,0, 
11729,POL,11,Drzyzga Fabian ,S,0,2,3,10.00,5,0,0,0,0, ,2,0,0,2,100.00,3,3,12,18,0.00,0,0,0,0, ,4,0,4,100.00,10,0,36,46,21.74
11729,POL,12,Lomacz Grzegorz ,S,0,0,0, ,0,0,0,0,0, ,0,0,0,0, ,0,0,0,0, ,0,0,0,0, ,0,0,0, ,0,0,0,0, 
11729,POL,14,Sliwka Aleksander ,OH,0,0,0, ,0,0,0,0,0, ,0,0,0,0, ,0,0,0,0, ,0,0,0,0, ,0,0,0, ,0,0,0,0, 
11729,POL,15,Kochanowski Jakub ,MB,0,1,0,25.00,1,0,0,0,0, ,1,0,1,2,50.00,0,0,2,2,0.00,0,0,0,0, ,0,1,1,-100.00,0,0,0,0, 
11729,POL,16,Semeniuk Kamil ,OH,11,1,1,27.27,13,11,1,3,15,66.67,1,1,0,2,0.00,1,2,13,16,-6.25,2,0,6,8,25.00,1,3,4,-50.00,0,0,1,1,0.00
11729,POL,17,Zatorski Pawel ,L,0,0,0, ,0,0,0,0,0, ,0,0,0,0, ,0,0,0,0, ,4,1,3,8,37.50,8,1,9,77.78,0,0,4,4,0.00
11729,POL,20,Bieniek Mateusz ,MB,0,0,0, ,0,0,0,0,0, ,0,0,0,0, ,0,0,0,0, ,0,0,0,0, ,0,0,0, ,0,0,0,0, 
11729,POL,21,Fornal Tomasz ,OH,6,0,4,14.29,10,6,2,5,13,30.77,0,1,1,2,-50.00,4,3,6,13,7.69,5,0,7,12,41.67,2,1,3,33.33,0,0,1,1,0.00
11729,POL,22,Bednorz Bartosz ,OH,0,0,0, ,0,0,0,0,0, ,0,0,0,0, ,0,0,0,0, ,0,0,0,0, ,0,0,0, ,0,0,0,0, 
11729,POL,99,Huber Norbert ,MB,2,1,2,0.00,5,2,0,2,4,50.00,1,3,1,5,-40.00,2,2,5,9,0.00,1,0,0,1,100.00,0,0,0, ,0,0,0,0, 
11730,ITA,7,Balaso Fabio ,L,0,0,0, ,0,0,0,0,0, ,0,0,0,0, ,0,0,0,0, ,8,1,13,22,31.82,20,4,25,64.00,0,0,9,9,0.00
11730,ITA,11,Galassi Gianluca ,MB,11,4,1,17.95,16,11,0,2,13,84.62,4,4,1,9,0.00,1,5,11,17,-23.53,0,0,0,0, ,4,1,5,60.00,0,0,0,0, 
11730,ITA,15,Sbertoli Riccardo ,S,0,0,1,-8.70,1,0,0,2,2,0.00,0,1,2,3,-33.33,1,2,15,18,-5.56,0,0,0,0, ,6,2,9,44.44,25,0,74,99,25.25
11730,ITA,18,Michieletto Alessandro ,OH,18,3,0,22.95,21,18,0,14,32,56.25,3,5,0,8,-25.00,0,2,19,21,-9.52,6,0,23,29,20.69,9,4,14,35.71,0,0,1,1,0.00
11730,ITA,20,Nelli Gabriele ,O,0,0,0,0.00,0,0,0,0,0, ,0,0,0,0, ,0,0,2,2,0.00,0,0,0,0, ,0,0,0, ,0,0,1,1,0.00
11730,ITA,21,Spirito Luca ,S,0,0,0, ,0,0,0,0,0, ,0,0,0,0, ,0,0,0,0, ,0,0,0,0, ,0,0,0, ,1,0,4,5,20.00
11730,ITA,23,Pinali Giulio ,O,18,0,0,20.83,18,18,3,9,30,50.00,0,3,1,4,-75.00,0,2,12,14,-14.29,0,0,1,1,0.00,6,4,10,20.00,0,0,2,2,0.00
11730,ITA,24,Cavuto Oreste ,OH,15,1,1,15.22,17,15,7,7,29,27.59,1,1,2,4,0.00,1,2,10,13,-7.69,5,1,17,23,17.39,0,2,3,-66.67,0,0,0,0, 
11730,ITA,25,Vitelli Marco ,MB,0,0,1,-25.00,1,0,1,1,2,-50.00,0,0,0,0, ,1,2,3,6,-16.67,0,0,0,0, ,0,0,0, ,0,0,0,0, 
11730,ITA,26,Cortesia Lorenzo ,MB,7,2,2,2.78,11,7,1,1,9,66.67,2,7,6,15,-33.33,2,2,8,12,0.00,0,0,0,0, ,0,1,1,-100.00,0,0,0,0, 
11730,ITA,28,Recine Francesco ,OH,0,0,1,0.00,1,0,1,1,2,-50.00,0,0,0,0, ,1,0,4,5,20.00,3,0,4,7,42.86,1,3,4,-50.00,0,0,1,1,0.00
11730,ITA,29,Bottolo Mattia ,OH,0,0,0, ,0,0,0,0,0, ,0,0,0,0, ,0,0,0,0, ,0,0,0,0, ,0,0,0, ,0,0,0,0, 
11730,ITA,30,Mosca Leandro Ausibio ,MB,0,0,0, ,0,0,0,0,0, ,0,0,0,0, ,0,0,0,0, ,0,0,0,0, ,0,0,0, ,0,0,0,0, 
11730,ITA,31,Federici Filippo ,L,0,0,0, ,0,0,0,0,0, ,0,0,0,0, ,0,0,0,0, ,0,0,0,0, ,0,0,0, ,0,0,0,0, 
11730,BUL,1,Karyagin Denis ,O,2,0,0,0.00,2,2,2,1,5,0.00,0,0,0,0, ,0,0,2,2,0.00,0,1,4,5,-20.00,1,1,2,0.00,0,0,0,0, 
11730,BUL,2,Chavdarov Stefan ,MB,4,1,0,10.00,5,4,0,3,7,57.14,1,2,0,3,-33.33,0,1,9,10,-10.00,0,0,1,1,0.00,1,0,1,100.00,0,0,1,1,0.00
11730,BUL,3,Kolev Nikolay ,MB,3,1,0,0.00,4,3,1,4,8,25.00,1,3,1,5,-40.00,0,0,7,7,0.00,0,0,2,2,0.00,2,1,3,33.33,0,0,2,2,0.00
11730,BUL,4,Atanasov Martin ,OH,0,0,0, ,0,0,0,0,0, ,0,0,0,0, ,0,0,0,0, ,0,0,0,0, ,0,0,0, ,0,0,0,0, 
11730,BUL,6,Stankov Vladimir ,S,0,0,0,-27.78,0,0,0,1,1,0.00,0,4,6,10,-40.00,0,1,6,7,-14.29,0,0,0,0, ,3,2,6,16.67,6,0,56,62,9.68
11730,BUL,9,Seganov Georgi ,S,1,0,0,12.50,1,1,0,0,1,100.00,0,0,0,0, ,0,0,7,7,0.00,0,0,0,0, ,1,0,1,100.00,9,0,36,45,20.00
11730,BUL,12,Petrov Georgi ,OH,2,0,0,-33.33,2,2,2,1,5,0.00,0,3,0,3,-100.00,0,1,3,4,-25.00,2,1,7,10,10.00,1,0,1,100.00,0,0,1,1,0.00
11730,BUL,14,Asparuhov Asparuh ,OH,16,2,1,26.42,19,16,2,13,31,45.16,2,1,4,7,14.29,1,2,12,15,-6.67,16,1,20,37,40.54,6,4,10,20.00,0,0,3,3,0.00
11730,BUL,16,Ivanov Vladislav ,L,0,0,0, ,0,0,0,0,0, ,0,0,0,0, ,0,0,0,0, ,4,0,6,10,40.00,5,6,11,-9.09,0,0,2,2,0.00
11730,BUL,19,Sokolov Tsvetan ,O,0,0,0, ,0,0,0,0,0, ,0,0,0,0, ,0,0,0,0, ,0,0,0,0, ,0,0,0, ,0,0,0,0, 
11730,BUL,22,Kartev Nikolay ,MB,8,1,0,-5.13,9,8,1,2,11,63.64,1,9,0,10,-80.00,0,1,17,18,-5.56,0,1,0,1,-100.00,0,0,0, ,0,0,0,0, 
11730,BUL,24,Ivanov Martin ,L,0,0,0, ,0,0,0,0,0, ,0,0,0,0, ,0,0,0,0, ,2,0,11,13,15.38,6,0,8,75.00,0,0,2,2,0.00
11730,BUL,25,Parapunov Radoslav ,O,17,4,1,13.56,22,17,8,10,35,25.71,4,1,3,8,37.50,1,5,10,16,-25.00,0,0,0,0, ,4,3,9,11.11,0,0,1,1,0.00
11730,BUL,26,Ivanov Svetoslav ,OH,7,0,0,13.04,7,7,2,4,13,38.46,0,1,1,2,-50.00,0,1,7,8,-12.50,4,3,5,12,8.33,2,2,4,0.00,0,0,0,0, 
11731,RUS,1,Podlesnykh Yaroslav ,OH,0,0,0, ,0,0,0,0,0, ,0,0,0,0, ,0,0,0,0, ,0,0,0,0, ,0,0,0, ,0,0,0,0, 
11731,RUS,2,Vlasov Ilia ,MB,11,1,0,15.15,12,11,0,5,16,68.75,1,4,3,8,-37.50,0,3,6,9,-33.33,0,0,2,2,0.00,0,0,0, ,0,0,0,0, 
11731,RUS,4,Volvich Artem ,MB,0,0,0, ,0,0,0,0,0, ,0,0,0,0, ,0,0,0,0, ,0,0,0,0, ,0,0,0, ,0,0,0,0, 
11731,RUS,5,Semyshev Anton ,OH,9,1,0,0.00,10,9,6,6,21,14.29,1,1,1,3,0.00,0,3,12,15,-20.00,8,1,11,20,35.00,4,3,8,12.50,0,0,0,0, 
11731,RUS,6,Baranov Evgeny ,L,0,0,0, ,0,0,0,0,0, ,0,0,0,0, ,0,0,0,0, ,0,0,0,0, ,0,0,0, ,0,0,0,0, 
11731,RUS,10,Bogdan Denis ,OH,0,0,0,-50.00,0,0,1,1,2,-50.00,0,0,0,0, ,0,1,1,2,-50.00,0,0,0,0, ,0,0,1,0.00,0,0,0,0, 
11731,RUS,11,Pankov Pavel ,S,2,1,0,-8.00,3,2,0,0,2,100.00,1,4,2,7,-42.86,0,1,15,16,-6.25,0,0,0,0, ,4,6,12,-16.67,28,0,61,89,31.46
11731,RUS,13,Muserskiy Dmitriy ,MB,1,1,0,0.00,2,1,0,1,2,50.00,1,1,0,2,0.00,0,1,2,3,-33.33,0,0,0,0, ,1,0,1,100.00,0,0,0,0, 
11731,RUS,15,Poletaev Victor ,O,0,0,0,-20.00,0,0,0,0,0, ,0,0,0,0, ,0,1,4,5,-20.00,0,0,0,0, ,0,0,0, ,0,0,0,0, 
11731,RUS,17,Mikhaylov Maxim ,O,13,1,1,14.04,15,13,2,15,30,36.67,1,2,2,5,-20.00,1,3,18,22,-9.09,0,0,1,1,0.00,7,0,7,100.00,0,1,2,3,-33.33
11731,RUS,18,Kliuka Egor ,OH,17,0,0,13.04,17,17,3,8,28,50.00,0,5,0,5,-100.00,0,3,10,13,-23.08,6,0,12,18,33.33,12,1,15,73.33,0,0,3,3,0.00
11731,RUS,20,Kurkaev Ilyas ,MB,3,1,1,12.50,5,3,0,3,6,50.00,1,2,1,4,-25.00,1,1,4,6,0.00,0,0,0,0, ,1,0,1,100.00,0,0,2,2,0.00
11731,RUS,24,Kobzar Igor ,S,0,0,0, ,0,0,0,0,0, ,0,0,0,0, ,0,0,0,0, ,0,0,0,0, ,0,0,0, ,0,0,0,0, 
11731,RUS,27,Golubev Valentin ,L,0,0,0, ,0,0,0,0,0, ,0,0,0,0, ,0,0,0,0, ,9,2,17,28,25.00,7,1,9,66.67,0,0,5,5,0.00
11731,USA,4,Jendryk II Jeffrey ,MB,4,0,1,6.67,5,4,1,0,5,60.00,0,2,1,3,-66.67,1,1,5,7,0.00,0,0,0,0, ,2,0,2,100.00,0,0,0,0, 
11731,USA,5,Ensing Kyle ,O,6,0,0,3.85,6,6,2,4,12,33.33,0,1,4,5,-20.00,0,2,7,9,-22.22,0,0,0,0, ,3,1,4,50.00,0,0,2,2,0.00
11731,USA,6,Stahl Mitchell ,MB,4,1,0,7.14,5,4,0,2,6,66.67,1,2,1,4,-25.00,0,2,2,4,-50.00,1,0,2,3,33.33,0,0,1,0.00,0,0,0,0, 
11731,USA,7,Shoji Kawika ,S,0,0,0, ,0,0,0,0,0, ,0,0,0,0, ,0,0,0,0, ,0,0,0,0, ,0,0,0, ,0,0,0,0, 
11731,USA,8,Defalco Torey ,OH,10,2,0,-4.08,12,10,7,9,26,11.54,2,3,2,7,-14.29,0,4,12,16,-25.00,3,1,18,22,9.09,6,2,9,44.44,0,0,2,2,0.00
11731,USA,11,Christenson Micah ,S,4,0,1,-6.90,5,4,0,2,6,66.67,0,4,2,6,-66.67,1,3,13,17,-11.76,0,0,1,1,0.00,4,6,12,-16.67,35,0,50,85,41.18
11731,USA,13,Patch Benjamin ,O,4,0,0,-5.26,4,4,3,7,14,7.14,0,0,1,1,0.00,0,2,2,4,-50.00,0,0,0,0, ,2,1,3,33.33,0,0,1,1,0.00
11731,USA,15,Sander Brenden ,OH,0,0,0, ,0,0,0,0,0, ,0,0,0,0, ,0,0,0,0, ,0,0,0,0, ,0,0,0, ,0,0,0,0, 
11731,USA,17,Jaeschke Thomas ,OH,14,1,1,24.39,16,14,2,5,21,57.14,1,2,2,5,-20.00,1,2,12,15,-6.67,5,1,15,21,19.05,6,7,15,-6.67,0,0,2,2,0.00
11731,USA,18,Muagututia Garrett ,OH,0,0,0, ,0,0,0,0,0, ,0,0,0,0, ,0,0,0,0, ,0,0,0,0, ,0,0,0, ,0,0,0,0, 
11731,USA,19,Averill Taylor ,MB,4,1,0,25.00,5,4,0,2,6,66.67,1,1,0,2,0.00,0,0,8,8,0.00,0,0,0,0, ,1,0,2,50.00,0,0,1,1,0.00
11731,USA,20,Smith David ,MB,2,0,0,-14.29,2,2,1,2,5,20.00,0,2,1,3,-66.67,0,1,5,6,-16.67,0,0,0,0, ,2,1,3,33.33,0,0,0,0, 
11731,USA,21,Watten Dustin ,L,0,0,0, ,0,0,0,0,0, ,0,0,0,0, ,0,0,0,0, ,0,0,0,0, ,0,0,0, ,0,0,0,0, 
11731,USA,22,Shoji Erik ,L,0,0,0, ,0,0,0,0,0, ,0,0,0,0, ,0,0,0,0, ,10,0,17,27,37.04,8,2,11,54.55,0,0,5,5,0.00
11732,ARG,2,Pereyra Federico ,O,4,0,0,-25.00,4,4,7,9,20,-15.00,0,1,1,2,-50.00,0,3,3,6,-50.00,0,0,0,0, ,1,0,3,33.33,0,0,2,2,0.00
11732,ARG,3,Martinez Franchi Jan ,OH,7,0,0,7.14,7,7,1,9,17,35.29,0,1,0,1,-100.00,0,3,7,10,-30.00,5,0,14,19,26.32,9,1,10,80.00,0,0,4,4,0.00
11732,ARG,5,Uriarte Nicolas ,S,0,2,0,20.00,2,0,0,1,1,0.00,2,0,3,5,40.00,0,0,4,4,0.00,0,0,0,0, ,2,0,3,66.67,15,0,24,39,38.46
11732,ARG,6,Poglajen Cristian ,OH,4,0,0,0.00,4,4,2,6,12,16.67,0,2,3,5,-40.00,0,0,5,5,0.00,1,1,9,11,0.00,5,2,7,42.86,0,0,0,0, 
11732,ARG,7,Conte Facundo ,OH,0,0,0, ,0,0,0,0,0, ,0,0,0,0, ,0,0,0,0, ,0,0,0,0, ,0,0,0, ,0,0,0,0, 
11732,ARG,8,Loser Agustin ,MB,0,0,0, ,0,0,0,0,0, ,0,0,0,0, ,0,0,0,0, ,0,0,0,0, ,0,0,0, ,0,0,0,0, 
11732,ARG,11,SolÃ© Sebastian ,MB,0,0,0, ,0,0,0,0,0, ,0,0,0,0, ,0,0,0,0, ,0,0,0,0, ,0,0,0, ,0,0,0,0, 
11732,ARG,13,Palacios Ezequiel ,OH,0,0,0, ,0,0,0,0,0, ,0,0,0,0, ,0,0,0,0, ,0,0,0,0, ,0,0,0, ,0,0,0,0, 
11732,ARG,14,Crer Pablo ,MB,6,2,0,14.81,8,6,1,2,9,55.56,2,2,2,6,0.00,0,1,11,12,-8.33,0,0,1,1,0.00,3,1,5,40.00,0,0,1,1,0.00
11732,ARG,15,De Cecco Luciano ,S,0,0,0,-11.11,0,0,0,0,0, ,0,0,2,2,0.00,0,1,6,7,-14.29,0,0,1,1,0.00,1,1,4,0.00,11,0,23,34,32.35
11732,ARG,16,Palonsky Luciano ,OH,4,0,0,0.00,4,4,2,4,10,20.00,0,1,0,1,-100.00,0,1,4,5,-20.00,0,0,0,0, ,4,2,6,33.33,0,0,1,1,0.00
11732,ARG,17,Mendez Nicolas ,OH,2,2,0,0.00,4,2,1,6,9,11.11,2,2,1,5,0.00,0,1,2,3,-33.33,3,1,11,15,13.33,2,0,2,100.00,0,0,1,1,0.00
11732,ARG,18,Ramos Martin ,MB,5,1,0,0.00,6,5,1,3,9,44.44,1,4,5,10,-30.00,0,1,7,8,-12.50,1,0,0,1,100.00,3,1,7,28.57,0,1,1,2,-50.00
11732,ARG,19,Massimino Franco ,L,0,0,0, ,0,0,0,0,0, ,0,0,0,0, ,0,0,0,0, ,2,2,6,10,0.00,4,4,10,0.00,0,0,3,3,0.00
11732,SLO,1,Å tern TonÄek ,O,6,0,1,0.00,7,6,3,7,16,18.75,0,1,0,1,-100.00,1,3,8,12,-16.67,0,0,0,0, ,2,0,2,100.00,0,0,2,2,0.00
11732,SLO,2,Pajenk Alen ,MB,6,1,0,-2.94,7,6,0,2,8,75.00,1,6,7,14,-35.71,0,2,10,12,-16.67,0,0,1,1,0.00,3,1,4,50.00,0,0,0,0, 
11732,SLO,3,PernuÅ¡ Gregor ,S,0,0,0, ,0,0,0,0,0, ,0,0,0,0, ,0,0,0,0, ,0,0,0,0, ,0,0,0, ,0,0,0,0, 
11732,SLO,4,Kozamernik Jan ,MB,2,2,1,-5.71,5,2,1,4,7,14.29,2,2,8,12,0.00,1,4,11,16,-18.75,0,0,2,2,0.00,3,0,3,100.00,0,0,1,1,0.00
11732,SLO,5,Å ket Alen ,O,4,0,0,8.33,4,4,0,3,7,57.14,0,2,0,2,-100.00,0,1,2,3,-33.33,0,0,0,0, ,0,1,1,-100.00,0,0,0,0, 
11732,SLO,6,Gasparini Mitja ,O,0,0,0, ,0,0,0,0,0, ,0,0,0,0, ,0,0,0,0, ,0,0,0,0, ,0,0,0, ,0,0,0,0, 
11732,SLO,10,Å talekar SaÅ¡o ,MB,0,0,0, ,0,0,0,0,0, ,0,0,0,0, ,0,0,0,0, ,0,0,0,0, ,0,0,0, ,0,0,0,0, 
11732,SLO,11,Å tern Å½iga ,OH,11,1,2,20.00,14,11,2,5,18,50.00,1,1,1,3,0.00,2,4,8,14,-14.29,1,0,15,16,6.25,7,3,11,36.36,0,0,3,3,0.00
11732,SLO,13,KovaÄiÄ Jani ,L,0,0,0, ,0,0,0,0,0, ,0,0,0,0, ,0,0,0,0, ,3,0,8,11,27.27,12,1,13,84.62,0,0,3,3,0.00
11732,SLO,15,VideÄnik Matic ,MB,0,0,0, ,0,0,0,0,0, ,0,0,0,0, ,0,0,0,0, ,0,0,0,0, ,1,0,1,100.00,0,0,0,0, 
11732,SLO,16,Ropret Gregor ,S,1,0,0,0.00,1,1,0,0,1,100.00,0,1,3,4,-25.00,0,0,9,9,0.00,0,0,0,0, ,5,0,6,83.33,35,1,39,75,45.33
11732,SLO,17,Urnaut Tine ,OH,0,0,0, ,0,0,0,0,0, ,0,0,0,0, ,0,0,0,0, ,0,0,0,0, ,0,0,0, ,0,0,0,0, 
11732,SLO,18,Äebulj Klemen ,OH,11,1,0,11.11,12,11,3,14,28,28.57,1,2,6,9,-11.11,0,2,6,8,-25.00,6,0,13,19,31.58,7,1,10,60.00,0,0,3,3,0.00
11732,SLO,19,MoÅ¾iÄ Rok ,OH,0,0,0, ,0,0,0,0,0, ,0,0,0,0, ,0,0,0,0, ,0,0,0,0, ,0,0,0, ,0,0,0,0, 
11733,NED,2,Keemink Wessel ,S,0,0,0,-15.38,0,0,0,1,1,0.00,0,4,1,5,-80.00,0,0,20,20,0.00,0,0,0,0, ,8,1,10,70.00,28,0,82,110,25.45
11733,NED,4,Ter Horst Thijs ,OH,24,1,1,25.93,26,24,4,8,36,55.56,1,3,0,4,-50.00,1,5,8,14,-28.57,5,2,12,19,15.79,5,1,6,66.67,0,0,2,2,0.00
11733,NED,5,van der Ent Luuc ,MB,0,0,0, ,0,0,0,0,0, ,0,0,0,0, ,0,0,0,0, ,0,0,0,0, ,0,0,0, ,0,0,0,0, 
11733,NED,6,Dronkers Just ,L,0,0,0, ,0,0,0,0,0, ,0,0,0,0, ,0,0,0,0, ,21,2,15,38,50.00,10,6,16,25.00,0,0,5,5,0.00
11733,NED,7,Jorna Gijs ,OH,0,0,0,-16.67,0,0,0,0,0, ,0,0,0,0, ,0,1,5,6,-16.67,1,0,0,1,100.00,1,0,1,100.00,0,0,0,0, 
11733,NED,10,van Zeist Maikel ,MB,0,0,0, ,0,0,0,0,0, ,0,0,0,0, ,0,0,0,0, ,0,0,0,0, ,0,0,0, ,0,0,0,0, 
11733,NED,12,Tuinstra Bennie Junior ,OH,12,0,1,1.96,13,12,6,10,28,21.43,0,3,1,4,-75.00,1,3,15,19,-10.53,7,1,10,18,33.33,7,0,7,100.00,0,0,3,3,0.00
11733,NED,13,Ottevanger Steven ,L,0,0,0, ,0,0,0,0,0, ,0,0,0,0, ,0,0,0,0, ,0,0,0,0, ,0,0,0, ,0,0,0,0, 
11733,NED,14,Abdel-Aziz Nimir ,O,18,1,5,12.33,24,18,4,20,42,33.33,1,3,4,8,-25.00,5,8,10,23,-13.04,0,0,0,0, ,14,3,17,64.71,0,1,3,4,-25.00
11733,NED,15,van Solkema Gijs ,S,0,0,0, ,0,0,0,0,0, ,0,0,0,0, ,0,0,0,0, ,0,0,0,0, ,0,0,0, ,0,0,0,0, 
11733,NED,17,Parkinson Michael ,MB,11,4,1,8.70,16,11,1,1,13,76.92,4,9,8,21,-23.81,1,2,9,12,-8.33,1,0,5,6,16.67,1,0,1,100.00,0,0,0,0, 
11733,NED,18,Andringa Robbert ,L,0,0,0, ,0,0,0,0,0, ,0,0,0,0, ,0,0,0,0, ,0,0,0,0, ,2,0,2,100.00,0,0,0,0, 
11733,NED,22,Wiltenburg Twan ,MB,1,1,1,-17.24,3,1,1,2,4,0.00,1,5,4,10,-40.00,1,2,12,15,-6.67,0,0,1,1,0.00,2,0,2,100.00,0,0,2,2,0.00
11733,NED,25,van Tilburg Stijn ,OH,0,0,0,-100.00,0,0,0,0,0, ,0,0,0,0, ,0,1,0,1,-100.00,0,0,0,0, ,0,0,0, ,0,0,0,0, 
11733,GER,1,Fromm Christian ,OH,2,0,2,11.11,4,2,0,1,3,66.67,0,1,0,1,-100.00,2,2,1,5,0.00,2,1,5,8,12.50,0,0,0, ,0,0,2,2,0.00
11733,GER,3,Schott Ruben ,OH,10,0,1,4.44,11,10,2,7,19,42.11,0,2,2,4,-50.00,1,5,16,22,-18.18,16,3,13,32,40.62,7,4,12,25.00,0,0,2,2,0.00
11733,GER,5,Reichert Moritz ,OH,9,0,1,2.22,10,9,3,9,21,28.57,0,3,4,7,-42.86,1,3,13,17,-11.76,3,2,7,12,8.33,5,0,5,100.00,0,0,3,3,0.00
11733,GER,6,Kaliberda Denys ,OH,0,0,0, ,0,0,0,0,0, ,0,0,0,0, ,0,0,0,0, ,0,0,0,0, ,0,0,0, ,0,0,0,0, 
11733,GER,7,Sossenheimer David ,OH,0,0,0,-40.00,0,0,0,0,0, ,0,0,0,0, ,0,2,3,5,-40.00,0,0,0,0, ,1,0,1,100.00,0,0,0,0, 
11733,GER,8,BÃ¶hme Marcus ,MB,1,0,0,0.00,1,1,0,2,3,33.33,0,1,0,1,-100.00,0,0,2,2,0.00,0,0,0,0, ,1,1,2,0.00,0,0,0,0, 
11733,GER,10,Zenger Julian ,L,0,0,0, ,0,0,0,0,0, ,0,0,0,0, ,0,0,0,0, ,17,3,16,36,38.89,12,6,22,27.27,0,0,2,2,0.00
11733,GER,13,Hirsch Simon ,O,2,0,0,11.11,2,2,1,2,5,20.00,0,0,0,0, ,0,0,4,4,0.00,0,0,0,0, ,0,1,2,-50.00,0,0,1,1,0.00
11733,GER,15,BaxpÃ¶hler Noah ,MB,5,3,0,3.70,8,5,1,0,6,66.67,3,5,3,11,-18.18,0,1,9,10,-10.00,0,0,0,0, ,0,1,1,-100.00,0,0,0,0, 
11733,GER,16,BurggrÃ¤f Eric ,S,0,0,0, ,0,0,0,0,0, ,0,0,0,0, ,0,0,0,0, ,0,0,0,0, ,0,0,0, ,0,0,1,1,0.00
11733,GER,17,Zimmermann Jan ,S,1,0,0,-14.29,1,1,0,1,2,50.00,0,2,2,4,-50.00,0,2,13,15,-13.33,0,0,0,0, ,6,3,9,33.33,11,2,85,98,9.18
11733,GER,18,Krage Florian ,MB,8,1,0,-9.09,9,8,3,2,13,38.46,1,7,2,10,-60.00,0,2,8,10,-20.00,0,0,0,0, ,1,0,1,100.00,0,0,1,1,0.00
11733,GER,19,RÃ¶hrs Erik ,OH,0,0,0, ,0,0,0,0,0, ,0,0,0,0, ,0,0,0,0, ,0,0,0,0, ,0,0,0, ,0,0,0,0, 
11733,GER,20,Weber Linus ,O,17,2,1,23.21,20,17,4,16,37,35.14,2,1,4,7,14.29,1,2,9,12,-8.33,0,0,0,0, ,1,0,2,50.00,0,0,0,0, 
11734,BRA,1,Rezende Bruno Mossa ,S,0,0,0, ,0,0,0,0,0, ,0,0,0,0, ,0,0,0,0, ,0,0,0,0, ,0,0,0, ,0,0,2,2,0.00
11734,BRA,5,Borges Almeida Silva Mauricio ,OH,1,0,0,25.00,1,1,0,1,2,50.00,0,0,0,0, ,0,0,2,2,0.00,0,0,4,4,0.00,1,3,4,-50.00,0,0,0,0, 
11734,BRA,6,Gil Kreling Fernando ,S,0,0,0,-18.18,0,0,0,1,1,0.00,0,1,2,3,-33.33,0,1,6,7,-14.29,0,0,0,0, ,10,1,12,75.00,31,0,34,65,47.69
11734,BRA,8,De Souza Wallace ,O,15,0,1,31.71,16,15,1,10,26,53.85,0,0,2,2,0.00,1,2,10,13,-7.69,0,0,1,1,0.00,6,1,8,62.50,0,0,0,0, 
11734,BRA,9,Leal Hidalgo Yoandy ,OH,7,2,3,13.51,12,7,5,4,16,12.50,2,1,4,7,14.29,3,1,10,14,14.29,3,0,12,15,20.00,6,0,6,100.00,0,0,1,1,0.00
11734,BRA,10,Bispo dos Santos Matheus ,MB,2,1,0,12.50,3,2,0,0,2,100.00,1,2,2,5,-20.00,0,0,1,1,0.00,0,0,0,0, ,1,0,2,50.00,0,0,1,1,0.00
11734,BRA,12,Santos Isac ,MB,7,0,1,12.00,8,7,0,2,9,77.78,0,4,5,9,-44.44,1,1,5,7,0.00,0,0,0,0, ,3,2,5,20.00,0,0,1,1,0.00
11734,BRA,13,De Souza Mauricio Luiz ,MB,1,0,0,-20.00,1,1,0,0,1,100.00,0,2,1,3,-66.67,0,1,5,6,-16.67,0,0,0,0, ,0,0,0, ,0,0,0,0, 
11734,BRA,14,Correia De Souza Douglas ,OH,11,0,2,13.89,13,11,4,5,20,35.00,0,1,1,2,-50.00,2,3,9,14,-7.14,2,2,7,11,0.00,6,0,7,85.71,0,0,4,4,0.00
11734,BRA,15,Nascimento Maique Reis ,L,0,0,0, ,0,0,0,0,0, ,0,0,0,0, ,0,0,0,0, ,0,0,0,0, ,4,1,5,60.00,0,0,1,1,0.00
11734,BRA,17,Hoss Thales ,L,0,0,0, ,0,0,0,0,0, ,0,0,0,0, ,0,0,0,0, ,8,0,8,16,50.00,1,0,1,100.00,0,0,1,1,0.00
11734,BRA,18,Souza Ricardo Lucarelli ,OH,0,0,0, ,0,0,0,0,0, ,0,0,0,0, ,0,0,0,0, ,0,0,0,0, ,0,0,0, ,0,0,0,0, 
11734,BRA,21,Souza Alan ,O,0,0,0,0.00,0,0,0,0,0, ,0,0,1,1,0.00,0,0,0,0, ,0,0,0,0, ,0,0,0, ,0,0,0,0, 
11734,BRA,23,Resende Gualberto Flavio ,MB,4,0,0,0.00,4,4,2,0,6,33.33,0,2,2,4,-50.00,0,0,9,9,0.00,0,0,0,0, ,2,0,2,100.00,0,0,5,5,0.00
11734,JPN,1,Shimizu Kunihiro ,O,8,0,0,8.70,8,8,4,2,14,28.57,0,1,0,1,-100.00,0,1,7,8,-12.50,0,0,1,1,0.00,1,1,2,0.00,0,0,0,0, 
11734,JPN,3,Fujii Naonobu ,S,0,0,0,0.00,0,0,0,0,0, ,0,0,0,0, ,0,0,4,4,0.00,0,0,0,0, ,4,2,7,28.57,16,0,25,41,39.02
11734,JPN,4,Otake Issei ,O,0,0,0, ,0,0,0,0,0, ,0,0,0,0, ,0,0,0,0, ,0,0,0,0, ,0,0,0, ,0,0,0,0, 
11734,JPN,5,Fukuzawa Tatsuya ,OH,2,0,0,-8.33,2,2,2,3,7,0.00,0,0,2,2,0.00,0,1,2,3,-33.33,2,0,6,8,25.00,3,0,3,100.00,0,0,0,0, 
11734,JPN,6,Yamauchi Akihiro ,MB,4,2,1,16.00,7,4,0,4,8,50.00,2,3,1,6,-16.67,1,0,10,11,9.09,0,0,3,3,0.00,0,0,1,0.00,0,0,2,2,0.00
11734,JPN,13,Oya Masaki ,S,0,0,0,-66.67,0,0,0,0,0, ,0,1,0,1,-100.00,0,1,1,2,-50.00,0,0,0,0, ,2,1,3,33.33,8,0,14,22,36.36
11734,JPN,14,Ishikawa Yuki ,OH,6,1,0,8.70,7,6,0,5,11,54.55,1,3,1,5,-40.00,0,2,5,7,-28.57,5,0,13,18,27.78,4,1,5,60.00,0,0,3,3,0.00
11734,JPN,15,Ri Haku ,MB,0,3,0,0.00,3,0,1,5,6,-16.67,3,1,7,11,18.18,0,1,7,8,-12.50,0,0,1,1,0.00,1,1,2,0.00,0,0,0,0, 
11734,JPN,16,Takahashi Kentaro ,MB,0,0,0, ,0,0,0,0,0, ,0,0,0,0, ,0,0,0,0, ,0,0,0,0, ,0,0,0, ,0,0,0,0, 
11734,JPN,17,Takanashi Kenta ,OH,9,0,0,2.94,9,9,2,10,21,33.33,0,2,1,3,-66.67,0,4,6,10,-40.00,3,1,11,15,13.33,3,2,6,16.67,0,0,2,2,0.00
11734,JPN,19,Otsuka Tatsunori ,OH,2,0,1,16.67,3,2,0,5,7,28.57,0,0,0,0, ,1,1,3,5,0.00,0,0,2,2,0.00,0,1,1,-100.00,0,0,0,0, 
11734,JPN,20,Yamamoto Tomohiro ,L,0,0,0, ,0,0,0,0,0, ,0,0,0,0, ,0,0,0,0, ,3,1,2,6,33.33,1,1,2,0.00,0,0,1,1,0.00
11734,JPN,21,Takahashi Ran ,OH,0,0,0, ,0,0,0,0,0, ,0,0,0,0, ,0,0,0,0, ,0,0,0,0, ,0,0,0, ,0,0,0,0, 
11734,JPN,24,Ogawa Tomohiro ,L,0,0,0, ,0,0,0,0,0, ,0,0,0,0, ,0,0,0,0, ,1,5,4,10,-40.00,3,2,6,16.67,0,0,1,1,0.00
11735,SRB,2,Kovacevic Uros ,OH,8,2,1,-2.00,11,8,5,11,24,12.50,2,2,5,9,0.00,1,5,11,17,-23.53,8,5,15,28,10.71,7,1,8,75.00,0,0,1,1,0.00
11735,SRB,3,Kapur Milorad ,L,0,0,0, ,0,0,0,0,0, ,0,0,0,0, ,0,0,0,0, ,0,0,0,0, ,0,0,0, ,0,0,0,0, 
11735,SRB,6,Pekovic Nikola ,L,0,0,0, ,0,0,0,0,0, ,0,0,0,0, ,0,0,0,0, ,15,3,13,31,38.71,4,1,5,60.00,0,0,6,6,0.00
11735,SRB,7,Krsmanovic Petar ,MB,10,3,0,-3.92,13,10,0,2,12,83.33,3,12,8,23,-39.13,0,3,13,16,-18.75,0,0,0,0, ,4,1,5,60.00,0,0,2,2,0.00
11735,SRB,8,Ivovic Marko ,OH,15,0,0,8.16,15,15,4,7,26,42.31,0,4,3,7,-57.14,0,3,13,16,-18.75,14,1,11,26,50.00,6,4,10,20.00,0,0,5,5,0.00
11735,SRB,9,Jovovic Nikola ,S,0,1,0,-25.00,1,0,0,0,0, ,1,6,0,7,-71.43,0,1,16,17,-5.88,0,0,0,0, ,6,2,9,44.44,23,1,59,83,26.51
11735,SRB,10,KujundÅ¾iÄ Miran ,OH,0,0,0, ,0,0,0,0,0, ,0,0,0,0, ,0,0,0,0, ,0,0,0,0, ,0,0,0, ,0,0,0,0, 
11735,SRB,12,Peric Pavle ,OH,0,0,0, ,0,0,0,0,0, ,0,0,0,0, ,0,0,0,0, ,0,0,0,0, ,0,0,0, ,0,0,0,0, 
11735,SRB,13,Simic Stevan ,MB,0,0,0, ,0,0,0,0,0, ,0,0,0,0, ,0,0,0,0, ,0,0,0,0, ,0,0,0, ,0,0,0,0, 
11735,SRB,14,Atanasijevic Aleksandar ,O,20,2,2,29.63,24,20,3,7,30,56.67,2,1,4,7,14.29,2,4,11,17,-11.76,0,0,0,0, ,3,0,3,100.00,0,0,2,2,0.00
11735,SRB,16,Luburic Drazen ,O,5,0,0,30.00,5,5,0,0,5,100.00,0,0,0,0, ,0,2,3,5,-40.00,0,0,0,0, ,0,0,0, ,0,0,0,0, 
11735,SRB,18,Podrascanin Marko ,MB,4,3,0,-11.36,7,4,2,2,8,25.00,3,6,5,14,-21.43,0,4,18,22,-18.18,0,0,0,0, ,2,0,2,100.00,0,0,1,1,0.00
11735,SRB,21,Todorovic Vuk ,S,0,0,0, ,0,0,0,0,0, ,0,0,0,0, ,0,0,0,0, ,0,0,0,0, ,1,0,1,100.00,2,0,4,6,33.33
11735,SRB,26,Kovac Davide ,OH,0,0,0, ,0,0,0,0,0, ,0,0,0,0, ,0,0,0,0, ,0,0,0,0, ,0,0,0, ,0,0,0,0, 
11735,FRA,1,Chinenyeze BarthÃ©lÃ©my ,MB,3,0,0,-25.81,3,3,1,4,8,25.00,0,8,2,10,-80.00,0,2,11,13,-15.38,3,1,0,4,50.00,2,0,3,66.67,0,0,0,0, 
11735,FRA,2,Grebennikov Jenia ,L,0,0,0, ,0,0,0,0,0, ,0,0,0,0, ,0,0,0,0, ,7,1,16,24,25.00,10,3,16,43.75,0,0,4,4,0.00
11735,FRA,6,Toniutti Benjamin ,S,0,0,0,-27.27,0,0,0,2,2,0.00,0,3,2,5,-60.00,0,3,12,15,-20.00,0,0,1,1,0.00,4,4,9,0.00,19,1,90,110,16.36
11735,FRA,8,Lyneel Julien ,OH,4,0,0,-5.26,4,4,2,1,7,28.57,0,1,0,1,-100.00,0,2,9,11,-18.18,6,0,5,11,54.55,2,2,4,0.00,0,0,2,2,0.00
11735,FRA,9,Ngapeth Earvin ,OH,5,0,3,8.00,8,5,1,2,8,50.00,0,4,0,4,-100.00,3,1,9,13,15.38,4,0,4,8,50.00,0,3,4,-75.00,0,0,1,1,0.00
11735,FRA,11,Brizard Antoine ,S,0,0,0, ,0,0,0,0,0, ,0,0,0,0, ,0,0,0,0, ,0,0,0,0, ,0,0,0, ,0,0,0,0, 
11735,FRA,12,Boyer Stephen ,O,22,2,2,22.58,26,22,5,12,39,43.59,2,4,0,6,-33.33,2,3,12,17,-5.88,0,0,0,0, ,5,5,12,0.00,0,0,0,0, 
11735,FRA,14,Le Goff Nicolas ,MB,0,0,0, ,0,0,0,0,0, ,0,0,0,0, ,0,0,0,0, ,0,0,0,0, ,0,0,0, ,0,0,0,0, 
11735,FRA,16,Bultor Daryl ,MB,8,3,1,2.78,12,8,3,2,13,38.46,3,4,5,12,-8.33,1,4,6,11,-27.27,2,0,0,2,100.00,2,0,3,66.67,0,0,0,0, 
11735,FRA,18,Rossard Thibault ,OH,5,0,2,-9.68,7,5,4,5,14,7.14,0,2,0,2,-100.00,2,4,9,15,-13.33,9,1,13,23,34.78,2,2,4,0.00,0,0,1,1,0.00
11735,FRA,19,Louati Yacine ,OH,11,0,1,10.26,12,11,4,11,26,26.92,0,2,0,2,-100.00,1,2,8,11,-9.09,4,0,11,15,26.67,5,1,6,66.67,0,0,0,0, 
11735,FRA,20,Diez Benjamin ,L,0,0,0, ,0,0,0,0,0, ,0,0,0,0, ,0,0,0,0, ,0,0,0,0, ,0,0,0, ,0,0,0,0, 
11735,FRA,21,Faure ThÃ©o ,O,0,0,0, ,0,0,0,0,0, ,0,0,0,0, ,0,0,0,0, ,0,0,0,0, ,0,0,0, ,0,0,0,0, 
11735,FRA,24,Gueye Mousse ,MB,0,0,0, ,0,0,0,0,0, ,0,0,0,0, ,0,0,0,0, ,0,0,0,0, ,0,0,0, ,0,0,0,0, 
11736,IRI,2,Ebadipour Ghara H. Milad ,OH,6,0,2,0.00,8,6,3,11,20,15.00,0,2,0,2,-100.00,2,3,11,16,-6.25,5,3,10,18,11.11,5,1,6,66.67,0,0,3,3,0.00
11736,IRI,3,Abedini Reza ,MB,0,0,0,0.00,0,0,0,0,0, ,0,0,0,0, ,0,0,3,3,0.00,0,0,0,0, ,0,0,0, ,0,0,0,0, 
11736,IRI,4,Marouflakrani Mir Saeid ,S,0,0,0,-20.00,0,0,0,2,2,0.00,0,2,2,4,-50.00,0,2,12,14,-14.29,0,0,0,0, ,7,4,11,27.27,20,0,89,109,18.35
11736,IRI,6,Mousavi Eraghi Seyed Mohammad ,MB,0,0,0, ,0,0,0,0,0, ,0,0,0,0, ,0,0,0,0, ,0,0,0,0, ,0,0,0, ,0,0,0,0, 
11736,IRI,7,Fayazi D. Purya ,OH,0,0,0,-28.57,0,0,0,3,3,0.00,0,2,0,2,-100.00,0,0,2,2,0.00,1,1,6,8,0.00,2,0,2,100.00,0,1,0,1,-100.00
11736,IRI,8,Hazratpourtalatappeh Mohammadreza ,L,0,0,0, ,0,0,0,0,0, ,0,0,0,0, ,0,0,0,0, ,0,0,0,0, ,0,0,0, ,0,0,0,0, 
11736,IRI,9,Gholami Masoud ,MB,3,3,2,5.26,8,3,1,6,10,20.00,3,4,2,9,-11.11,2,1,16,19,5.26,1,0,0,1,100.00,1,5,6,-66.67,0,0,1,1,0.00
11736,IRI,11,Kazemi Saber ,O,20,1,3,12.82,24,20,4,29,53,30.19,1,6,0,7,-71.43,3,4,11,18,-5.56,0,0,1,1,0.00,4,4,8,0.00,0,0,0,0, 
11736,IRI,15,Mojarad Aliasghar ,MB,5,5,0,13.89,10,5,1,2,8,50.00,5,4,3,12,8.33,0,0,16,16,0.00,0,0,1,1,0.00,1,1,2,0.00,0,0,1,1,0.00
11736,IRI,17,Salehi Meisam ,OH,9,0,0,25.00,9,9,1,5,15,53.33,0,2,0,2,-100.00,0,0,7,7,0.00,6,0,11,17,35.29,1,2,3,-33.33,0,0,1,1,0.00
11736,IRI,18,Vadi Mohammad Taher ,S,0,0,0, ,0,0,0,0,0, ,0,0,0,0, ,0,0,0,0, ,0,0,0,0, ,0,0,0, ,0,0,2,2,0.00
11736,IRI,21,Salehi Arman ,L,0,0,0, ,0,0,0,0,0, ,0,0,0,0, ,0,0,0,0, ,8,2,8,18,33.33,11,6,18,27.78,0,0,7,7,0.00
11736,IRI,22,Esfandiar Amirhossein ,OH,5,1,0,0.00,6,5,1,6,12,33.33,1,2,1,4,-25.00,0,3,1,4,-75.00,3,2,10,15,6.67,2,2,4,0.00,0,0,1,1,0.00
11736,IRI,23,Saadat Bardia ,O,2,0,0,50.00,2,2,0,1,3,66.67,0,0,0,0, ,0,0,1,1,0.00,0,0,0,0, ,0,0,0, ,0,0,0,0, 
11736,ITA,1,Gardini Davide ,OH,0,0,0, ,0,0,0,0,0, ,0,0,0,0, ,0,0,0,0, ,0,0,0,0, ,0,0,0, ,0,0,0,0, 
11736,ITA,7,Balaso Fabio ,L,0,0,0, ,0,0,0,0,0, ,0,0,0,0, ,0,0,0,0, ,11,1,6,18,55.56,16,6,22,45.45,0,0,8,8,0.00
11736,ITA,11,Galassi Gianluca ,MB,8,1,1,14.29,10,8,0,3,11,72.73,1,2,1,4,-25.00,1,4,8,13,-23.08,1,0,0,1,100.00,1,1,3,0.00,0,0,0,0, 
11736,ITA,15,Sbertoli Riccardo ,S,0,0,2,-19.23,2,0,1,3,4,-25.00,0,3,2,5,-60.00,2,3,12,17,-5.88,0,0,1,1,0.00,8,3,12,41.67,24,2,81,107,20.56
11736,ITA,18,Michieletto Alessandro ,OH,13,0,1,20.59,14,13,4,7,24,37.50,0,0,0,0, ,1,3,6,10,-20.00,4,3,13,20,5.00,4,0,4,100.00,0,0,2,2,0.00
11736,ITA,20,Nelli Gabriele ,O,16,1,3,12.50,20,16,5,15,36,30.56,1,2,1,4,-25.00,3,6,7,16,-18.75,0,0,0,0, ,3,4,8,-12.50,0,0,4,4,0.00
11736,ITA,21,Spirito Luca ,S,0,0,0,0.00,0,0,0,0,0, ,0,0,0,0, ,0,0,2,2,0.00,0,0,0,0, ,0,0,0, ,3,0,5,8,37.50
11736,ITA,23,Pinali Giulio ,O,1,0,0,-14.29,1,1,1,3,5,0.00,0,1,0,1,-100.00,0,0,1,1,0.00,0,0,0,0, ,0,1,1,-100.00,0,0,0,0, 
11736,ITA,24,Cavuto Oreste ,OH,10,0,0,-2.08,10,10,5,14,29,17.24,0,5,1,6,-83.33,0,1,12,13,-7.69,11,2,14,27,33.33,7,5,12,16.67,0,1,1,2,-50.00
11736,ITA,26,Cortesia Lorenzo ,MB,8,0,1,12.90,9,8,1,3,12,58.33,0,3,2,5,-60.00,1,1,12,14,0.00,0,0,0,0, ,1,3,4,-50.00,0,0,0,0, 
11736,ITA,28,Recine Francesco ,OH,8,1,0,14.81,9,8,2,4,14,42.86,1,2,0,3,-33.33,0,1,9,10,-10.00,11,1,8,20,50.00,4,1,5,60.00,0,0,1,1,0.00
11736,ITA,29,Bottolo Mattia ,OH,0,0,0,-100.00,0,0,0,0,0, ,0,0,0,0, ,0,1,0,1,-100.00,0,0,0,0, ,0,0,0, ,0,0,0,0, 
11736,ITA,30,Mosca Leandro Ausibio ,MB,0,0,0,0.00,0,0,0,2,2,0.00,0,0,0,0, ,0,0,2,2,0.00,0,0,0,0, ,0,0,0, ,0,0,0,0, 
11736,ITA,31,Federici Filippo ,L,0,0,0, ,0,0,0,0,0, ,0,0,0,0, ,0,0,0,0, ,0,0,0,0, ,0,0,0, ,0,0,0,0, 
11737,POL,2,Muzaj Maciej ,O,0,0,0,0.00,0,0,0,0,0, ,0,0,1,1,0.00,0,0,0,0, ,0,0,0,0, ,0,0,0, ,0,0,0,0, 
11737,POL,6,Kurek Bartosz ,O,8,0,0,-5.56,8,8,5,6,19,15.79,0,2,4,6,-33.33,0,3,8,11,-27.27,1,0,1,2,50.00,8,1,10,70.00,0,0,0,0, 
11737,POL,9,Leon Venero Wilfredo ,OH,0,0,0,0.00,0,0,0,0,0, ,0,0,0,0, ,0,0,1,1,0.00,0,0,0,0, ,0,0,0, ,0,0,0,0, 
11737,POL,10,Wojtaszek Damian ,L,0,0,0, ,0,0,0,0,0, ,0,0,0,0, ,0,0,0,0, ,5,0,9,14,35.71,6,5,12,8.33,0,0,2,2,0.00
11737,POL,11,Drzyzga Fabian ,S,0,0,0, ,0,0,0,0,0, ,0,0,0,0, ,0,0,0,0, ,0,0,0,0, ,0,0,0, ,0,0,0,0, 
11737,POL,12,Lomacz Grzegorz ,S,0,0,0,-10.53,0,0,0,0,0, ,0,2,1,3,-66.67,0,0,16,16,0.00,0,0,0,0, ,5,1,8,50.00,31,1,35,67,44.78
11737,POL,13,Kubiak Michal ,OH,0,0,0, ,0,0,0,0,0, ,0,0,0,0, ,0,0,0,0, ,0,0,0,0, ,0,0,0, ,0,0,0,0, 
11737,POL,14,Sliwka Aleksander ,OH,8,1,0,8.11,9,8,2,4,14,42.86,1,1,2,4,0.00,0,3,16,19,-15.79,4,0,10,14,28.57,5,0,5,100.00,0,0,1,1,0.00
11737,POL,15,Kochanowski Jakub ,MB,9,1,0,15.38,10,9,3,1,13,46.15,1,2,3,6,-16.67,0,1,6,7,-14.29,0,0,0,0, ,3,0,5,60.00,0,0,0,0, 
11737,POL,16,Semeniuk Kamil ,OH,5,1,0,41.67,6,5,0,1,6,83.33,1,0,1,2,50.00,0,1,3,4,-25.00,3,0,3,6,50.00,5,0,6,83.33,0,0,0,0, 
11737,POL,17,Zatorski Pawel ,L,0,0,0, ,0,0,0,0,0, ,0,0,0,0, ,0,0,0,0, ,0,0,0,0, ,0,0,0, ,0,0,0,0, 
11737,POL,20,Bieniek Mateusz ,MB,7,5,0,33.33,12,7,0,3,10,70.00,5,1,1,7,57.14,0,2,8,10,-20.00,0,0,0,0, ,1,0,1,100.00,0,0,3,3,0.00
11737,POL,22,Bednorz Bartosz ,OH,3,2,2,8.33,7,3,2,7,12,8.33,2,1,0,3,33.33,2,2,5,9,0.00,2,2,3,7,0.00,3,1,4,50.00,0,0,2,2,0.00
11737,POL,77,Klos Karol ,MB,0,0,0, ,0,0,0,0,0, ,0,0,0,0, ,0,0,0,0, ,0,0,0,0, ,0,0,0, ,0,0,0,0, 
11737,USA,1,Anderson Matthew ,O,9,0,0,13.64,9,9,2,5,16,43.75,0,0,1,1,0.00,0,4,1,5,-80.00,9,1,6,16,50.00,5,1,8,50.00,0,0,0,0, 
11737,USA,4,Jendryk II Jeffrey ,MB,0,0,0, ,0,0,0,0,0, ,0,0,0,0, ,0,0,0,0, ,0,0,0,0, ,0,0,0, ,0,0,0,0, 
11737,USA,5,Ensing Kyle ,O,2,1,0,-7.69,3,2,2,3,7,0.00,1,0,2,3,33.33,0,2,1,3,-66.67,0,0,0,0, ,2,0,2,100.00,0,0,0,0, 
11737,USA,6,Stahl Mitchell ,MB,4,3,1,15.38,8,4,1,5,10,30.00,3,0,0,3,100.00,1,3,9,13,-15.38,1,0,0,1,100.00,0,1,1,-100.00,0,0,1,1,0.00
11737,USA,8,Defalco Torey ,OH,3,0,0,-16.67,3,3,3,3,9,0.00,0,1,0,1,-100.00,0,1,1,2,-50.00,4,0,10,14,28.57,0,1,1,-100.00,0,0,1,1,0.00
11737,USA,11,Christenson Micah ,S,0,0,0,-30.00,0,0,0,2,2,0.00,0,1,0,1,-100.00,0,2,5,7,-28.57,0,0,0,0, ,1,3,4,-50.00,21,1,29,51,39.22
11737,USA,12,Holt Maxwell ,MB,1,3,0,-5.88,4,1,2,5,8,-12.50,3,0,0,3,100.00,0,3,3,6,-50.00,0,0,0,0, ,1,1,2,0.00,0,0,0,0, 
11737,USA,13,Patch Benjamin ,O,5,0,0,9.09,5,5,3,6,14,14.29,0,0,1,1,0.00,0,0,7,7,0.00,0,0,1,1,0.00,3,2,5,20.00,0,0,0,0, 
11737,USA,16,Tuaniga Joshua ,S,1,0,0,16.67,1,1,0,0,1,100.00,0,0,1,1,0.00,0,0,4,4,0.00,0,0,0,0, ,3,2,5,20.00,12,0,17,29,41.38
11737,USA,17,Jaeschke Thomas ,OH,2,0,0,-11.11,2,2,0,3,5,40.00,0,1,0,1,-100.00,0,2,1,3,-66.67,2,0,2,4,50.00,0,3,3,-100.00,0,0,0,0, 
11737,USA,18,Muagututia Garrett ,OH,2,0,1,-4.35,3,2,2,8,12,0.00,0,1,2,3,-33.33,1,1,6,8,0.00,5,1,8,14,28.57,5,1,6,66.67,0,0,1,1,0.00
11737,USA,19,Averill Taylor ,MB,3,1,0,33.33,4,3,1,0,4,50.00,1,0,1,2,50.00,0,0,3,3,0.00,0,0,0,0, ,0,0,1,0.00,0,0,1,1,0.00
11737,USA,21,Watten Dustin ,L,0,0,0, ,0,0,0,0,0, ,0,0,0,0, ,0,0,0,0, ,0,0,0,0, ,0,0,0, ,0,0,0,0, 
11737,USA,22,Shoji Erik ,L,0,0,0, ,0,0,0,0,0, ,0,0,0,0, ,0,0,0,0, ,4,0,11,15,26.67,8,7,15,6.67,0,0,1,1,0.00
11738,RUS,1,Podlesnykh Yaroslav ,OH,5,0,2,8.70,7,5,3,8,16,12.50,0,1,0,1,-100.00,2,1,3,6,16.67,8,1,8,17,41.18,1,1,2,0.00,0,0,2,2,0.00
11738,RUS,2,Vlasov Ilia ,MB,0,0,0, ,0,0,0,0,0, ,0,0,0,0, ,0,0,0,0, ,0,0,0,0, ,0,0,0, ,0,0,0,0, 
11738,RUS,4,Volvich Artem ,MB,5,3,0,6.90,8,5,3,1,9,22.22,3,2,0,5,20.00,0,1,14,15,-6.67,0,0,0,0, ,0,1,1,-100.00,0,0,1,1,0.00
11738,RUS,5,Semyshev Anton ,OH,0,0,0, ,0,0,0,0,0, ,0,0,0,0, ,0,0,0,0, ,0,0,0,0, ,0,0,0, ,0,0,0,0, 
11738,RUS,6,Baranov Evgeny ,L,0,0,0, ,0,0,0,0,0, ,0,0,0,0, ,0,0,0,0, ,6,1,2,9,55.56,2,1,3,33.33,0,0,1,1,0.00
11738,RUS,7,Volkov Dmitry ,OH,9,2,2,16.67,13,9,1,8,18,44.44,2,2,0,4,0.00,2,4,8,14,-14.29,13,0,4,17,76.47,4,0,4,100.00,0,0,0,0, 
11738,RUS,10,Bogdan Denis ,OH,1,0,0,0.00,1,1,0,1,2,50.00,0,1,0,1,-100.00,0,0,2,2,0.00,4,0,0,4,100.00,1,1,2,0.00,0,0,0,0, 
11738,RUS,11,Pankov Pavel ,S,0,0,0, ,0,0,0,0,0, ,0,0,0,0, ,0,0,0,0, ,0,0,0,0, ,0,0,0, ,0,0,0,0, 
11738,RUS,13,Muserskiy Dmitriy ,MB,12,2,0,25.00,14,12,1,7,20,55.00,2,0,4,6,33.33,0,4,6,10,-40.00,0,0,0,0, ,2,1,3,33.33,0,0,1,1,0.00
11738,RUS,15,Poletaev Victor ,O,14,0,0,2.33,14,14,4,6,24,41.67,0,4,2,6,-66.67,0,5,8,13,-38.46,0,0,0,0, ,2,2,4,0.00,0,0,0,0, 
11738,RUS,20,Kurkaev Ilyas ,MB,0,0,0, ,0,0,0,0,0, ,0,0,0,0, ,0,0,0,0, ,0,0,0,0, ,0,0,0, ,0,0,0,0, 
11738,RUS,24,Kobzar Igor ,S,0,0,0,-23.81,0,0,0,1,1,0.00,0,2,3,5,-40.00,0,3,12,15,-20.00,0,0,0,0, ,1,0,1,100.00,18,0,62,80,22.50
11738,RUS,27,Golubev Valentin ,L,0,0,0, ,0,0,0,0,0, ,0,0,0,0, ,0,0,0,0, ,3,0,7,10,30.00,4,3,7,14.29,0,0,2,2,0.00
11738,AUS,1,Graham Beau ,MB,6,0,0,-13.51,6,6,8,11,25,-8.00,0,1,0,1,-100.00,0,2,9,11,-18.18,0,0,0,0, ,1,1,2,0.00,0,0,0,0, 
11738,AUS,2,Dosanjh Arshdeep ,S,2,1,1,-13.64,4,2,1,2,5,20.00,1,3,1,5,-40.00,1,3,8,12,-16.67,0,0,1,1,0.00,2,2,5,0.00,13,0,52,65,20.00
11738,AUS,7,Weir James ,MB,0,0,0, ,0,0,0,0,0, ,0,0,0,0, ,0,0,0,0, ,0,0,0,0, ,0,0,0, ,0,0,0,0, 
11738,AUS,8,O'Dea Trent ,MB,3,2,0,0.00,5,3,2,4,9,11.11,2,3,1,6,-16.67,0,0,12,12,0.00,0,0,1,1,0.00,3,1,4,50.00,0,0,1,1,0.00
11738,AUS,11,Perry Luke ,L,0,0,0, ,0,0,0,0,0, ,0,0,0,0, ,0,0,0,0, ,8,0,6,14,57.14,5,0,5,100.00,0,0,10,10,0.00
11738,AUS,12,Mote Nehemiah ,MB,5,0,0,4.00,5,5,0,1,6,83.33,0,4,2,6,-66.67,0,0,13,13,0.00,2,0,0,2,100.00,4,1,5,60.00,0,1,2,3,-33.33
11738,AUS,15,Smith Luke ,OH,11,1,1,20.51,13,11,2,12,25,36.00,1,2,2,5,-20.00,1,1,7,9,0.00,9,2,10,21,33.33,4,3,7,14.29,0,0,1,1,0.00
11738,AUS,21,Butler Nicholas ,S,0,0,0, ,0,0,0,0,0, ,0,0,0,0, ,0,0,0,0, ,0,0,0,0, ,0,0,0, ,0,0,0,0, 
11738,AUS,27,Senica Max ,OH,0,0,0, ,0,0,0,0,0, ,0,0,0,0, ,0,0,0,0, ,0,0,0,0, ,0,0,0, ,0,0,0,0, 
11738,AUS,28,Taylor Tim ,OH,0,0,0,-28.57,0,0,1,4,5,-20.00,0,0,0,0, ,0,1,1,2,-50.00,2,1,3,6,16.67,1,0,1,100.00,0,0,0,0, 
11738,AUS,29,Garrett Ethan ,OH,2,0,0,-6.25,2,2,1,6,9,11.11,0,1,0,1,-100.00,0,1,5,6,-16.67,5,1,6,12,33.33,0,1,1,-100.00,0,0,1,1,0.00
11738,AUS,31,Aubrey Matthew ,O,0,0,0, ,0,0,0,0,0, ,0,0,0,0, ,0,0,0,0, ,0,0,0,0, ,0,0,0, ,0,0,0,0, 
11738,AUS,32,Azeez Oluwatobi Elliot ,OH,0,0,0, ,0,0,0,0,0, ,0,0,0,0, ,0,0,0,0, ,0,0,0,0, ,0,0,0, ,0,0,0,0, 
11738,AUS,34,Greber Billy ,L,0,0,0, ,0,0,0,0,0, ,0,0,0,0, ,0,0,0,0, ,0,0,0,0, ,0,0,0, ,0,0,0,0, 
11739,CAN,1,Sanders Tyler ,S,0,0,0,-7.69,0,0,0,0,0, ,0,1,1,2,-50.00,0,0,11,11,0.00,0,0,1,1,0.00,2,1,4,25.00,17,0,42,59,28.81
11739,CAN,2,Perrin John Gordon ,OH,8,2,1,10.00,11,8,1,8,17,41.18,2,3,2,7,-14.29,1,3,12,16,-12.50,1,1,11,13,0.00,7,1,8,75.00,0,0,4,4,0.00
11739,CAN,3,Marshall Steven ,OH,0,0,0, ,0,0,0,0,0, ,0,0,0,0, ,0,0,0,0, ,0,0,0,0, ,0,0,0, ,0,0,0,0, 
11739,CAN,4,Hoag Nicholas ,OH,12,0,4,24.39,16,12,3,7,22,40.91,0,1,1,2,-50.00,4,2,11,17,11.76,5,1,14,20,20.00,2,2,7,0.00,0,0,1,1,0.00
11739,CAN,6,Pereira Jordan ,OH,0,0,0, ,0,0,0,0,0, ,0,0,0,0, ,0,0,0,0, ,0,0,0,0, ,0,0,0, ,0,0,0,0, 
11739,CAN,10,Sclater Ryan Joseph ,O,0,0,0, ,0,0,0,0,0, ,0,0,0,0, ,0,0,0,0, ,0,0,0,0, ,0,0,0, ,0,0,0,0, 
11739,CAN,11,Jansen Vandoorn Daniel ,MB,3,2,0,-4.55,5,3,2,1,6,16.67,2,4,0,6,-33.33,0,0,10,10,0.00,0,0,1,1,0.00,3,3,6,0.00,0,0,0,0, 
11739,CAN,12,Van Berkel Lucas ,MB,0,0,0, ,0,0,0,0,0, ,0,0,0,0, ,0,0,0,0, ,0,0,0,0, ,0,0,0, ,0,0,0,0, 
11739,CAN,13,Vernon-Evans Sharone ,O,9,3,0,5.41,12,9,2,8,19,36.84,3,6,0,9,-33.33,0,2,7,9,-22.22,0,0,0,0, ,2,1,3,33.33,0,0,4,4,0.00
11739,CAN,14,Loeppky Eric ,OH,0,0,0, ,0,0,0,0,0, ,0,0,0,0, ,0,0,0,0, ,0,0,0,0, ,0,0,0, ,0,0,0,0, 
11739,CAN,19,Bann Blair Cameron ,L,0,0,0, ,0,0,0,0,0, ,0,0,0,0, ,0,0,0,0, ,6,2,7,15,26.67,7,2,11,45.45,0,0,4,4,0.00
11739,CAN,20,Szwarc Arthur ,O,9,3,2,14.71,14,9,2,1,12,58.33,3,4,2,9,-11.11,2,3,8,13,-7.69,1,0,0,1,100.00,2,0,2,100.00,0,0,0,0, 
11739,CAN,21,Walsh Brett James ,S,0,0,0,-50.00,0,0,0,1,1,0.00,0,0,0,0, ,0,1,0,1,-100.00,0,0,0,0, ,0,0,0, ,0,0,2,2,0.00
11739,CAN,23,Demyanenko Danny ,MB,0,0,0, ,0,0,0,0,0, ,0,0,0,0, ,0,0,0,0, ,0,0,0,0, ,0,0,0, ,0,0,0,0, 
11739,BUL,1,Karyagin Denis ,O,0,0,0,-33.33,0,0,1,3,4,-25.00,0,0,0,0, ,0,1,1,2,-50.00,0,2,3,5,-40.00,1,0,1,100.00,0,0,0,0, 
11739,BUL,2,Chavdarov Stefan ,MB,3,0,0,-12.50,3,3,0,2,5,60.00,0,2,1,3,-66.67,0,3,5,8,-37.50,0,0,0,0, ,2,2,4,0.00,0,0,0,0, 
11739,BUL,3,Kolev Nikolay ,MB,0,0,0, ,0,0,0,0,0, ,0,0,0,0, ,0,0,0,0, ,0,0,0,0, ,1,0,1,100.00,0,0,0,0, 
11739,BUL,4,Atanasov Martin ,OH,0,0,0, ,0,0,0,0,0, ,0,0,0,0, ,0,0,0,0, ,0,0,0,0, ,0,0,0, ,0,0,0,0, 
11739,BUL,6,Stankov Vladimir ,S,0,0,0, ,0,0,0,0,0, ,0,0,0,0, ,0,0,0,0, ,0,0,0,0, ,0,0,0, ,0,0,0,0, 
11739,BUL,9,Seganov Georgi ,S,0,0,2,0.00,2,0,0,0,0, ,0,1,2,3,-33.33,2,1,16,19,5.26,0,0,0,0, ,4,3,7,14.29,15,0,53,68,22.06
11739,BUL,12,Petrov Georgi ,OH,1,0,0,50.00,1,1,0,0,1,100.00,0,0,0,0, ,0,0,1,1,0.00,2,0,4,6,33.33,0,1,2,-50.00,0,0,0,0, 
11739,BUL,14,Asparuhov Asparuh ,OH,6,1,0,-7.41,7,6,2,5,13,30.77,1,3,2,6,-33.33,0,4,4,8,-50.00,5,3,11,19,10.53,2,3,5,-20.00,0,0,3,3,0.00
11739,BUL,16,Ivanov Vladislav ,L,0,0,0, ,0,0,0,0,0, ,0,0,0,0, ,0,0,0,0, ,6,1,13,20,25.00,10,2,12,66.67,0,0,10,10,0.00
11739,BUL,19,Sokolov Tsvetan ,O,20,1,2,12.28,23,20,8,11,39,30.77,1,4,1,6,-50.00,2,4,6,12,-16.67,0,0,3,3,0.00,5,1,7,57.14,0,0,1,1,0.00
11739,BUL,22,Kartev Nikolay ,MB,4,2,0,8.00,6,4,3,3,10,10.00,2,1,1,4,25.00,0,0,11,11,0.00,0,0,0,0, ,1,2,3,-33.33,0,0,1,1,0.00
11739,BUL,24,Ivanov Martin ,L,0,0,0, ,0,0,0,0,0, ,0,0,0,0, ,0,0,0,0, ,0,0,0,0, ,0,0,0, ,0,0,0,0, 
11739,BUL,25,Parapunov Radoslav ,O,0,0,0, ,0,0,0,0,0, ,0,0,0,0, ,0,0,0,0, ,0,0,0,0, ,0,0,0, ,0,0,0,0, 
11739,BUL,26,Ivanov Svetoslav ,OH,5,0,0,0.00,5,5,1,5,11,36.36,0,2,1,3,-66.67,0,2,3,5,-40.00,6,1,6,13,38.46,2,0,2,100.00,0,0,0,0, 
11740,NED,2,Keemink Wessel ,S,1,0,0,0.00,1,1,0,0,1,100.00,0,1,1,2,-50.00,0,0,9,9,0.00,0,0,0,0, ,1,3,4,-50.00,13,0,59,72,18.06
11740,NED,4,Ter Horst Thijs ,OH,4,0,0,7.14,4,4,1,4,9,33.33,0,1,0,1,-100.00,0,1,3,4,-25.00,4,0,5,9,44.44,0,0,0, ,0,0,0,0, 
11740,NED,6,Dronkers Just ,L,0,0,0, ,0,0,0,0,0, ,0,0,0,0, ,0,0,0,0, ,5,0,9,14,35.71,5,2,8,37.50,0,0,4,4,0.00
11740,NED,7,Jorna Gijs ,OH,0,0,0,-23.08,0,0,2,4,6,-33.33,0,0,1,1,0.00,0,1,5,6,-16.67,5,1,6,12,33.33,1,5,6,-66.67,0,0,0,0, 
11740,NED,8,Plak Fabian ,MB,5,2,0,-3.85,7,5,2,5,12,25.00,2,3,0,5,-20.00,0,3,6,9,-33.33,0,0,0,0, ,2,0,2,100.00,0,0,0,0, 
11740,NED,10,van Zeist Maikel ,MB,3,3,0,31.58,6,3,0,4,7,42.86,3,0,3,6,50.00,0,0,6,6,0.00,0,0,0,0, ,0,0,0, ,0,0,0,0, 
11740,NED,12,Tuinstra Bennie Junior ,OH,5,1,2,14.29,8,5,2,12,19,15.79,1,0,0,1,100.00,2,2,4,8,0.00,10,1,10,21,42.86,4,2,6,33.33,0,0,1,1,0.00
11740,NED,13,Ottevanger Steven ,L,0,0,0, ,0,0,0,0,0, ,0,0,0,0, ,0,0,0,0, ,0,0,0,0, ,0,0,0, ,0,0,0,0, 
11740,NED,14,Abdel-Aziz Nimir ,O,17,1,4,20.00,22,17,6,7,30,36.67,1,3,1,5,-40.00,4,3,8,15,6.67,0,0,0,0, ,3,4,7,-14.29,0,0,1,1,0.00
11740,NED,15,van Solkema Gijs ,S,0,0,0,-100.00,0,0,0,0,0, ,0,1,0,1,-100.00,0,0,0,0, ,0,0,1,1,0.00,0,0,0, ,2,0,12,14,14.29
11740,NED,17,Parkinson Michael ,MB,0,0,0,0.00,0,0,0,0,0, ,0,0,0,0, ,0,0,1,1,0.00,0,0,0,0, ,0,0,0, ,0,0,0,0, 
11740,NED,18,Andringa Robbert ,L,0,0,0,-26.67,0,0,3,7,10,-30.00,0,0,0,0, ,0,1,4,5,-20.00,5,0,3,8,62.50,1,0,1,100.00,0,0,1,1,0.00
11740,NED,22,Wiltenburg Twan ,MB,0,0,0, ,0,0,0,0,0, ,0,0,0,0, ,0,0,0,0, ,0,0,0,0, ,0,0,0, ,0,0,0,0, 
11740,NED,25,van Tilburg Stijn ,OH,0,0,0,-100.00,0,0,1,0,1,-100.00,0,0,0,0, ,0,0,0,0, ,0,0,0,0, ,0,0,0, ,0,0,0,0, 
11740,ARG,1,Sanchez Matias ,S,0,0,0, ,0,0,0,0,0, ,0,0,0,0, ,0,0,0,0, ,0,0,0,0, ,0,0,0, ,0,0,0,0, 
11740,ARG,2,Pereyra Federico ,O,8,6,1,9.09,15,8,6,9,23,8.70,6,2,2,10,40.00,1,3,7,11,-18.18,0,0,0,0, ,2,5,7,-42.86,0,0,2,2,0.00
11740,ARG,3,Martinez Franchi Jan ,OH,0,0,0, ,0,0,0,0,0, ,0,0,0,0, ,0,0,0,0, ,0,0,0,0, ,0,0,0, ,0,0,0,0, 
11740,ARG,6,Poglajen Cristian ,OH,6,0,0,0.00,6,6,1,2,9,55.56,0,3,0,3,-100.00,0,2,12,14,-14.29,5,2,7,14,21.43,3,1,4,50.00,0,0,1,1,0.00
11740,ARG,7,Conte Facundo ,OH,12,2,0,22.50,14,12,1,12,25,44.00,2,2,1,5,0.00,0,2,8,10,-20.00,9,1,13,23,34.78,5,1,6,66.67,0,0,1,1,0.00
11740,ARG,8,Loser Agustin ,MB,8,1,1,14.29,10,8,1,1,10,70.00,1,3,2,6,-33.33,1,2,9,12,-8.33,1,0,0,1,100.00,0,1,1,-100.00,0,0,0,0, 
11740,ARG,11,SolÃ© Sebastian ,MB,8,1,0,29.17,9,8,0,2,10,80.00,1,2,1,4,-25.00,0,0,10,10,0.00,0,0,0,0, ,1,1,2,0.00,1,0,0,1,100.00
11740,ARG,13,Palacios Ezequiel ,OH,0,0,0, ,0,0,0,0,0, ,0,0,0,0, ,0,0,0,0, ,0,0,1,1,0.00,0,1,1,-100.00,0,0,0,0, 
11740,ARG,14,Crer Pablo ,MB,0,0,0, ,0,0,0,0,0, ,0,0,0,0, ,0,0,0,0, ,0,0,0,0, ,0,0,0, ,0,0,0,0, 
11740,ARG,15,De Cecco Luciano ,S,1,0,0,4.55,1,1,0,3,4,25.00,0,0,1,1,0.00,0,0,17,17,0.00,0,1,0,1,-100.00,1,2,3,-33.33,24,0,49,73,32.88
11740,ARG,16,Palonsky Luciano ,OH,0,0,0, ,0,0,0,0,0, ,0,0,0,0, ,0,0,0,0, ,0,0,0,0, ,0,0,0, ,0,0,0,0, 
11740,ARG,17,Mendez Nicolas ,OH,0,0,0, ,0,0,0,0,0, ,0,0,0,0, ,0,0,0,0, ,0,0,0,0, ,0,0,0, ,0,0,0,0, 
11740,ARG,18,Ramos Martin ,MB,0,0,0, ,0,0,0,0,0, ,0,0,0,0, ,0,0,0,0, ,0,0,0,0, ,0,0,0, ,0,0,0,0, 
11740,ARG,19,Massimino Franco ,L,0,0,0, ,0,0,0,0,0, ,0,0,0,0, ,0,0,0,0, ,2,2,8,12,0.00,9,3,13,46.15,0,0,3,3,0.00
11741,SLO,1,Å tern TonÄek ,O,12,1,0,9.09,13,12,2,5,19,52.63,1,6,2,9,-55.56,0,2,3,5,-40.00,0,0,0,0, ,3,0,3,100.00,0,0,1,1,0.00
11741,SLO,2,Pajenk Alen ,MB,5,0,0,0.00,5,5,2,3,10,30.00,0,1,9,10,-10.00,0,2,8,10,-20.00,1,0,2,3,33.33,2,0,2,100.00,0,0,1,1,0.00
11741,SLO,3,PernuÅ¡ Gregor ,S,0,0,0, ,0,0,0,0,0, ,0,0,0,0, ,0,0,0,0, ,0,0,0,0, ,0,0,0, ,3,1,2,6,33.33
11741,SLO,4,Kozamernik Jan ,MB,1,0,0,-30.43,1,1,3,1,5,-40.00,0,4,4,8,-50.00,0,1,9,10,-10.00,1,0,0,1,100.00,2,0,2,100.00,0,0,0,0, 
11741,SLO,5,Å ket Alen ,O,0,0,0,0.00,0,0,0,3,3,0.00,0,0,1,1,0.00,0,0,0,0, ,0,0,0,0, ,0,0,0, ,0,0,0,0, 
11741,SLO,6,Gasparini Mitja ,O,4,2,1,25.00,7,4,0,7,11,36.36,2,0,1,3,66.67,1,2,3,6,-16.67,0,0,0,0, ,7,1,9,66.67,0,0,1,1,0.00
11741,SLO,10,Å talekar SaÅ¡o ,MB,1,1,0,7.69,2,1,0,2,3,33.33,1,1,4,6,0.00,0,0,4,4,0.00,0,0,1,1,0.00,0,1,1,-100.00,0,0,0,0, 
11741,SLO,11,Å tern Å½iga ,OH,2,0,0,11.11,2,2,1,3,6,16.67,0,0,1,1,0.00,0,0,2,2,0.00,1,0,3,4,25.00,1,0,2,50.00,0,0,1,1,0.00
11741,SLO,12,Klobucar Jan ,L,0,0,0, ,0,0,0,0,0, ,0,0,0,0, ,0,0,0,0, ,0,0,0,0, ,0,0,0, ,0,0,0,0, 
11741,SLO,13,KovaÄiÄ Jani ,L,0,0,0, ,0,0,0,0,0, ,0,0,0,0, ,0,0,0,0, ,8,2,9,19,31.58,18,3,21,71.43,0,0,5,5,0.00
11741,SLO,16,Ropret Gregor ,S,1,0,2,-10.34,3,1,0,0,1,100.00,0,4,2,6,-66.67,2,2,18,22,0.00,0,0,0,0, ,8,4,13,30.77,35,0,61,96,36.46
11741,SLO,17,Urnaut Tine ,OH,11,0,1,2.08,12,11,6,14,31,16.13,0,2,1,3,-66.67,1,3,10,14,-14.29,3,0,12,15,20.00,8,2,10,60.00,1,0,2,3,33.33
11741,SLO,18,Äebulj Klemen ,OH,7,1,0,0.00,8,7,1,10,18,33.33,1,1,1,3,0.00,0,6,4,10,-60.00,9,4,6,19,26.32,4,2,6,33.33,0,0,0,0, 
11741,SLO,19,MoÅ¾iÄ Rok ,OH,3,0,1,10.00,4,3,1,1,5,40.00,0,0,1,1,0.00,1,2,1,4,-25.00,2,1,6,9,11.11,2,1,3,33.33,0,0,0,0, 
11741,GER,1,Fromm Christian ,OH,18,1,1,28.57,20,18,2,16,36,44.44,1,0,2,3,33.33,1,4,5,10,-30.00,7,2,8,17,29.41,7,0,7,100.00,0,0,1,1,0.00
11741,GER,3,Schott Ruben ,OH,9,0,2,12.50,11,9,3,5,17,35.29,0,1,1,2,-50.00,2,3,8,13,-7.69,3,1,11,15,13.33,8,4,14,28.57,0,1,5,6,-16.67
11741,GER,5,Reichert Moritz ,OH,0,0,0,0.00,0,0,0,0,0, ,0,0,0,0, ,0,0,2,2,0.00,0,0,2,2,0.00,1,0,1,100.00,1,0,0,1,100.00
11741,GER,7,Sossenheimer David ,OH,5,0,0,-12.00,5,5,2,6,13,23.08,0,3,1,4,-75.00,0,3,5,8,-37.50,1,2,6,9,-11.11,4,2,6,33.33,0,0,6,6,0.00
11741,GER,8,BÃ¶hme Marcus ,MB,0,0,0, ,0,0,0,0,0, ,0,0,0,0, ,0,0,0,0, ,0,0,0,0, ,0,0,0, ,0,0,0,0, 
11741,GER,10,Zenger Julian ,L,0,0,0, ,0,0,0,0,0, ,0,0,0,0, ,0,0,0,0, ,7,0,13,20,35.00,15,6,21,42.86,0,0,5,5,0.00
11741,GER,15,BaxpÃ¶hler Noah ,MB,0,0,0, ,0,0,0,0,0, ,0,0,0,0, ,0,0,0,0, ,0,0,0,0, ,0,0,0, ,0,0,0,0, 
11741,GER,16,BurggrÃ¤f Eric ,S,0,0,0, ,0,0,0,0,0, ,0,0,0,0, ,0,0,0,0, ,0,0,0,0, ,0,0,0, ,0,0,0,0, 
11741,GER,17,Zimmermann Jan ,S,1,1,0,-21.74,2,1,0,2,3,33.33,1,4,2,7,-42.86,0,3,10,13,-23.08,0,0,0,0, ,12,2,15,66.67,24,1,70,95,24.21
11741,GER,18,Krage Florian ,MB,1,1,1,-6.67,3,1,0,4,5,20.00,1,4,2,7,-42.86,1,1,16,18,0.00,0,0,2,2,0.00,3,2,5,20.00,0,0,1,1,0.00
11741,GER,19,RÃ¶hrs Erik ,OH,0,0,0, ,0,0,0,0,0, ,0,0,0,0, ,0,0,0,0, ,0,0,0,0, ,0,0,0, ,0,0,0,0, 
11741,GER,20,Weber Linus ,O,10,1,1,1.82,12,10,3,17,30,23.33,1,4,2,7,-42.86,1,4,13,18,-16.67,0,0,0,0, ,3,2,8,12.50,0,0,0,0, 
11741,GER,21,Krick Tobias ,MB,4,4,2,8.57,10,4,0,4,8,50.00,4,3,9,16,6.25,2,4,5,11,-18.18,1,0,1,2,50.00,2,0,2,100.00,0,0,0,0, 
11741,GER,25,Maase Lukas ,O,0,0,0, ,0,0,0,0,0, ,0,0,0,0, ,0,0,0,0, ,0,0,0,0, ,0,0,0, ,0,0,0,0, 
11742,FRA,1,Chinenyeze BarthÃ©lÃ©my ,MB,8,3,1,12.50,12,8,1,6,15,46.67,3,5,2,10,-20.00,1,1,13,15,0.00,1,0,0,1,100.00,3,0,3,100.00,0,0,1,1,0.00
11742,FRA,2,Grebennikov Jenia ,L,0,0,0, ,0,0,0,0,0, ,0,0,0,0, ,0,0,0,0, ,6,3,13,22,13.64,8,6,15,13.33,0,0,3,3,0.00
11742,FRA,4,Patry Jean ,O,16,2,1,4.76,19,16,4,16,36,33.33,2,4,0,6,-33.33,1,8,12,21,-33.33,0,0,0,0, ,2,3,6,-16.67,0,0,1,1,0.00
11742,FRA,7,Tillie Kevin ,OH,13,1,1,22.50,15,13,2,6,21,52.38,1,3,0,4,-50.00,1,1,13,15,0.00,7,1,12,20,30.00,1,2,3,-33.33,0,0,2,2,0.00
11742,FRA,8,Lyneel Julien ,OH,1,0,0,-14.29,1,1,2,2,5,-20.00,0,0,0,0, ,0,1,8,9,-11.11,1,0,4,5,20.00,1,0,1,100.00,0,0,0,0, 
11742,FRA,11,Brizard Antoine ,S,4,2,1,3.70,7,4,0,1,5,80.00,2,2,1,5,0.00,1,4,12,17,-17.65,0,0,0,0, ,3,5,8,-25.00,25,0,82,107,23.36
11742,FRA,14,Le Goff Nicolas ,MB,0,0,0, ,0,0,0,0,0, ,0,0,0,0, ,0,0,0,0, ,0,0,0,0, ,0,0,0, ,0,0,0,0, 
11742,FRA,16,Bultor Daryl ,MB,7,0,1,-3.85,8,7,3,1,11,36.36,0,5,0,5,-100.00,1,1,8,10,0.00,1,0,0,1,100.00,0,1,1,-100.00,0,0,0,0, 
11742,FRA,17,Clevenot Trevor ,OH,12,1,0,21.21,13,12,2,3,17,58.82,1,2,0,3,-33.33,0,2,11,13,-15.38,8,0,10,18,44.44,4,1,5,60.00,0,0,0,0, 
11742,FRA,19,Louati Yacine ,OH,4,0,1,0.00,5,4,2,6,12,16.67,0,2,0,2,-100.00,1,1,7,9,0.00,8,1,11,20,35.00,1,0,1,100.00,0,0,1,1,0.00
11742,FRA,20,Diez Benjamin ,L,0,0,0, ,0,0,0,0,0, ,0,0,0,0, ,0,0,0,0, ,0,0,0,0, ,1,0,1,100.00,0,0,0,0, 
11742,FRA,21,Faure ThÃ©o ,O,0,0,0, ,0,0,0,0,0, ,0,0,0,0, ,0,0,0,0, ,0,0,0,0, ,0,0,0, ,0,0,0,0, 
11742,FRA,23,Meyer LÃ©o ,S,0,0,0, ,0,0,0,0,0, ,0,0,0,0, ,0,0,0,0, ,0,0,0,0, ,0,0,0, ,0,0,0,0, 
11742,FRA,24,Gueye Mousse ,MB,0,0,0, ,0,0,0,0,0, ,0,0,0,0, ,0,0,0,0, ,0,0,0,0, ,0,0,0, ,0,0,0,0, 
11742,JPN,1,Shimizu Kunihiro ,O,16,1,1,6.67,18,16,7,13,36,25.00,1,5,3,9,-44.44,1,2,12,15,-6.67,0,0,0,0, ,2,2,5,0.00,1,0,0,1,100.00
11742,JPN,2,Onodera Taishi ,MB,8,2,2,16.22,12,8,0,5,13,61.54,2,2,0,4,0.00,2,4,14,20,-10.00,0,0,1,1,0.00,1,4,6,-50.00,0,0,0,0, 
11742,JPN,3,Fujii Naonobu ,S,0,0,0,-18.75,0,0,0,1,1,0.00,0,2,2,4,-50.00,0,1,10,11,-9.09,0,0,1,1,0.00,3,3,6,0.00,24,1,68,93,24.73
11742,JPN,5,Fukuzawa Tatsuya ,OH,0,0,0, ,0,0,0,0,0, ,0,0,0,0, ,0,0,0,0, ,0,0,0,0, ,0,0,0, ,0,0,0,0, 
11742,JPN,6,Yamauchi Akihiro ,MB,2,0,0,-16.67,2,2,1,1,4,25.00,0,2,1,3,-66.67,0,2,9,11,-18.18,0,0,0,0, ,0,0,0, ,0,0,1,1,0.00
11742,JPN,12,Sekita Masahiro ,S,0,0,0,-33.33,0,0,0,0,0, ,0,1,0,1,-100.00,0,0,2,2,0.00,0,0,1,1,0.00,0,1,1,-100.00,3,0,14,17,17.65
11742,JPN,14,Ishikawa Yuki ,OH,22,1,2,31.58,25,22,1,10,33,63.64,1,2,1,4,-25.00,2,4,14,20,-10.00,16,3,9,28,46.43,1,2,4,-25.00,1,0,4,5,20.00
11742,JPN,15,Ri Haku ,MB,0,0,0,0.00,0,0,0,0,0, ,0,0,0,0, ,0,0,1,1,0.00,0,0,0,0, ,0,1,1,-100.00,0,0,0,0, 
11742,JPN,16,Takahashi Kentaro ,MB,3,2,0,-5.88,5,3,1,2,6,33.33,2,3,0,5,-20.00,0,2,4,6,-33.33,0,0,0,0, ,0,1,1,-100.00,0,0,2,2,0.00
11742,JPN,17,Takanashi Kenta ,OH,8,0,0,7.41,8,8,4,4,16,25.00,0,0,2,2,0.00,0,2,7,9,-22.22,6,1,13,20,25.00,0,2,2,-100.00,0,0,0,0, 
11742,JPN,19,Otsuka Tatsunori ,OH,0,0,0,-20.00,0,0,1,2,3,-33.33,0,0,0,0, ,0,0,2,2,0.00,0,0,0,0, ,1,0,1,100.00,0,0,0,0, 
11742,JPN,20,Yamamoto Tomohiro ,L,0,0,0, ,0,0,0,0,0, ,0,0,0,0, ,0,0,0,0, ,12,2,8,22,45.45,8,3,11,45.45,0,0,2,2,0.00
11742,JPN,21,Takahashi Ran ,OH,4,1,0,-12.50,5,4,3,3,10,10.00,1,3,1,5,-40.00,0,2,7,9,-22.22,9,0,8,17,52.94,4,4,8,0.00,0,0,4,4,0.00
11742,JPN,24,Ogawa Tomohiro ,L,0,0,0, ,0,0,0,0,0, ,0,0,0,0, ,0,0,0,0, ,0,0,0,0, ,0,0,0, ,0,0,0,0, 
11743,BRA,1,Rezende Bruno Mossa ,S,1,2,0,4.35,3,1,0,0,1,100.00,2,2,2,6,0.00,0,0,16,16,0.00,0,0,0,0, ,6,1,9,55.56,39,1,41,81,46.91
11743,BRA,5,Borges Almeida Silva Mauricio ,OH,0,0,0, ,0,0,0,0,0, ,0,0,0,0, ,0,0,0,0, ,0,0,0,0, ,0,0,0, ,0,0,0,0, 
11743,BRA,6,Gil Kreling Fernando ,S,0,0,0, ,0,0,0,0,0, ,0,0,0,0, ,0,0,0,0, ,0,0,0,0, ,0,0,0, ,0,0,1,1,0.00
11743,BRA,8,De Souza Wallace ,O,0,0,0, ,0,0,0,0,0, ,0,0,0,0, ,0,0,0,0, ,0,0,0,0, ,0,0,0, ,0,0,0,0, 
11743,BRA,9,Leal Hidalgo Yoandy ,OH,0,0,0, ,0,0,0,0,0, ,0,0,0,0, ,0,0,0,0, ,0,0,0,0, ,0,0,0, ,0,0,0,0, 
11743,BRA,11,Kavalkievicz Gabriel ,OH,0,0,0, ,0,0,0,0,0, ,0,0,0,0, ,0,0,0,0, ,0,0,0,0, ,0,0,0, ,0,0,0,0, 
11743,BRA,12,Santos Isac ,MB,3,2,1,-12.00,6,3,2,1,6,16.67,2,3,2,7,-14.29,1,4,7,12,-25.00,0,0,0,0, ,0,0,0, ,0,0,0,0, 
11743,BRA,13,De Souza Mauricio Luiz ,MB,3,0,1,-15.38,4,3,0,2,5,60.00,0,6,2,8,-75.00,1,2,10,13,-7.69,2,0,4,6,33.33,0,0,0, ,0,0,1,1,0.00
11743,BRA,14,Correia De Souza Douglas ,OH,17,4,1,26.42,22,17,3,10,30,46.67,4,2,1,7,28.57,1,3,12,16,-12.50,8,0,11,19,42.11,3,1,5,40.00,0,0,4,4,0.00
11743,BRA,15,Nascimento Maique Reis ,L,0,0,0, ,0,0,0,0,0, ,0,0,0,0, ,0,0,0,0, ,0,0,0,0, ,3,4,7,-14.29,0,0,0,0, 
11743,BRA,17,Hoss Thales ,L,0,0,0, ,0,0,0,0,0, ,0,0,0,0, ,0,0,0,0, ,7,2,6,15,33.33,3,0,3,100.00,0,0,6,6,0.00
11743,BRA,18,Souza Ricardo Lucarelli ,OH,14,4,0,15.69,18,14,3,5,22,50.00,4,4,3,11,0.00,0,3,15,18,-16.67,12,2,20,34,29.41,7,0,8,87.50,0,0,2,2,0.00
11743,BRA,21,Souza Alan ,O,17,2,0,16.67,19,17,2,8,27,55.56,2,4,2,8,-25.00,0,5,8,13,-38.46,0,0,0,0, ,7,2,10,50.00,0,0,0,0, 
11743,BRA,23,Resende Gualberto Flavio ,MB,3,0,0,-22.73,3,3,1,2,6,33.33,0,5,2,7,-71.43,0,2,7,9,-22.22,0,0,0,0, ,1,0,2,50.00,0,0,0,0, 
11743,SRB,2,Kovacevic Uros ,OH,10,1,0,-6.12,11,10,5,11,26,19.23,1,5,2,8,-50.00,0,4,11,15,-26.67,10,2,24,36,22.22,5,3,9,22.22,0,0,5,5,0.00
11743,SRB,3,Kapur Milorad ,L,0,0,0, ,0,0,0,0,0, ,0,0,0,0, ,0,0,0,0, ,0,0,0,0, ,0,0,0, ,0,0,0,0, 
11743,SRB,6,Pekovic Nikola ,L,0,0,0, ,0,0,0,0,0, ,0,0,0,0, ,0,0,0,0, ,3,0,14,17,17.65,11,3,14,57.14,0,0,5,5,0.00
11743,SRB,7,Krsmanovic Petar ,MB,11,1,0,7.69,12,11,3,3,17,47.06,1,5,3,9,-44.44,0,1,12,13,-7.69,1,0,0,1,100.00,5,2,7,42.86,0,0,0,0, 
11743,SRB,8,Ivovic Marko ,OH,12,0,2,15.00,14,12,4,8,24,33.33,0,2,1,3,-66.67,2,2,9,13,0.00,14,1,9,24,54.17,7,1,11,54.55,0,0,1,1,0.00
11743,SRB,9,Jovovic Nikola ,S,0,1,0,-7.69,1,0,0,0,0, ,1,1,0,2,0.00,0,1,10,11,-9.09,0,0,0,0, ,2,2,4,0.00,26,0,39,65,40.00
11743,SRB,10,KujundÅ¾iÄ Miran ,OH,0,0,0, ,0,0,0,0,0, ,0,0,0,0, ,0,0,0,0, ,0,0,0,0, ,0,0,0, ,0,0,0,0, 
11743,SRB,12,Peric Pavle ,OH,0,0,0, ,0,0,0,0,0, ,0,0,0,0, ,0,0,0,0, ,0,0,0,0, ,0,0,0, ,0,0,0,0, 
11743,SRB,13,Simic Stevan ,MB,3,0,0,-6.67,3,3,0,1,4,75.00,0,3,1,4,-75.00,0,1,6,7,-14.29,0,0,0,0, ,1,0,1,100.00,0,0,0,0, 
11743,SRB,14,Atanasijevic Aleksandar ,O,10,1,1,5.00,12,10,8,6,24,8.33,1,1,2,4,0.00,1,1,10,12,0.00,0,0,0,0, ,1,1,3,0.00,0,0,1,1,0.00
11743,SRB,16,Luburic Drazen ,O,0,0,1,-53.85,1,0,5,3,8,-62.50,0,1,0,1,-100.00,1,2,1,4,-25.00,0,0,0,0, ,0,2,2,-100.00,0,0,0,0, 
11743,SRB,18,Podrascanin Marko ,MB,3,1,0,12.50,4,3,0,1,4,75.00,1,2,2,5,-20.00,0,0,7,7,0.00,0,0,0,0, ,1,1,2,0.00,0,0,0,0, 
11743,SRB,21,Todorovic Vuk ,S,0,1,0,0.00,1,0,0,1,1,0.00,1,1,1,3,0.00,0,0,4,4,0.00,0,0,0,0, ,2,1,3,33.33,12,0,20,32,37.50
11743,SRB,26,Kovac Davide ,OH,0,0,0, ,0,0,0,0,0, ,0,0,0,0, ,0,0,0,0, ,0,0,0,0, ,0,0,0, ,0,0,0,0, 
11744,RUS,2,Vlasov Ilia ,MB,0,0,0, ,0,0,0,0,0, ,0,0,0,0, ,0,0,0,0, ,0,0,0,0, ,0,0,0, ,0,0,0,0, 
11744,RUS,4,Volvich Artem ,MB,4,2,0,-7.14,6,4,1,3,8,37.50,2,6,3,11,-36.36,0,1,8,9,-11.11,1,0,2,3,33.33,2,0,2,100.00,0,0,0,0, 
11744,RUS,5,Semyshev Anton ,OH,0,0,0,-50.00,0,0,0,0,0, ,0,1,0,1,-100.00,0,0,1,1,0.00,0,1,5,6,-16.67,0,0,0, ,0,0,1,1,0.00
11744,RUS,6,Baranov Evgeny ,L,0,0,0, ,0,0,0,0,0, ,0,0,0,0, ,0,0,0,0, ,0,0,0,0, ,0,0,0, ,0,0,0,0, 
11744,RUS,7,Volkov Dmitry ,OH,12,1,1,11.36,14,12,3,10,25,36.00,1,1,3,5,0.00,1,5,8,14,-28.57,5,3,11,19,10.53,12,2,15,66.67,0,0,4,4,0.00
11744,RUS,10,Bogdan Denis ,OH,3,0,0,-25.00,3,3,3,2,8,0.00,0,2,2,4,-50.00,0,2,2,4,-50.00,3,1,7,11,18.18,1,0,1,100.00,0,0,4,4,0.00
11744,RUS,11,Pankov Pavel ,S,0,1,1,-15.38,2,0,0,0,0, ,1,3,2,6,-33.33,1,1,5,7,0.00,0,0,0,0, ,1,1,2,0.00,16,1,30,47,31.91
11744,RUS,13,Muserskiy Dmitriy ,MB,6,0,2,-3.45,8,6,0,3,9,66.67,0,3,3,6,-50.00,2,6,6,14,-28.57,0,1,0,1,-100.00,1,0,2,50.00,0,0,2,2,0.00
11744,RUS,15,Poletaev Victor ,O,0,0,0,-100.00,0,0,0,0,0, ,0,0,0,0, ,0,1,0,1,-100.00,0,0,0,0, ,0,0,0, ,0,0,0,0, 
11744,RUS,17,Mikhaylov Maxim ,O,16,0,2,13.21,18,16,8,8,32,25.00,0,1,1,2,-50.00,2,2,15,19,0.00,1,0,0,1,100.00,7,1,9,66.67,0,0,2,2,0.00
11744,RUS,18,Kliuka Egor ,OH,4,0,0,-10.53,4,4,4,4,12,0.00,0,1,2,3,-33.33,0,1,3,4,-25.00,2,2,6,10,0.00,1,1,2,0.00,0,0,1,1,0.00
11744,RUS,20,Kurkaev Ilyas ,MB,0,0,0, ,0,0,0,0,0, ,0,0,0,0, ,0,0,0,0, ,0,0,0,0, ,0,0,0, ,0,0,0,0, 
11744,RUS,24,Kobzar Igor ,S,0,0,0,-25.00,0,0,0,0,0, ,0,1,2,3,-33.33,0,1,4,5,-20.00,0,0,1,1,0.00,3,0,4,75.00,8,1,23,32,21.88
11744,RUS,27,Golubev Valentin ,L,0,0,0, ,0,0,0,0,0, ,0,0,0,0, ,0,0,0,0, ,6,4,16,26,7.69,6,3,10,30.00,0,0,1,1,0.00
11744,POL,1,Nowakowski Piotr ,MB,3,3,0,-4.76,6,3,1,1,5,40.00,3,6,4,13,-23.08,0,0,3,3,0.00,0,0,0,0, ,1,0,1,100.00,0,0,0,0, 
11744,POL,2,Muzaj Maciej ,O,9,2,1,4.65,12,9,2,8,19,36.84,2,4,5,11,-18.18,1,4,8,13,-23.08,0,1,0,1,-100.00,3,0,3,100.00,0,0,4,4,0.00
11744,POL,5,Kaczmarek Lukasz ,O,0,0,0,-50.00,0,0,0,0,0, ,0,1,0,1,-100.00,0,0,1,1,0.00,0,0,0,0, ,0,0,0, ,0,0,0,0, 
11744,POL,9,Leon Venero Wilfredo ,OH,16,2,7,25.00,25,16,3,13,32,40.62,2,3,1,6,-16.67,7,5,6,18,11.11,4,1,14,19,15.79,4,1,5,60.00,0,0,3,3,0.00
11744,POL,10,Wojtaszek Damian ,L,0,0,0, ,0,0,0,0,0, ,0,0,0,0, ,0,0,0,0, ,0,0,0,0, ,0,0,0, ,0,0,0,0, 
11744,POL,11,Drzyzga Fabian ,S,0,0,0,-35.71,0,0,0,0,0, ,0,2,1,3,-66.67,0,3,8,11,-27.27,0,0,0,0, ,6,2,8,50.00,26,0,40,66,39.39
11744,POL,12,Lomacz Grzegorz ,S,0,0,0, ,0,0,0,0,0, ,0,0,0,0, ,0,0,0,0, ,0,0,0,0, ,0,0,0, ,2,0,1,3,66.67
11744,POL,13,Kubiak Michal ,OH,8,2,1,21.21,11,8,2,9,19,31.58,2,1,0,3,33.33,1,1,9,11,0.00,1,2,11,14,-7.14,5,1,8,50.00,0,0,3,3,0.00
11744,POL,16,Semeniuk Kamil ,OH,0,0,0, ,0,0,0,0,0, ,0,0,0,0, ,0,0,0,0, ,0,0,0,0, ,0,0,0, ,0,0,0,0, 
11744,POL,17,Zatorski Pawel ,L,0,0,0, ,0,0,0,0,0, ,0,0,0,0, ,0,0,0,0, ,7,2,15,24,20.83,8,3,14,35.71,0,0,3,3,0.00
11744,POL,20,Bieniek Mateusz ,MB,2,0,2,4.55,4,2,0,0,2,100.00,0,0,2,2,0.00,2,3,13,18,-5.56,0,0,0,0, ,3,1,4,50.00,0,0,0,0, 
11744,POL,21,Fornal Tomasz ,OH,0,0,0, ,0,0,0,0,0, ,0,0,0,0, ,0,0,0,0, ,0,0,0,0, ,0,0,0, ,0,0,0,0, 
11744,POL,77,Klos Karol ,MB,4,3,1,0.00,8,4,1,1,6,50.00,3,6,4,13,-23.08,1,1,18,20,0.00,0,0,0,0, ,4,0,4,100.00,0,0,0,0, 
11744,POL,99,Huber Norbert ,MB,0,0,0, ,0,0,0,0,0, ,0,0,0,0, ,0,0,0,0, ,0,0,0,0, ,0,0,0, ,0,0,0,0, 
11745,USA,1,Anderson Matthew ,O,12,1,1,29.03,14,12,2,4,18,55.56,1,0,0,1,100.00,1,3,8,12,-16.67,2,0,6,8,25.00,4,2,8,25.00,0,0,2,2,0.00
11745,USA,4,Jendryk II Jeffrey ,MB,6,1,0,0.00,7,6,0,6,12,50.00,1,3,5,9,-22.22,0,4,4,8,-50.00,1,0,2,3,33.33,4,0,5,80.00,0,0,0,0, 
11745,USA,5,Ensing Kyle ,O,9,2,0,13.51,11,9,3,8,20,30.00,2,2,3,7,0.00,0,1,9,10,-10.00,0,0,0,0, ,4,1,5,60.00,0,0,1,1,0.00
11745,USA,6,Stahl Mitchell ,MB,0,0,0, ,0,0,0,0,0, ,0,0,0,0, ,0,0,0,0, ,0,0,0,0, ,0,0,0, ,0,0,0,0, 
11745,USA,7,Shoji Kawika ,S,0,0,0,0.00,0,0,0,0,0, ,0,0,0,0, ,0,0,1,1,0.00,0,0,0,0, ,0,1,1,-100.00,2,0,7,9,22.22
11745,USA,8,Defalco Torey ,OH,0,0,0, ,0,0,0,0,0, ,0,0,0,0, ,0,0,0,0, ,0,0,0,0, ,0,0,0, ,0,0,0,0, 
11745,USA,11,Christenson Micah ,S,2,1,1,-7.69,4,2,0,2,4,50.00,1,4,4,9,-33.33,1,2,10,13,-7.69,0,0,0,0, ,6,3,10,30.00,21,0,34,55,38.18
11745,USA,13,Patch Benjamin ,O,0,0,0, ,0,0,0,0,0, ,0,0,0,0, ,0,0,0,0, ,0,0,0,0, ,0,0,0, ,0,0,0,0, 
11745,USA,17,Jaeschke Thomas ,OH,4,1,3,9.38,8,4,3,8,15,6.67,1,1,0,2,0.00,3,1,11,15,13.33,11,0,17,28,39.29,1,1,3,0.00,0,0,1,1,0.00
11745,USA,18,Muagututia Garrett ,OH,0,0,0,-50.00,0,0,0,0,0, ,0,0,0,0, ,0,1,1,2,-50.00,0,0,0,0, ,0,0,0, ,0,0,0,0, 
11745,USA,19,Averill Taylor ,MB,0,0,0, ,0,0,0,0,0, ,0,0,0,0, ,0,0,0,0, ,0,0,0,0, ,0,0,0, ,0,0,0,0, 
11745,USA,20,Smith David ,MB,5,3,1,20.00,9,5,0,0,5,100.00,3,2,3,8,12.50,1,2,9,12,-8.33,0,0,0,0, ,3,0,4,75.00,0,0,0,0, 
11745,USA,21,Watten Dustin ,L,0,0,0, ,0,0,0,0,0, ,0,0,0,0, ,0,0,0,0, ,3,1,10,14,14.29,7,2,9,55.56,0,0,8,8,0.00
11745,USA,22,Shoji Erik ,L,0,0,0, ,0,0,0,0,0, ,0,0,0,0, ,0,0,0,0, ,0,0,0,0, ,0,0,0, ,0,0,0,0, 
11745,AUS,1,Graham Beau ,MB,7,0,0,-15.62,7,7,6,9,22,4.55,0,2,1,3,-66.67,0,4,3,7,-57.14,0,0,0,0, ,4,0,4,100.00,0,0,2,2,0.00
11745,AUS,2,Dosanjh Arshdeep ,S,2,0,0,-13.33,2,2,0,3,5,40.00,0,2,0,2,-100.00,0,2,6,8,-25.00,0,0,0,0, ,4,4,11,0.00,14,1,51,66,19.70
11745,AUS,7,Weir James ,MB,0,0,0,0.00,0,0,0,0,0, ,0,0,0,0, ,0,0,2,2,0.00,0,0,0,0, ,0,0,0, ,0,0,0,0, 
11745,AUS,8,O'Dea Trent ,MB,7,0,0,16.67,7,7,1,0,8,75.00,0,2,2,4,-50.00,0,0,12,12,0.00,0,0,0,0, ,2,0,4,50.00,0,0,1,1,0.00
11745,AUS,11,Perry Luke ,L,0,0,0, ,0,0,0,0,0, ,0,0,0,0, ,0,0,0,0, ,7,1,6,14,42.86,7,2,10,50.00,0,0,8,8,0.00
11745,AUS,12,Mote Nehemiah ,MB,3,0,0,-4.00,3,3,1,4,8,25.00,0,3,4,7,-42.86,0,0,10,10,0.00,0,0,0,0, ,3,3,7,0.00,0,0,3,3,0.00
11745,AUS,15,Smith Luke ,OH,6,0,0,2.94,6,6,2,9,17,23.53,0,3,2,5,-60.00,0,0,12,12,0.00,3,1,15,19,10.53,1,1,3,0.00,0,0,1,1,0.00
11745,AUS,21,Butler Nicholas ,S,0,0,0, ,0,0,0,0,0, ,0,0,0,0, ,0,0,0,0, ,0,0,0,0, ,0,0,0, ,0,0,0,0, 
11745,AUS,27,Senica Max ,OH,3,0,1,0.00,4,3,2,0,5,20.00,0,1,0,1,-100.00,1,1,1,3,0.00,1,0,6,7,14.29,0,0,0, ,0,0,0,0, 
11745,AUS,28,Taylor Tim ,OH,7,2,0,13.04,9,7,4,3,14,21.43,2,0,1,3,66.67,0,2,4,6,-33.33,2,3,13,18,-5.56,5,1,6,66.67,0,0,1,1,0.00
11745,AUS,31,Aubrey Matthew ,O,0,0,0, ,0,0,0,0,0, ,0,0,0,0, ,0,0,0,0, ,0,0,0,0, ,0,0,0, ,0,0,0,0, 
11745,AUS,32,Azeez Oluwatobi Elliot ,OH,1,0,0,-22.22,1,1,2,3,6,-16.67,0,1,0,1,-100.00,0,0,2,2,0.00,0,1,0,1,-100.00,2,0,2,100.00,0,0,2,2,0.00
11745,AUS,33,Flowerday Sam ,OH,0,0,0, ,0,0,0,0,0, ,0,0,0,0, ,0,0,0,0, ,0,0,0,0, ,0,0,0, ,0,0,0,0, 
11745,AUS,34,Greber Billy ,L,0,0,0, ,0,0,0,0,0, ,0,0,0,0, ,0,0,0,0, ,0,0,0,0, ,0,0,0, ,0,0,0,0, 
11746,BUL,1,Karyagin Denis ,O,6,0,0,-8.00,6,6,2,4,12,33.33,0,2,1,3,-66.67,0,4,6,10,-40.00,1,3,13,17,-11.76,4,1,6,50.00,0,0,4,4,0.00
11746,BUL,2,Chavdarov Stefan ,MB,3,1,1,-6.90,5,3,0,3,6,50.00,1,6,3,10,-50.00,1,1,11,13,0.00,0,0,0,0, ,1,1,2,0.00,0,0,0,0, 
11746,BUL,3,Kolev Nikolay ,MB,7,1,0,5.41,8,7,0,6,13,53.85,1,6,5,12,-41.67,0,0,12,12,0.00,0,0,0,0, ,0,1,1,-100.00,0,0,2,2,0.00
11746,BUL,4,Atanasov Martin ,OH,0,0,0, ,0,0,0,0,0, ,0,0,0,0, ,0,0,0,0, ,0,0,0,0, ,0,0,0, ,0,0,0,0, 
11746,BUL,6,Stankov Vladimir ,S,3,2,2,4.17,7,3,0,0,3,100.00,2,2,0,4,0.00,2,4,11,17,-11.76,0,0,1,1,0.00,6,0,7,85.71,26,0,56,82,31.71
11746,BUL,9,Seganov Georgi ,S,0,0,0, ,0,0,0,0,0, ,0,0,0,0, ,0,0,0,0, ,0,0,0,0, ,0,0,0, ,0,0,0,0, 
11746,BUL,10,Stankov Svetoslav ,S,0,0,0, ,0,0,0,0,0, ,0,0,0,0, ,0,0,0,0, ,0,0,0,0, ,0,0,0, ,0,0,0,0, 
11746,BUL,12,Petrov Georgi ,OH,8,0,0,-5.56,8,8,4,11,23,17.39,0,2,4,6,-33.33,0,4,3,7,-57.14,1,1,21,23,0.00,7,0,7,100.00,0,0,2,2,0.00
11746,BUL,14,Asparuhov Asparuh ,OH,3,0,1,-15.00,4,3,4,5,12,-8.33,0,1,1,2,-50.00,1,2,3,6,-16.67,1,1,5,7,0.00,2,2,4,0.00,0,0,1,1,0.00
11746,BUL,19,Sokolov Tsvetan ,O,0,0,0, ,0,0,0,0,0, ,0,0,0,0, ,0,0,0,0, ,0,0,0,0, ,0,0,0, ,0,0,0,0, 
11746,BUL,22,Kartev Nikolay ,MB,0,0,0,-100.00,0,0,0,0,0, ,0,2,0,2,-100.00,0,0,0,0, ,0,0,0,0, ,0,0,0, ,0,0,0,0, 
11746,BUL,24,Ivanov Martin ,L,0,0,0, ,0,0,0,0,0, ,0,0,0,0, ,0,0,0,0, ,5,0,14,19,26.32,9,0,9,100.00,0,0,1,1,0.00
11746,BUL,25,Parapunov Radoslav ,O,10,1,0,-7.14,11,10,8,11,29,6.90,1,2,1,4,-25.00,0,4,5,9,-44.44,0,0,1,1,0.00,6,1,7,71.43,0,0,1,1,0.00
11746,BUL,26,Ivanov Svetoslav ,OH,0,0,0, ,0,0,0,0,0, ,0,0,0,0, ,0,0,0,0, ,0,0,0,0, ,0,0,0, ,0,0,0,0, 
11746,IRI,3,Abedini Reza ,MB,1,4,0,-10.00,5,1,1,0,2,0.00,4,6,3,13,-15.38,0,1,14,15,-6.67,0,0,1,1,0.00,3,1,5,40.00,0,0,1,1,0.00
11746,IRI,4,Marouflakrani Mir Saeid ,S,0,0,0,0.00,0,0,0,0,0, ,0,0,1,1,0.00,0,0,3,3,0.00,0,0,1,1,0.00,4,1,5,60.00,3,0,13,16,18.75
11746,IRI,6,Mousavi Eraghi Seyed Mohammad ,MB,4,3,3,2.70,10,4,1,4,9,33.33,3,5,6,14,-14.29,3,3,8,14,0.00,0,0,1,1,0.00,6,0,7,85.71,0,0,1,1,0.00
11746,IRI,7,Fayazi D. Purya ,OH,0,0,0,0.00,0,0,0,3,3,0.00,0,0,3,3,0.00,0,0,2,2,0.00,0,0,1,1,0.00,0,0,0, ,0,0,0,0, 
11746,IRI,8,Hazratpourtalatappeh Mohammadreza ,L,0,0,0, ,0,0,0,0,0, ,0,0,0,0, ,0,0,0,0, ,4,2,11,17,11.76,6,4,12,16.67,0,0,2,2,0.00
11746,IRI,9,Gholami Masoud ,MB,0,0,0, ,0,0,0,0,0, ,0,0,0,0, ,0,0,0,0, ,0,0,0,0, ,0,0,0, ,0,0,0,0, 
11746,IRI,11,Kazemi Saber ,O,2,0,0,10.00,2,2,1,5,8,12.50,0,0,0,0, ,0,0,2,2,0.00,0,0,0,0, ,0,0,0, ,0,0,1,1,0.00
11746,IRI,12,Sharifi Morteza ,OH,0,0,0, ,0,0,0,0,0, ,0,0,0,0, ,0,0,0,0, ,0,0,0,0, ,0,0,0, ,0,0,0,0, 
11746,IRI,15,Mojarad Aliasghar ,MB,0,0,0, ,0,0,0,0,0, ,0,0,0,0, ,0,0,0,0, ,0,0,0,0, ,0,0,0, ,0,0,0,0, 
11746,IRI,17,Salehi Meisam ,OH,9,0,0,12.90,9,9,1,3,13,61.54,0,1,3,4,-25.00,0,3,11,14,-21.43,3,1,10,14,14.29,6,0,7,85.71,0,0,1,1,0.00
11746,IRI,18,Vadi Mohammad Taher ,S,1,0,0,-7.14,1,1,0,0,1,100.00,0,2,1,3,-66.67,0,0,10,10,0.00,0,0,0,0, ,1,1,3,0.00,12,0,41,53,22.64
11746,IRI,21,Salehi Arman ,L,0,0,0, ,0,0,0,0,0, ,0,0,0,0, ,0,0,0,0, ,0,0,0,0, ,0,0,0, ,0,0,0,0, 
11746,IRI,22,Esfandiar Amirhossein ,OH,9,1,1,4.65,11,9,4,8,21,23.81,1,3,5,9,-22.22,1,2,10,13,-7.69,3,1,16,20,10.00,2,1,3,33.33,0,0,0,0, 
11746,IRI,23,Saadat Bardia ,O,15,1,1,14.29,17,15,3,3,21,57.14,1,4,0,5,-60.00,1,5,3,9,-44.44,0,0,0,0, ,1,0,2,50.00,0,0,2,2,0.00
11747,CAN,1,Sanders Tyler ,S,0,0,0,-16.67,0,0,0,0,0, ,0,0,2,2,0.00,0,1,3,4,-25.00,0,0,0,0, ,2,0,3,66.67,4,0,22,26,15.38
11747,CAN,2,Perrin John Gordon ,OH,9,1,0,28.00,10,9,1,8,18,44.44,1,2,1,4,-25.00,0,0,3,3,0.00,3,2,2,7,14.29,1,0,1,100.00,0,0,2,2,0.00
11747,CAN,3,Marshall Steven ,OH,0,0,0, ,0,0,0,0,0, ,0,0,0,0, ,0,0,0,0, ,0,0,0,0, ,0,0,0, ,0,0,0,0, 
11747,CAN,4,Hoag Nicholas ,OH,16,1,1,1.49,18,16,10,16,42,14.29,1,2,0,3,-33.33,1,5,16,22,-18.18,16,0,18,34,47.06,5,0,6,83.33,0,0,7,7,0.00
11747,CAN,6,Pereira Jordan ,OH,0,0,0, ,0,0,0,0,0, ,0,0,0,0, ,0,0,0,0, ,0,0,0,0, ,0,0,0, ,0,0,0,0, 
11747,CAN,8,Blankenau Jay ,S,1,0,1,-9.52,2,1,0,3,4,25.00,0,3,2,5,-60.00,1,1,10,12,0.00,0,0,0,0, ,5,5,11,0.00,23,0,62,85,27.06
11747,CAN,10,Sclater Ryan Joseph ,O,2,0,1,-27.59,3,2,6,8,16,-25.00,0,4,3,7,-57.14,1,1,4,6,0.00,0,0,0,0, ,4,0,4,100.00,0,0,0,0, 
11747,CAN,11,Jansen Vandoorn Daniel ,MB,5,1,0,-11.11,6,5,2,4,11,27.27,1,5,1,7,-57.14,0,2,7,9,-22.22,0,0,2,2,0.00,3,1,4,50.00,0,0,2,2,0.00
11747,CAN,12,Van Berkel Lucas ,MB,6,2,0,3.03,8,6,1,3,10,50.00,2,6,3,11,-36.36,0,0,12,12,0.00,0,0,1,1,0.00,4,2,6,33.33,0,0,1,1,0.00
11747,CAN,13,Vernon-Evans Sharone ,O,6,2,4,-2.78,12,6,5,3,14,7.14,2,2,1,5,0.00,4,6,7,17,-11.76,0,0,0,0, ,9,0,10,90.00,0,0,1,1,0.00
11747,CAN,14,Loeppky Eric ,OH,13,1,1,6.38,15,13,6,6,25,28.00,1,4,2,7,-42.86,1,2,12,15,-6.67,7,1,16,24,25.00,9,1,10,80.00,0,0,2,2,0.00
11747,CAN,19,Bann Blair Cameron ,L,0,0,0, ,0,0,0,0,0, ,0,0,0,0, ,0,0,0,0, ,9,2,15,26,26.92,13,3,16,62.50,0,0,15,15,0.00
11747,CAN,20,Szwarc Arthur ,O,3,0,0,-9.09,3,3,3,0,6,0.00,0,0,0,0, ,0,1,4,5,-20.00,0,0,1,1,0.00,0,2,2,-100.00,0,0,0,0, 
11747,CAN,23,Demyanenko Danny ,MB,0,0,0, ,0,0,0,0,0, ,0,0,0,0, ,0,0,0,0, ,0,0,0,0, ,0,0,0, ,0,0,0,0, 
11747,ITA,1,Gardini Davide ,OH,0,0,0, ,0,0,0,0,0, ,0,0,0,0, ,0,0,0,0, ,0,0,0,0, ,0,0,0, ,0,0,0,0, 
11747,ITA,7,Balaso Fabio ,L,0,0,0, ,0,0,0,0,0, ,0,0,0,0, ,0,0,0,0, ,0,3,10,13,-23.08,1,1,4,0.00,0,0,5,5,0.00
11747,ITA,11,Galassi Gianluca ,MB,1,0,0,-42.86,1,1,0,0,1,100.00,0,2,1,3,-66.67,0,2,1,3,-66.67,0,0,0,0, ,0,0,0, ,0,0,0,0, 
11747,ITA,15,Sbertoli Riccardo ,S,0,0,0, ,0,0,0,0,0, ,0,0,0,0, ,0,0,0,0, ,0,0,0,0, ,1,1,2,0.00,1,0,2,3,33.33
11747,ITA,18,Michieletto Alessandro ,OH,2,0,0,40.00,2,2,0,2,4,50.00,0,0,0,0, ,0,0,1,1,0.00,0,0,2,2,0.00,0,1,1,-100.00,0,0,0,0, 
11747,ITA,20,Nelli Gabriele ,O,17,0,2,15.79,19,17,3,13,33,42.42,0,2,2,4,-50.00,2,5,13,20,-15.00,0,0,0,0, ,6,3,10,30.00,0,0,4,4,0.00
11747,ITA,21,Spirito Luca ,S,0,3,0,0.00,3,0,1,3,4,-25.00,3,1,4,8,25.00,0,1,10,11,-9.09,0,0,0,0, ,11,3,14,57.14,10,1,75,86,10.47
11747,ITA,23,Pinali Giulio ,O,0,0,0, ,0,0,0,0,0, ,0,0,0,0, ,0,0,0,0, ,0,0,0,0, ,0,0,0, ,0,0,0,0, 
11747,ITA,24,Cavuto Oreste ,OH,0,0,0, ,0,0,0,0,0, ,0,0,0,0, ,0,0,0,0, ,0,0,0,0, ,0,0,0, ,0,0,0,0, 
11747,ITA,26,Cortesia Lorenzo ,MB,1,5,1,2.22,7,1,0,2,3,33.33,5,5,6,16,0.00,1,1,24,26,0.00,0,0,1,1,0.00,2,0,2,100.00,0,0,0,0, 
11747,ITA,28,Recine Francesco ,OH,16,3,0,20.37,19,16,4,12,32,37.50,3,2,3,8,12.50,0,2,12,14,-14.29,15,2,21,38,34.21,5,5,14,0.00,0,0,2,2,0.00
11747,ITA,29,Bottolo Mattia ,OH,10,2,2,0.00,14,10,7,11,28,10.71,2,3,4,9,-11.11,2,4,17,23,-8.70,4,2,13,19,10.53,5,2,8,37.50,0,0,3,3,0.00
11747,ITA,30,Mosca Leandro Ausibio ,MB,3,5,0,3.12,8,3,0,1,4,75.00,5,6,4,15,-6.67,0,1,12,13,-7.69,0,0,0,0, ,0,1,1,-100.00,0,0,3,3,0.00
11747,ITA,31,Federici Filippo ,L,0,0,0, ,0,0,0,0,0, ,0,0,0,0, ,0,0,0,0, ,4,1,8,13,23.08,5,4,10,10.00,0,0,4,4,0.00
11878,CHN,3,Diao Linyu ,S,0,0,0, ,0,0,0,0,0, ,0,0,0,0, ,0,0,0,0, ,0,0,1,1,0.00,1,0,1,100.00,1,0,6,7,14.29
11878,CHN,4,Yang Hanyu ,MB,12,3,0,-2.00,15,12,7,5,24,20.83,3,8,5,16,-31.25,0,1,9,10,-10.00,1,0,0,1,100.00,2,0,2,100.00,0,1,2,3,-33.33
11878,CHN,5,Gao Yi ,MB,0,0,0, ,0,0,0,0,0, ,0,0,0,0, ,0,0,0,0, ,0,0,0,0, ,0,0,0, ,0,0,0,0, 
11878,CHN,7,Wang Yuanyuan ,MB,14,1,0,10.00,15,14,1,5,20,65.00,1,8,3,12,-58.33,0,1,17,18,-5.56,0,1,0,1,-100.00,4,0,4,100.00,0,0,5,5,0.00
11878,CHN,8,Li Yao ,OH,12,0,0,-5.00,12,12,7,22,41,12.20,0,5,2,7,-71.43,0,3,9,12,-25.00,5,3,6,14,14.29,16,1,19,78.95,0,0,6,6,0.00
11878,CHN,9,Zhang Changning ,OH,35,2,0,18.75,37,35,9,33,77,33.77,2,6,5,13,-30.77,0,1,21,22,-4.55,1,1,12,14,0.00,9,1,13,61.54,0,0,6,6,0.00
11878,CHN,10,Liu Xiaotong ,OH,1,0,0,-21.43,1,1,2,6,9,-11.11,0,1,0,1,-100.00,0,1,3,4,-25.00,3,1,11,15,13.33,6,0,6,100.00,0,0,2,2,0.00
11878,CHN,11,Yao Di ,S,0,0,0,-12.50,0,0,0,1,1,0.00,0,3,4,7,-42.86,0,1,23,24,-4.17,0,0,0,0, ,16,2,19,73.68,50,1,90,141,34.75
11878,CHN,14,Zheng Yixin ,MB,0,0,0, ,0,0,0,0,0, ,0,0,0,0, ,0,0,0,0, ,0,0,0,0, ,0,0,0, ,0,0,0,0, 
11878,CHN,15,Lin Li ,L,0,0,0, ,0,0,0,0,0, ,0,0,0,0, ,0,0,0,0, ,0,2,6,8,-25.00,3,1,4,50.00,0,0,4,4,0.00
11878,CHN,18,Wang Mengjie ,L,0,0,0, ,0,0,0,0,0, ,0,0,0,0, ,0,0,0,0, ,8,0,16,24,33.33,28,4,36,66.67,0,0,13,13,0.00
11878,CHN,19,Liu Yanhan ,OH,2,0,0,14.29,2,2,0,4,6,33.33,0,0,0,0, ,0,1,0,1,-100.00,0,0,0,0, ,1,1,2,0.00,0,0,0,0, 
11878,CHN,22,Duan Fang ,OH,4,0,0,-10.34,4,4,5,5,14,-7.14,0,1,1,2,-50.00,0,1,12,13,-7.69,5,1,17,23,17.39,14,1,16,81.25,0,0,2,2,0.00
11878,BEL,2,Van Sas Elise ,S,0,2,0,25.00,2,0,0,0,0, ,2,0,0,2,100.00,0,0,6,6,0.00,0,0,0,0, ,0,1,1,-100.00,4,0,12,16,25.00
11878,BEL,3,Herbots Britt ,OH,26,1,1,17.65,28,26,8,33,67,26.87,1,3,1,5,-40.00,1,2,10,13,-7.69,2,0,3,5,40.00,7,4,13,23.08,0,0,2,2,0.00
11878,BEL,4,Lemmens Nathalie ,MB,0,0,0, ,0,0,0,0,0, ,0,0,0,0, ,0,0,0,0, ,0,0,0,0, ,0,0,0, ,0,0,0,0, 
11878,BEL,5,Guilliams Jodie ,OH,2,0,2,-2.94,4,2,2,14,18,0.00,0,2,5,7,-28.57,2,1,6,9,11.11,3,0,13,16,18.75,12,3,15,60.00,0,0,4,4,0.00
11878,BEL,6,Gilson Helena ,OH,0,0,0,-50.00,0,0,1,2,3,-33.33,0,1,0,1,-100.00,0,0,0,0, ,0,0,1,1,0.00,0,0,0, ,0,0,0,0, 
11878,BEL,7,Van Gestel Celine ,OH,11,1,3,6.67,15,11,4,13,28,25.00,1,7,7,15,-40.00,3,0,14,17,17.65,12,0,31,43,27.91,11,2,14,64.29,0,0,2,2,0.00
11878,BEL,9,Demeyer Nel ,L,0,0,0, ,0,0,0,0,0, ,0,0,0,0, ,0,0,0,0, ,0,0,0,0, ,0,0,0, ,0,0,0,0, 
11878,BEL,10,Sobolska Dominika ,MB,0,0,0,-50.00,0,0,1,1,2,-50.00,0,0,0,0, ,0,0,0,0, ,0,0,0,0, ,1,0,1,100.00,0,0,0,0, 
11878,BEL,13,Janssens Marlies ,MB,7,9,1,18.87,17,7,0,11,18,38.89,9,5,6,20,20.00,1,2,12,15,-6.67,0,0,0,0, ,1,1,2,0.00,0,0,2,2,0.00
11878,BEL,15,Van De Vyver Jutta ,S,0,0,0, ,0,0,0,0,0, ,0,0,0,0, ,0,0,0,0, ,0,0,0,0, ,0,0,0, ,0,0,0,0, 
11878,BEL,17,Van De Vyver Ilka ,S,0,0,0,-10.00,0,0,0,1,1,0.00,0,2,0,2,-100.00,0,0,17,17,0.00,0,0,0,0, ,16,3,22,59.09,33,0,87,120,27.50
11878,BEL,18,Rampelberg Britt ,L,0,0,0, ,0,0,0,0,0, ,0,0,0,0, ,0,0,0,0, ,10,0,14,24,41.67,23,5,33,54.55,0,1,11,12,-8.33
11878,BEL,19,Van Avermaet Silke ,MB,9,4,1,12.50,14,9,0,14,23,39.13,4,6,2,12,-16.67,1,1,19,21,0.00,1,0,0,1,100.00,3,1,6,33.33,0,0,3,3,0.00
11878,BEL,21,Stragier Manon ,OH,0,0,1,-6.67,1,0,1,4,5,-20.00,0,1,0,1,-100.00,1,0,8,9,11.11,1,0,3,4,25.00,3,1,6,33.33,0,0,2,2,0.00
11879,JPN,1,Kurogo Ai ,OH,18,0,1,32.65,19,18,2,16,36,44.44,0,1,1,2,-50.00,1,0,10,11,9.09,0,0,1,1,0.00,9,3,14,42.86,0,0,2,2,0.00
11879,JPN,2,Koga Sarina ,OH,10,0,0,4.55,10,10,5,14,29,17.24,0,1,3,4,-25.00,0,2,9,11,-18.18,2,0,6,8,25.00,10,1,13,69.23,0,0,1,1,0.00
11879,JPN,5,Araki Erika ,MB,6,3,1,10.00,10,6,1,8,15,33.33,3,5,3,11,-18.18,1,0,13,14,7.14,0,0,0,0, ,1,1,6,0.00,0,0,2,2,0.00
11879,JPN,7,Ishii Yuki ,OH,0,0,0,-20.00,0,0,1,3,4,-25.00,0,0,0,0, ,0,0,1,1,0.00,2,1,2,5,20.00,0,1,1,-100.00,0,0,0,0, 
11879,JPN,8,Ishikawa Mayu ,OH,5,0,0,-3.85,5,5,5,7,17,0.00,0,0,1,1,0.00,0,1,7,8,-12.50,6,1,20,27,18.52,9,4,15,33.33,0,0,2,2,0.00
11879,JPN,9,Tashiro Kanami ,S,0,0,0, ,0,0,0,0,0, ,0,0,0,0, ,0,0,0,0, ,0,0,0,0, ,0,0,0, ,0,0,0,0, 
11879,JPN,10,Akutagawa Aika ,MB,0,0,0, ,0,0,0,0,0, ,0,0,0,0, ,0,0,0,0, ,0,0,0,0, ,0,0,0, ,0,0,0,0, 
11879,JPN,11,Nabeya Yurie ,OH,0,0,0, ,0,0,0,0,0, ,0,0,0,0, ,0,0,0,0, ,0,0,0,0, ,0,0,0, ,0,0,0,0, 
11879,JPN,13,Okumura Mai ,MB,0,0,0, ,0,0,0,0,0, ,0,0,0,0, ,0,0,0,0, ,0,0,0,0, ,0,0,0, ,0,0,0,0, 
11879,JPN,14,Kobata Mako ,L,0,0,0, ,0,0,0,0,0, ,0,0,0,0, ,0,0,0,0, ,4,1,8,13,23.08,13,2,15,73.33,0,0,3,3,0.00
11879,JPN,15,Inoue Kotoe ,L,0,0,0, ,0,0,0,0,0, ,0,0,0,0, ,0,0,0,0, ,3,0,3,6,50.00,3,1,4,50.00,0,0,5,5,0.00
11879,JPN,19,Yamada Nichika ,MB,3,1,0,-12.50,4,3,3,7,13,0.00,1,5,5,11,-36.36,0,0,8,8,0.00,0,0,0,0, ,2,2,5,0.00,0,0,0,0, 
11879,JPN,21,Hayashi Kotona ,OH,0,0,0,0.00,0,0,0,0,0, ,0,0,0,0, ,0,0,1,1,0.00,0,1,4,5,-20.00,1,0,1,100.00,0,0,1,1,0.00
11879,JPN,24,Momii Aki ,S,0,0,0,-6.25,0,0,0,2,2,0.00,0,1,1,2,-50.00,0,0,12,12,0.00,0,0,0,0, ,7,1,9,66.67,35,2,61,98,33.67
11879,NED,1,Knip Kirsten ,L,0,0,0, ,0,0,0,0,0, ,0,0,0,0, ,0,0,0,0, ,0,0,0,0, ,0,0,0, ,0,0,0,0, 
11879,NED,2,Savelkoel Fleur ,OH,0,0,0, ,0,0,0,0,0, ,0,0,0,0, ,0,0,0,0, ,0,0,0,0, ,0,0,0, ,0,0,0,0, 
11879,NED,4,Plak Celeste ,OH,0,0,0,-25.00,0,0,0,2,2,0.00,0,0,0,0, ,0,1,1,2,-50.00,0,0,0,0, ,3,1,4,50.00,0,0,0,0, 
11879,NED,7,Lohuis Juliet ,MB,5,3,0,5.56,8,5,2,9,16,18.75,3,3,7,13,0.00,0,1,6,7,-14.29,0,0,1,1,0.00,1,0,3,33.33,0,0,0,0, 
11879,NED,9,Schoot Myrthe ,L,0,0,0, ,0,0,0,0,0, ,0,0,0,0, ,0,0,0,0, ,4,1,2,7,42.86,13,2,17,64.71,0,0,14,14,0.00
11879,NED,10,van Aalen Sarah ,S,0,0,0, ,0,0,0,0,0, ,0,0,0,0, ,0,0,0,0, ,0,0,0,0, ,0,0,0, ,0,0,0,0, 
11879,NED,11,Buijs Anne ,OH,3,0,0,-15.00,3,3,3,7,13,0.00,0,2,0,2,-100.00,0,1,4,5,-20.00,4,0,11,15,26.67,4,1,6,50.00,0,0,1,1,0.00
11879,NED,12,Bongaerts Britt ,S,1,0,0,-16.00,1,1,0,3,4,25.00,0,3,5,8,-37.50,0,2,11,13,-15.38,0,0,0,0, ,6,1,10,50.00,35,0,60,95,36.84
11879,NED,16,Baijens Indy ,MB,0,0,0, ,0,0,0,0,0, ,0,0,0,0, ,0,0,0,0, ,0,0,0,0, ,0,0,0, ,0,0,0,0, 
11879,NED,18,Jasper Marrit ,OH,5,0,0,0.00,5,5,3,9,17,11.76,0,1,3,4,-25.00,0,1,9,10,-10.00,7,0,4,11,63.64,10,1,11,81.82,0,0,0,0, 
11879,NED,19,Daalderop Nika ,OH,19,1,2,28.30,22,19,3,14,36,44.44,1,2,1,4,-25.00,2,2,9,13,0.00,4,1,24,29,10.34,4,2,10,20.00,0,0,0,0, 
11879,NED,23,Timmerman Eline ,MB,7,3,2,28.12,12,7,1,2,10,60.00,3,2,6,11,9.09,2,0,9,11,18.18,0,0,0,0, ,3,0,3,100.00,0,0,0,0, 
11879,NED,26,Dambrink Elles ,O,8,2,0,24.24,10,8,0,9,17,47.06,2,1,0,3,33.33,0,1,12,13,-7.69,0,0,0,0, ,10,0,10,100.00,0,0,1,1,0.00
11879,NED,27,Scholten Iris ,O,0,0,0, ,0,0,0,0,0, ,0,0,0,0, ,0,0,0,0, ,0,0,0,0, ,0,0,0, ,0,0,0,0, 
11880,TUR,2,Akoz Simge Sebnem ,L,0,0,0, ,0,0,0,0,0, ,0,0,0,0, ,0,0,0,0, ,4,0,11,15,26.67,23,3,26,76.92,0,0,8,8,0.00
11880,TUR,3,Ãzbay Cansu ,S,3,0,2,4.17,5,3,0,0,3,100.00,0,2,1,3,-66.67,2,2,14,18,0.00,0,0,0,0, ,5,1,6,66.67,42,0,59,101,41.58
11880,TUR,4,Senoglu Tugba ,OH,10,3,0,19.51,13,10,4,7,21,28.57,3,0,2,5,60.00,0,1,14,15,-6.67,10,0,16,26,38.46,17,1,19,84.21,0,0,1,1,0.00
11880,TUR,5,Ercan Seyma ,OH,4,0,1,17.65,5,4,1,2,7,42.86,0,0,0,0, ,1,1,8,10,0.00,5,0,2,7,71.43,5,0,5,100.00,0,0,0,0, 
11880,TUR,6,Caliskan Kubra ,MB,0,1,1,-40.00,2,0,2,0,2,-100.00,1,5,2,8,-50.00,1,1,3,5,0.00,0,0,0,0, ,0,0,0, ,0,0,0,0, 
11880,TUR,7,Baladin Hande ,OH,12,1,3,12.50,16,12,5,13,30,23.33,1,3,0,4,-50.00,3,2,9,14,7.14,4,0,12,16,25.00,6,1,8,62.50,0,0,2,2,0.00
11880,TUR,8,Guveli Yasemin ,MB,5,4,1,15.15,10,5,1,2,8,50.00,4,3,3,10,10.00,1,1,13,15,0.00,0,0,0,0, ,2,0,3,66.67,0,0,0,0, 
11880,TUR,9,Ismailoglu Meliha ,OH,0,0,0, ,0,0,0,0,0, ,0,0,0,0, ,0,0,0,0, ,0,0,0,0, ,0,0,0, ,0,0,0,0, 
11880,TUR,10,Aykac Ayca ,L,0,0,0, ,0,0,0,0,0, ,0,0,0,0, ,0,0,0,0, ,0,0,0,0, ,0,0,0, ,0,0,0,0, 
11880,TUR,11,Aydemir Akyol Naz ,S,0,0,0, ,0,0,0,0,0, ,0,0,0,0, ,0,0,0,0, ,0,0,0,0, ,0,0,0, ,5,0,6,11,45.45
11880,TUR,13,Boz Meryem ,O,22,0,2,23.08,24,22,3,15,40,47.50,0,4,6,10,-40.00,2,2,11,15,0.00,0,0,0,0, ,8,1,11,63.64,0,1,0,1,-100.00
11880,TUR,14,Erdem DÃ¼ndar Eda ,MB,5,5,1,34.78,11,5,2,2,9,33.33,5,0,4,9,55.56,1,1,3,5,0.00,0,0,0,0, ,0,0,0, ,0,0,2,2,0.00
11880,TUR,19,Kalac Asli ,MB,0,0,0, ,0,0,0,0,0, ,0,0,0,0, ,0,0,0,0, ,0,0,0,0, ,0,0,0, ,0,0,0,0, 
11880,TUR,99,Karakurt Ebrar ,OH,5,0,0,20.00,5,5,2,2,9,33.33,0,1,0,1,-100.00,0,0,0,0, ,0,0,0,0, ,0,0,0, ,0,0,1,1,0.00
11880,THA,2,Pannoy Piyanut ,L,0,0,0, ,0,0,0,0,0, ,0,0,0,0, ,0,0,0,0, ,11,2,10,23,39.13,10,1,11,81.82,0,0,10,10,0.00
11880,THA,3,ManaKij Sirima ,S,0,0,0,0.00,0,0,0,0,0, ,0,0,1,1,0.00,0,0,7,7,0.00,0,0,0,0, ,4,0,6,66.67,7,0,50,57,12.28
11880,THA,5,Thinkaow Pleumjit ,MB,6,2,0,2.70,8,6,3,11,20,15.00,2,4,1,7,-28.57,0,0,10,10,0.00,0,0,1,1,0.00,2,0,2,100.00,0,0,4,4,0.00
11880,THA,6,Sittirak Onuma ,OH,14,0,0,16.28,14,14,4,13,31,32.26,0,2,0,2,-100.00,0,1,9,10,-10.00,2,0,6,8,25.00,2,7,10,-50.00,0,0,4,4,0.00
11880,THA,9,Chuewulim Sutadta ,OH,7,0,0,-5.56,7,7,5,11,23,8.70,0,3,0,3,-100.00,0,1,9,10,-10.00,4,3,12,19,5.26,0,0,0, ,0,0,2,2,0.00
11880,THA,10,Apinyapong Wilavan ,L,0,0,0, ,0,0,0,0,0, ,0,0,0,0, ,0,0,0,0, ,0,0,0,0, ,4,2,7,28.57,0,0,1,1,0.00
11880,THA,11,Hyapha Amporn ,MB,1,0,0,-16.67,1,1,2,1,4,-25.00,0,1,1,2,-50.00,0,0,6,6,0.00,0,0,0,0, ,2,0,2,100.00,0,0,0,0, 
11880,THA,12,Chaisri Tapaphaipun ,L,0,0,0,0.00,0,0,0,3,3,0.00,0,0,0,0, ,0,0,1,1,0.00,1,2,6,9,-11.11,3,0,4,75.00,0,0,1,1,0.00
11880,THA,13,Tomkom Nootsara ,S,0,1,0,0.00,1,0,0,1,1,0.00,1,1,0,2,0.00,0,0,4,4,0.00,0,0,0,0, ,7,2,9,55.56,3,0,31,34,8.82
11880,THA,14,Juangjan Pattiya ,OH,1,0,0,-27.27,1,1,4,4,9,-33.33,0,0,0,0, ,0,0,2,2,0.00,1,0,2,3,33.33,1,0,3,33.33,0,0,0,0, 
11880,THA,15,Kanthong Malika ,O,4,0,0,-3.03,4,4,0,14,18,22.22,0,4,2,6,-66.67,0,1,8,9,-11.11,3,3,9,15,0.00,7,5,13,15.38,1,0,1,2,50.00
11880,THA,19,Krause Karina ,MB,1,1,0,22.22,2,1,0,1,2,50.00,1,0,1,2,50.00,0,0,5,5,0.00,0,1,1,2,-50.00,4,0,4,100.00,0,0,1,1,0.00
11880,THA,22,Nilapa Chatsuda ,OH,0,0,0,-12.50,0,0,0,5,5,0.00,0,1,0,1,-100.00,0,0,2,2,0.00,1,0,5,6,16.67,0,0,0, ,0,0,1,1,0.00
11880,THA,24,Nuanjam Watchareeya ,MB,0,0,0,0.00,0,0,0,2,2,0.00,0,0,0,0, ,0,0,1,1,0.00,0,0,0,0, ,0,0,0, ,0,0,0,0, 
11881,DOM,1,Vargas Valdez Annerys Victoria ,MB,7,4,0,-5.13,11,7,3,6,16,25.00,4,9,4,17,-29.41,0,1,5,6,-16.67,0,0,0,0, ,3,0,3,100.00,0,0,1,1,0.00
11881,DOM,5,Castillo Brenda ,L,0,0,0, ,0,0,0,0,0, ,0,0,0,0, ,0,0,0,0, ,7,1,18,26,23.08,18,4,25,56.00,0,0,12,12,0.00
11881,DOM,6,Dominguez Martinez Camil Inmaculada ,S,0,0,0,0.00,0,0,0,0,0, ,0,0,0,0, ,0,0,2,2,0.00,0,0,0,0, ,0,0,0, ,0,0,5,5,0.00
11881,DOM,7,Marte Frica Niverka Dharlenis ,S,1,0,1,0.00,2,1,0,2,3,33.33,0,2,9,11,-18.18,1,0,10,11,9.09,0,0,0,0, ,3,3,6,0.00,47,2,93,142,31.69
11881,DOM,11,Rodriguez Marifranchi ,MB,0,0,0,0.00,0,0,0,0,0, ,0,0,1,1,0.00,0,0,1,1,0.00,0,0,0,0, ,0,0,0, ,0,0,1,1,0.00
11881,DOM,14,Rivera Brens Prisilla ,OH,6,2,0,4.55,8,6,2,20,28,14.29,2,3,3,8,-12.50,0,1,7,8,-12.50,4,0,22,26,15.38,5,1,7,57.14,0,0,3,3,0.00
11881,DOM,16,PeÃ±a Isabel Yonkaira Paola ,OH,9,3,0,26.32,12,9,2,13,24,29.17,3,0,1,4,75.00,0,0,10,10,0.00,6,0,14,20,30.00,13,2,17,64.71,0,0,0,0, 
11881,DOM,17,Mambru Casilla Gina Altagracia ,O,0,0,0,-33.33,0,0,1,0,1,-100.00,0,0,1,1,0.00,0,0,1,1,0.00,0,0,0,0, ,1,0,1,100.00,0,0,0,0, 
11881,DOM,18,De La Cruz De PeÃ±a Bethania ,OH,8,0,1,0.00,9,8,5,20,33,9.09,0,1,3,4,-25.00,1,3,17,21,-9.52,2,0,16,18,11.11,14,4,20,50.00,0,0,1,1,0.00
11881,DOM,20,Martinez Brayelin Elizabeth ,OH,22,0,1,16.18,23,22,6,19,47,34.04,0,5,1,6,-83.33,1,1,13,15,0.00,1,0,0,1,100.00,16,5,26,42.31,0,0,1,1,0.00
11881,DOM,21,Martinez Jineiry ,MB,8,1,0,-9.84,9,8,4,7,19,21.05,1,11,11,23,-43.48,0,0,19,19,0.00,0,0,0,0, ,2,2,5,0.00,0,0,3,3,0.00
11881,DOM,25,Martinez Caro Larysmer ,OH,0,0,0,0.00,0,0,0,0,0, ,0,0,0,0, ,0,0,3,3,0.00,1,0,7,8,12.50,0,0,1,0.00,0,0,0,0, 
11881,RUS,4,Pilipenko Daria ,L,0,0,0, ,0,0,0,0,0, ,0,0,0,0, ,0,0,0,0, ,11,1,15,27,37.04,22,4,27,66.67,0,0,8,8,0.00
11881,RUS,5,Fedorovtseva Arina ,OH,18,2,0,10.96,20,18,7,22,47,23.40,2,2,2,6,0.00,0,3,17,20,-15.00,11,1,23,35,28.57,8,1,11,63.64,0,1,3,4,-25.00
11881,RUS,6,Koroleva Irina ,MB,6,4,0,-3.39,10,6,1,3,10,50.00,4,11,19,34,-20.59,0,0,15,15,0.00,0,0,0,0, ,4,1,7,42.86,0,0,4,4,0.00
11881,RUS,8,Goncharova Nataliya ,O,30,1,0,28.05,31,30,7,21,58,39.66,1,0,8,9,11.11,0,1,14,15,-6.67,0,0,0,0, ,13,3,18,55.56,0,0,3,3,0.00
11881,RUS,9,Gorbunova Valeriia ,O,0,0,0, ,0,0,0,0,0, ,0,0,0,0, ,0,0,0,0, ,0,0,0,0, ,0,0,0, ,0,0,0,0, 
11881,RUS,10,Matveeva Polina ,S,0,0,0,-29.41,0,0,1,0,1,-100.00,0,4,3,7,-57.14,0,0,9,9,0.00,0,0,0,0, ,8,2,10,60.00,13,0,64,77,16.88
11881,RUS,11,Brovkina Yulia ,MB,0,0,0,-25.00,0,0,0,2,2,0.00,0,1,1,2,-50.00,0,0,0,0, ,0,0,0,0, ,0,0,0, ,0,0,1,1,0.00
11881,RUS,13,Startseva Evgeniya ,S,0,0,0,0.00,0,0,0,2,2,0.00,0,0,0,0, ,0,0,5,5,0.00,0,0,0,0, ,5,0,5,100.00,5,0,53,58,8.62
11881,RUS,14,Fetisova Irina ,MB,2,2,0,-4.65,4,2,0,0,2,100.00,2,5,10,17,-17.65,0,1,23,24,-4.17,0,0,0,0, ,5,2,10,30.00,0,0,5,5,0.00
11881,RUS,16,Voronkova Irina ,OH,18,0,1,10.00,19,18,6,19,43,27.91,0,3,6,9,-33.33,1,3,14,18,-11.11,5,1,22,28,14.29,14,0,16,87.50,0,0,5,5,0.00
11881,RUS,22,Zaytseva Tamara ,L,0,0,0, ,0,0,0,0,0, ,0,0,0,0, ,0,0,0,0, ,0,0,0,0, ,0,0,0, ,0,0,0,0, 
11881,RUS,24,Pipunyrova Ekaterina ,OH,0,0,0, ,0,0,0,0,0, ,0,0,0,0, ,0,0,0,0, ,0,0,0,0, ,0,0,0, ,0,0,0,0, 
11881,RUS,25,Smirnova Kseniia ,OH,0,0,0,0.00,0,0,0,2,2,0.00,0,0,0,0, ,0,0,1,1,0.00,0,0,1,1,0.00,3,0,3,100.00,0,0,0,0, 
11882,BRA,2,De Oliveira Saad Gattaz Caroline ,MB,1,2,0,-5.26,3,1,0,4,5,20.00,2,3,2,7,-14.29,0,1,6,7,-14.29,1,0,1,2,50.00,3,0,4,75.00,0,0,3,3,0.00
11882,BRA,3,Rodrigues Lins Dos Santos Danielle ,S,0,0,0,-28.57,0,0,0,0,0, ,0,0,2,2,0.00,0,2,3,5,-40.00,0,1,0,1,-100.00,5,0,6,83.33,6,0,26,32,18.75
11882,BRA,5,Da Silva Adenizia ,MB,3,2,0,44.44,5,3,0,0,3,100.00,2,1,2,5,20.00,0,0,1,1,0.00,0,0,0,0, ,1,0,1,100.00,0,0,1,1,0.00
11882,BRA,6,Alexandre Costa Nunes Nyeme Victoria ,L,0,0,0, ,0,0,0,0,0, ,0,0,0,0, ,0,0,0,0, ,1,0,2,3,33.33,3,2,6,16.67,0,0,2,2,0.00
11882,BRA,7,Montibeller Rosamaria ,OH,0,0,0, ,0,0,0,0,0, ,0,0,0,0, ,0,0,0,0, ,0,0,0,0, ,0,0,0, ,0,0,0,0, 
11882,BRA,8,Silva Carneiro Macris Fernanda ,S,0,0,0,0.00,0,0,0,0,0, ,0,0,1,1,0.00,0,0,3,3,0.00,0,0,0,0, ,4,0,4,100.00,4,0,27,31,12.90
11882,BRA,10,Braga Guimaraes Gabriela ,OH,6,0,0,16.00,6,6,2,3,11,36.36,0,0,1,1,0.00,0,0,13,13,0.00,9,0,6,15,60.00,12,0,14,85.71,0,0,0,0, 
11882,BRA,11,Caixeta Tandara ,OH,12,0,0,25.00,12,12,1,4,17,64.71,0,2,2,4,-50.00,0,1,10,11,-9.09,0,0,0,0, ,3,1,4,50.00,0,0,1,1,0.00
11882,BRA,13,Castro De Paula Blassioli Sheilla ,O,3,0,2,28.57,5,3,0,3,6,50.00,0,1,0,1,-100.00,2,0,5,7,28.57,0,0,0,0, ,2,0,2,100.00,0,0,0,0, 
11882,BRA,15,Da Silva Ana Carolina ,MB,1,1,0,-26.67,2,1,0,0,1,100.00,1,4,1,6,-50.00,0,2,6,8,-25.00,0,0,0,0, ,2,0,2,100.00,0,0,2,2,0.00
11882,BRA,16,Rodrigues Fernanda ,OH,10,1,0,32.14,11,10,0,9,19,52.63,1,1,2,4,0.00,0,1,4,5,-20.00,4,0,1,5,80.00,6,0,6,100.00,0,0,3,3,0.00
11882,BRA,17,Menezes Oliveira de Souza Ana Cristina ,OH,3,1,1,15.38,5,3,1,3,7,28.57,1,1,0,2,0.00,1,1,2,4,0.00,0,0,3,3,0.00,1,1,2,0.00,0,0,0,0, 
11882,BRA,18,Brait Camila ,L,0,0,0, ,0,0,0,0,0, ,0,0,0,0, ,0,0,0,0, ,1,0,2,3,33.33,3,0,3,100.00,0,0,2,2,0.00
11882,BRA,28,Araujo De Souza Mayany Cristina ,MB,2,0,2,15.79,4,2,0,4,6,33.33,0,1,3,4,-25.00,2,0,7,9,22.22,0,0,0,0, ,1,0,1,100.00,0,0,0,0, 
11882,SRB,2,Lazovic Katarina ,OH,6,0,0,15.00,6,6,2,6,14,28.57,0,0,1,1,0.00,0,1,4,5,-20.00,12,4,12,28,28.57,4,0,5,80.00,0,0,2,2,0.00
11882,SRB,3,Caric Sara ,O,3,0,1,0.00,4,3,3,11,17,0.00,0,1,1,2,-50.00,1,0,5,6,16.67,0,0,0,0, ,3,1,4,50.00,0,0,5,5,0.00
11882,SRB,6,Uzelac Aleksandra ,OH,0,0,0, ,0,0,0,0,0, ,0,0,0,0, ,0,0,0,0, ,0,0,0,0, ,0,0,0, ,0,0,0,0, 
11882,SRB,7,Jaksic Ana ,S,0,0,0,-25.00,0,0,0,2,2,0.00,0,1,0,1,-100.00,0,0,1,1,0.00,0,0,0,0, ,2,0,2,100.00,1,0,24,25,4.00
11882,SRB,21,Kocic Jovana ,MB,2,0,0,-8.33,2,2,0,3,5,40.00,0,3,1,4,-75.00,0,0,3,3,0.00,0,0,0,0, ,2,0,2,100.00,0,0,1,1,0.00
11882,SRB,22,Lozo Sara ,O,2,0,0,-36.36,2,2,3,3,8,-12.50,0,1,0,1,-100.00,0,2,0,2,-100.00,4,1,4,9,33.33,1,0,2,50.00,0,0,1,1,0.00
11882,SRB,23,Djordjevic Mila ,S,1,1,0,-11.11,2,1,0,0,1,100.00,1,1,1,3,0.00,0,2,3,5,-40.00,0,0,0,0, ,3,1,5,40.00,6,1,35,42,11.90
11882,SRB,24,Medic Sofija ,MB,0,0,0, ,0,0,0,0,0, ,0,0,0,0, ,0,0,0,0, ,0,0,0,0, ,0,0,0, ,0,0,0,0, 
11882,SRB,25,Markovic Bozica ,MB,2,1,0,-14.81,3,2,2,4,8,0.00,1,4,5,10,-30.00,0,1,8,9,-11.11,0,0,0,0, ,2,0,4,50.00,0,0,2,2,0.00
11882,SRB,26,Savic Vanja ,O,0,0,0,-75.00,0,0,3,1,4,-75.00,0,0,0,0, ,0,0,0,0, ,0,0,0,0, ,1,2,3,-33.33,0,0,1,1,0.00
11882,SRB,28,Delic Jelena ,MB,0,0,0,-50.00,0,0,0,0,0, ,0,1,0,1,-100.00,0,1,2,3,-33.33,0,0,0,0, ,0,0,0, ,0,0,0,0, 
11882,SRB,31,Djurdjevic Sanja ,L,0,0,0, ,0,0,0,0,0, ,0,0,0,0, ,0,0,0,0, ,1,0,1,2,50.00,2,1,4,25.00,0,0,1,1,0.00
11882,SRB,32,Gocanin Bojana ,L,0,0,0, ,0,0,0,0,0, ,0,0,0,0, ,0,0,0,0, ,6,0,11,17,35.29,3,0,4,75.00,0,0,2,2,0.00
11882,SRB,34,Mirosavljevic Jovana ,OH,8,1,0,5.71,9,8,4,13,25,16.00,1,1,1,3,0.00,0,2,5,7,-28.57,5,0,4,9,55.56,3,4,8,-12.50,0,0,3,3,0.00
11883,CAN,1,Bujan Cassandra ,L,0,0,0, ,0,0,0,0,0, ,0,0,0,0, ,0,0,0,0, ,6,1,6,13,38.46,11,6,18,27.78,0,0,9,9,0.00
11883,CAN,3,Van Ryk Kiera ,OH,23,3,2,13.33,28,23,8,21,52,28.85,3,4,2,9,-11.11,2,6,6,14,-28.57,0,0,0,0, ,6,7,13,-7.69,0,1,2,3,-33.33
11883,CAN,5,Smith Danielle ,S,0,0,0, ,0,0,0,0,0, ,0,0,0,0, ,0,0,0,0, ,0,0,0,0, ,0,1,1,-100.00,1,0,2,3,33.33
11883,CAN,6,White Jazmine  Ruth ,MB,0,0,0, ,0,0,0,0,0, ,0,0,0,0, ,0,0,0,0, ,0,0,0,0, ,0,0,0, ,0,0,0,0, 
11883,CAN,8,Ogoms Alicia ,MB,0,0,0, ,0,0,0,0,0, ,0,0,0,0, ,0,0,0,0, ,0,0,0,0, ,0,0,0, ,0,0,0,0, 
11883,CAN,11,Mitrovic Andrea ,OH,13,0,0,0.00,13,13,6,14,33,21.21,0,5,0,5,-100.00,0,2,13,15,-13.33,7,2,36,45,11.11,1,3,4,-50.00,0,0,0,0, 
11883,CAN,12,Cross Jennifer ,MB,4,4,1,2.33,9,4,4,6,14,0.00,4,3,4,11,9.09,1,1,16,18,0.00,1,1,0,2,0.00,5,0,6,83.33,0,0,2,2,0.00
11883,CAN,13,King Brie ,S,1,2,1,5.00,4,1,0,0,1,100.00,2,2,1,5,0.00,1,1,12,14,0.00,0,1,0,1,-100.00,7,4,14,21.43,21,3,98,122,14.75
11883,CAN,14,Howe Hilary ,OH,9,1,1,-2.08,11,9,5,10,24,16.67,1,4,0,5,-60.00,1,3,15,19,-10.53,7,3,25,35,11.43,3,6,9,-33.33,0,0,1,1,0.00
11883,CAN,15,Joseph Shainah ,O,0,0,0, ,0,0,0,0,0, ,0,0,0,0, ,0,0,0,0, ,0,0,0,0, ,0,0,0, ,0,0,0,0, 
11883,CAN,16,Livingston Caroline ,OH,0,0,0,0.00,0,0,0,1,1,0.00,0,0,0,0, ,0,0,0,0, ,1,0,0,1,100.00,0,0,0, ,0,0,0,0, 
11883,CAN,19,Maglio Emily ,MB,9,4,0,28.57,13,9,2,3,14,50.00,4,0,2,6,66.67,0,1,14,15,-6.67,0,0,0,0, ,3,2,6,16.67,0,0,2,2,0.00
11883,CAN,22,Snape Kennedy Brooklyn ,L,0,0,0, ,0,0,0,0,0, ,0,0,0,0, ,0,0,0,0, ,0,0,0,0, ,0,0,0, ,0,0,0,0, 
11883,CAN,23,Austin Parker Jane ,OH,0,0,0, ,0,0,0,0,0, ,0,0,0,0, ,0,0,0,0, ,0,0,1,1,0.00,0,0,0, ,0,0,0,0, 
11883,POL,1,Nowicka Julia ,S,1,2,1,0.00,4,1,1,2,4,0.00,2,1,1,4,25.00,1,2,17,20,-5.00,0,0,0,0, ,4,4,8,0.00,12,0,91,103,11.65
11883,POL,3,Alagierska Klaudia ,MB,6,2,1,8.82,9,6,3,2,11,27.27,2,3,2,7,-14.29,1,0,15,16,6.25,0,0,1,1,0.00,2,2,4,0.00,0,0,0,0, 
11883,POL,5,Kakolewska Agnieszka ,MB,0,0,0, ,0,0,0,0,0, ,0,0,0,0, ,0,0,0,0, ,0,0,0,0, ,0,0,0, ,0,0,0,0, 
11883,POL,8,Stenzel Maria ,L,0,0,0, ,0,0,0,0,0, ,0,0,0,0, ,0,0,0,0, ,13,1,12,26,46.15,3,2,5,20.00,1,0,8,9,11.11
11883,POL,9,Stysiak Magdalena ,O,7,0,1,4.00,8,7,3,7,17,23.53,0,1,0,1,-100.00,1,3,3,7,-28.57,1,1,3,5,0.00,3,1,5,40.00,0,0,0,0, 
11883,POL,10,Efimienko-Mlotkowska Zuzanna ,MB,5,4,1,16.67,10,5,0,8,13,38.46,4,3,4,11,9.09,1,1,10,12,0.00,0,0,0,0, ,1,1,2,0.00,0,0,1,1,0.00
11883,POL,11,Lukasik Martyna ,O,10,6,1,24.07,17,10,1,15,26,34.62,6,1,0,7,71.43,1,2,18,21,-4.76,5,2,9,16,18.75,10,4,15,40.00,0,0,2,2,0.00
11883,POL,13,Jagla Monika ,L,0,0,0, ,0,0,0,0,0, ,0,0,0,0, ,0,0,0,0, ,0,0,0,0, ,9,13,22,-18.18,0,0,3,3,0.00
11883,POL,17,Smarzek Malwina ,O,21,1,1,23.44,23,21,6,19,46,32.61,1,2,2,5,-20.00,1,0,12,13,7.69,0,0,3,3,0.00,9,4,14,35.71,0,0,0,0, 
11883,POL,19,Fedusio Monika ,OH,0,0,0, ,0,0,0,0,0, ,0,0,0,0, ,0,0,0,0, ,0,0,0,0, ,0,0,0, ,0,0,0,0, 
11883,POL,20,Czyrnianska Martyna ,OH,0,0,0, ,0,0,0,0,0, ,0,0,0,0, ,0,0,0,0, ,0,0,0,0, ,0,0,0, ,0,0,0,0, 
11883,POL,27,Åazowska Martyna ,S,1,0,0,0.00,1,1,0,1,2,50.00,0,0,0,0, ,0,1,0,1,-100.00,0,0,0,0, ,1,1,2,0.00,3,0,16,19,15.79
11883,POL,78,Gryka Aleksandra ,MB,0,0,0, ,0,0,0,0,0, ,0,0,0,0, ,0,0,0,0, ,0,0,0,0, ,0,0,0, ,0,0,0,0, 
11883,POL,88,Gorecka Zuzanna ,OH,6,1,2,2.38,9,6,6,10,22,0.00,1,1,0,2,0.00,2,1,15,18,5.56,13,1,16,30,40.00,3,3,6,0.00,0,0,0,0, 
11884,ITA,2,Bosio Francesca ,S,0,1,4,4.35,5,0,0,2,2,0.00,1,3,12,16,-12.50,4,0,24,28,14.29,0,0,0,0, ,9,3,13,46.15,18,1,104,123,13.82
11884,ITA,4,Bonifacio Sara ,MB,5,1,1,5.13,7,5,0,8,13,38.46,1,4,5,10,-30.00,1,1,14,16,0.00,0,0,1,1,0.00,4,1,5,60.00,0,1,1,2,-50.00
11884,ITA,12,Guerra Anastasia ,OH,8,1,0,6.98,9,8,3,17,28,17.86,1,0,0,1,100.00,0,3,11,14,-21.43,9,3,24,36,16.67,12,1,15,73.33,0,0,2,2,0.00
11884,ITA,15,Nwakalor Sylvia Chinelo ,O,15,1,0,6.98,16,15,7,9,31,25.81,1,4,0,5,-60.00,0,2,5,7,-28.57,0,1,0,1,-100.00,7,2,10,50.00,0,0,2,2,0.00
11884,ITA,19,Mingardi Camilla ,OH,11,0,0,11.43,11,11,1,14,26,38.46,0,4,1,5,-80.00,0,2,2,4,-50.00,0,0,0,0, ,5,0,5,100.00,0,0,0,0, 
11884,ITA,21,Lubian Marina ,MB,0,0,0, ,0,0,0,0,0, ,0,0,0,0, ,0,0,0,0, ,0,0,0,0, ,0,0,0, ,0,0,0,0, 
11884,ITA,23,De Bortoli Chiara ,L,0,0,0, ,0,0,0,0,0, ,0,0,0,0, ,0,0,0,0, ,2,0,3,5,40.00,0,2,2,-100.00,0,0,1,1,0.00
11884,ITA,24,Mazzaro Alessia ,MB,8,5,1,8.33,14,8,2,1,11,54.55,5,7,8,20,-10.00,1,1,15,17,0.00,0,0,0,0, ,3,0,5,60.00,0,0,1,1,0.00
11884,ITA,26,Battistoni Ilaria ,S,0,0,0,0.00,0,0,0,0,0, ,0,0,0,0, ,0,0,1,1,0.00,0,0,0,0, ,0,0,1,0.00,0,0,4,4,0.00
11884,ITA,27,Furlan Eleonora ,MB,0,0,0, ,0,0,0,0,0, ,0,0,0,0, ,0,0,0,0, ,0,0,0,0, ,0,0,0, ,0,0,0,0, 
11884,ITA,28,Melli Giulia ,OH,1,0,0,0.00,1,1,0,1,2,50.00,0,1,0,1,-100.00,0,0,0,0, ,1,1,0,2,0.00,0,0,0, ,0,0,0,0, 
11884,ITA,29,D'Odorico Sofia ,OH,10,0,1,-4.17,11,10,7,15,32,9.38,0,4,1,5,-80.00,1,2,8,11,-9.09,11,1,7,19,52.63,8,0,11,72.73,0,0,2,2,0.00
11884,ITA,31,Fersino Eleonora ,L,0,0,0, ,0,0,0,0,0, ,0,0,0,0, ,0,0,0,0, ,12,0,6,18,66.67,19,1,23,78.26,0,0,9,9,0.00
11884,ITA,32,Omoruyi Oghosasere Loveth ,OH,0,0,0, ,0,0,0,0,0, ,0,0,0,0, ,0,0,0,0, ,0,0,0,0, ,0,0,0, ,0,0,0,0, 
11884,KOR,1,Lee Soyoung ,OH,14,2,4,6.35,20,14,10,20,44,9.09,2,2,1,5,0.00,4,4,6,14,0.00,9,4,21,34,14.71,10,2,17,47.06,0,0,1,1,0.00
11884,KOR,2,Lee Dahyeon ,MB,0,1,0,-8.33,1,0,1,1,2,-50.00,1,1,3,5,0.00,0,0,5,5,0.00,0,1,0,1,-100.00,0,0,0, ,0,0,1,1,0.00
11884,KOR,3,Yeum Hye Seon ,S,1,0,0,-5.56,1,1,0,3,4,25.00,0,1,1,2,-50.00,0,1,11,12,-8.33,0,0,0,0, ,4,2,6,33.33,7,1,53,61,9.84
11884,KOR,5,Han Dahye ,L,0,0,0, ,0,0,0,0,0, ,0,0,0,0, ,0,0,0,0, ,5,0,3,8,62.50,6,1,7,71.43,0,0,1,1,0.00
11884,KOR,6,Kim Dain ,S,0,0,0,-33.33,0,0,0,0,0, ,0,4,1,5,-80.00,0,1,9,10,-10.00,0,0,0,0, ,3,0,3,100.00,4,0,55,59,6.78
11884,KOR,8,Park Eunjin ,MB,2,0,2,5.56,4,2,1,3,6,16.67,0,2,2,4,-50.00,2,0,6,8,25.00,0,0,1,1,0.00,2,0,2,100.00,0,0,0,0, 
11884,KOR,9,Oh Jiyoung ,L,0,0,0, ,0,0,0,0,0, ,0,0,0,0, ,0,0,0,0, ,8,1,8,17,41.18,11,3,15,53.33,0,0,9,9,0.00
11884,KOR,10,Kim Yeon Koung ,OH,12,0,0,16.00,12,12,2,17,31,32.26,0,2,3,5,-40.00,0,0,14,14,0.00,4,1,11,16,18.75,16,3,21,61.90,0,1,11,12,-8.33
11884,KOR,12,Han Songyi ,MB,2,0,0,22.22,2,2,0,1,3,66.67,0,0,4,4,0.00,0,0,2,2,0.00,0,0,0,0, ,1,0,2,50.00,0,0,0,0, 
11884,KOR,13,Park Jeongah ,OH,8,0,0,10.53,8,8,2,16,26,23.08,0,0,4,4,0.00,0,2,6,8,-25.00,0,0,1,1,0.00,2,1,3,33.33,0,0,1,1,0.00
11884,KOR,14,Yang Hyo Jin ,MB,6,1,0,0.00,7,6,0,6,12,50.00,1,6,0,7,-71.43,0,1,13,14,-7.14,0,0,0,0, ,2,0,3,66.67,0,0,2,2,0.00
11884,KOR,15,Yuk Seoyoung ,OH,2,0,0,16.67,2,2,0,2,4,50.00,0,0,0,0, ,0,1,1,2,-50.00,1,0,4,5,20.00,1,1,2,0.00,0,0,0,0, 
11884,KOR,16,Jeong Jiyun ,O,3,0,0,-7.14,3,3,2,4,9,11.11,0,1,2,3,-33.33,0,1,1,2,-50.00,1,0,0,1,100.00,1,0,1,100.00,0,0,0,0, 
11884,KOR,19,Pyo Seungju ,OH,0,0,0,-25.00,0,0,1,1,2,-50.00,0,0,0,0, ,0,0,2,2,0.00,1,0,2,3,33.33,2,0,3,66.67,0,0,0,0, 
11885,GER,1,Bock Linda ,L,0,0,0, ,0,0,0,0,0, ,0,0,0,0, ,0,0,0,0, ,0,0,0,0, ,0,0,0, ,0,0,0,0, 
11885,GER,2,KÃ¤stner Pia ,S,2,0,0,25.00,2,2,0,0,2,100.00,0,0,0,0, ,0,0,6,6,0.00,0,0,1,1,0.00,1,0,1,100.00,1,2,24,27,-3.70
11885,GER,4,Imoudu Denise ,S,0,0,0,-14.29,0,0,0,1,1,0.00,0,1,1,2,-50.00,0,0,4,4,0.00,0,0,0,0, ,1,1,2,0.00,1,1,31,33,0.00
11885,GER,5,Poll Jana Franziska ,OH,1,0,1,40.00,2,1,0,1,2,50.00,0,0,0,0, ,1,0,2,3,33.33,1,0,4,5,20.00,0,1,1,-100.00,0,0,0,0, 
11885,GER,7,Vanjak Ivana ,OH,3,0,0,-8.33,3,3,1,3,7,28.57,0,2,0,2,-100.00,0,1,2,3,-33.33,0,0,0,0, ,0,0,0, ,0,0,0,0, 
11885,GER,8,Drewniok Kimberly ,O,4,0,0,10.53,4,4,2,7,13,15.38,0,0,1,1,0.00,0,0,5,5,0.00,0,0,0,0, ,3,1,4,50.00,0,0,0,0, 
11885,GER,9,Alsmeier Lina ,OH,6,1,0,3.33,7,6,2,11,19,21.05,1,3,1,5,-40.00,0,1,5,6,-16.67,4,1,7,12,25.00,1,1,2,0.00,0,0,1,1,0.00
11885,GER,10,Stigrot Lena ,OH,1,0,1,-9.09,2,1,2,4,7,-14.29,0,1,1,2,-50.00,1,0,1,2,50.00,1,1,5,7,0.00,1,0,1,100.00,0,0,1,1,0.00
11885,GER,12,Orthmann Hanna ,OH,7,0,0,0.00,7,7,2,5,14,35.71,0,3,0,3,-100.00,0,2,4,6,-33.33,7,4,15,26,11.54,2,1,4,25.00,0,0,1,1,0.00
11885,GER,14,SchÃ¶lzel Marie ,MB,1,0,0,-18.18,1,1,1,2,4,0.00,0,2,1,3,-66.67,0,0,4,4,0.00,0,0,0,0, ,1,1,2,0.00,0,0,1,1,0.00
11885,GER,16,Ambrosius Lea ,MB,2,0,0,-14.29,2,2,0,1,3,66.67,0,2,0,2,-100.00,0,1,1,2,-50.00,1,0,0,1,100.00,0,0,0, ,0,0,1,1,0.00
11885,GER,17,Pogany Anna ,L,0,0,0, ,0,0,0,0,0, ,0,0,0,0, ,0,0,0,0, ,1,2,8,11,-9.09,0,6,7,-85.71,0,0,7,7,0.00
11885,GER,21,Weitzel Camilla ,MB,0,3,1,0.00,4,0,0,2,2,0.00,3,2,1,6,16.67,1,2,7,10,-10.00,0,0,0,0, ,1,0,1,100.00,0,0,2,2,0.00
11885,GER,24,Cekulaev Anastasia ,MB,0,0,0, ,0,0,0,0,0, ,0,0,0,0, ,0,0,0,0, ,0,0,0,0, ,0,0,0, ,0,0,0,0, 
11885,USA,1,Hancock Micha ,S,1,0,3,4.76,4,1,0,0,1,100.00,0,0,2,2,0.00,3,3,12,18,0.00,0,0,0,0, ,5,1,6,66.67,6,1,61,68,7.35
11885,USA,3,Plummer Kathryn ,OH,0,0,0, ,0,0,0,0,0, ,0,0,0,0, ,0,0,0,0, ,0,0,0,0, ,0,0,0, ,0,0,0,0, 
11885,USA,4,Wong-Orantes Justine ,L,0,0,0, ,0,0,0,0,0, ,0,0,0,0, ,0,0,0,0, ,7,2,15,24,20.83,14,2,16,75.00,0,0,4,4,0.00
11885,USA,6,Dixon Tetori ,MB,0,0,0, ,0,0,0,0,0, ,0,0,0,0, ,0,0,0,0, ,0,0,0,0, ,0,0,0, ,0,0,0,0, 
11885,USA,7,Carlini Lauren ,S,0,0,0, ,0,0,0,0,0, ,0,0,0,0, ,0,0,0,0, ,0,0,0,0, ,0,0,0, ,0,0,0,0, 
11885,USA,8,Tapp Hannah ,MB,0,0,0, ,0,0,0,0,0, ,0,0,0,0, ,0,0,0,0, ,0,0,0,0, ,0,0,0, ,0,0,0,0, 
11885,USA,10,Larson Jordan ,OH,8,0,2,13.51,10,8,2,7,17,35.29,0,2,1,3,-66.67,2,1,14,17,5.88,3,1,3,7,28.57,3,1,4,50.00,0,0,6,6,0.00
11885,USA,11,Drews Andrea ,O,17,0,0,40.00,17,17,0,9,26,65.38,0,2,0,2,-100.00,0,1,6,7,-14.29,0,0,0,0, ,3,1,4,50.00,0,0,1,1,0.00
11885,USA,12,Thompson Jordan ,O,0,0,0, ,0,0,0,0,0, ,0,0,0,0, ,0,0,0,0, ,0,0,0,0, ,0,0,0, ,0,0,0,0, 
11885,USA,13,Wilhite Sarah ,OH,0,0,0, ,0,0,0,0,0, ,0,0,0,0, ,0,0,0,0, ,0,0,0,0, ,0,0,0, ,0,0,0,0, 
11885,USA,15,Hill Kimberly ,OH,0,0,0, ,0,0,0,0,0, ,0,0,0,0, ,0,0,0,0, ,0,0,0,0, ,0,0,0, ,0,0,0,0, 
11885,USA,16,Akinradewo Foluke ,MB,2,1,0,0.00,3,2,0,5,7,28.57,1,2,0,3,-33.33,0,1,4,5,-20.00,0,0,0,0, ,3,1,4,50.00,0,0,0,0, 
11885,USA,23,Robinson Kelsey ,OH,12,2,3,20.45,17,12,6,8,26,23.08,2,0,1,3,66.67,3,2,10,15,6.67,5,0,8,13,38.46,4,2,6,33.33,0,0,4,4,0.00
11885,USA,24,Ogbogu Chiaka ,MB,5,1,0,3.85,6,5,0,2,7,71.43,1,3,4,8,-25.00,0,2,9,11,-18.18,0,0,0,0, ,0,1,1,-100.00,0,0,1,1,0.00
11886,RUS,4,Pilipenko Daria ,L,0,0,0, ,0,0,0,0,0, ,0,0,0,0, ,0,0,0,0, ,5,0,13,18,27.78,10,5,18,27.78,0,0,9,9,0.00
11886,RUS,5,Fedorovtseva Arina ,OH,16,1,3,21.31,20,16,3,12,31,41.94,1,2,5,8,-12.50,3,2,17,22,4.55,6,3,13,22,13.64,4,1,9,33.33,0,0,1,1,0.00
11886,RUS,6,Koroleva Irina ,MB,8,2,1,13.95,11,8,0,4,12,66.67,2,5,9,16,-18.75,1,0,14,15,6.67,0,0,0,0, ,3,0,3,100.00,0,0,0,0, 
11886,RUS,8,Goncharova Nataliya ,O,14,4,1,25.93,19,14,2,15,31,38.71,4,1,5,10,30.00,1,2,10,13,-7.69,0,0,1,1,0.00,8,2,11,54.55,0,0,1,1,0.00
11886,RUS,9,Gorbunova Valeriia ,O,0,0,0, ,0,0,0,0,0, ,0,0,0,0, ,0,0,0,0, ,0,0,0,0, ,0,0,0, ,0,0,0,0, 
11886,RUS,10,Matveeva Polina ,S,4,2,1,18.18,7,4,0,1,5,80.00,2,0,1,3,66.67,1,3,10,14,-14.29,0,0,0,0, ,7,2,9,55.56,14,2,62,78,15.38
11886,RUS,11,Brovkina Yulia ,MB,2,0,0,66.67,2,2,0,0,2,100.00,0,0,0,0, ,0,0,1,1,0.00,0,0,0,0, ,0,0,0, ,0,0,0,0, 
11886,RUS,14,Fetisova Irina ,MB,4,6,0,11.76,10,4,1,1,6,50.00,6,4,6,16,12.50,0,1,11,12,-8.33,0,0,0,0, ,3,0,3,100.00,0,0,1,1,0.00
11886,RUS,16,Voronkova Irina ,OH,5,1,0,0.00,6,5,2,10,17,17.65,1,2,0,3,-33.33,0,2,8,10,-20.00,10,1,11,22,40.91,13,1,14,85.71,0,0,2,2,0.00
11886,RUS,20,Lazareva Ekaterina ,S,0,0,0,-25.00,0,0,0,1,1,0.00,0,0,0,0, ,0,1,2,3,-33.33,0,0,0,0, ,3,0,4,75.00,3,0,18,21,14.29
11886,RUS,22,Zaytseva Tamara ,L,0,0,0, ,0,0,0,0,0, ,0,0,0,0, ,0,0,0,0, ,0,0,0,0, ,0,0,0, ,0,0,0,0, 
11886,RUS,23,Kapustina Irina ,OH,0,0,0, ,0,0,0,0,0, ,0,0,0,0, ,0,0,0,0, ,0,0,0,0, ,0,0,0, ,0,0,0,0, 
11886,RUS,24,Pipunyrova Ekaterina ,OH,0,0,0, ,0,0,0,0,0, ,0,0,0,0, ,0,0,0,0, ,0,0,1,1,0.00,1,0,1,100.00,0,0,0,0, 
11886,RUS,25,Smirnova Kseniia ,OH,5,2,0,28.57,7,5,1,3,9,44.44,2,1,0,3,33.33,0,1,1,2,-50.00,1,2,3,6,-16.67,2,0,2,100.00,0,0,0,0, 
11886,THA,2,Pannoy Piyanut ,L,0,0,0, ,0,0,0,0,0, ,0,0,0,0, ,0,0,0,0, ,14,3,18,35,31.43,4,1,7,42.86,0,0,1,1,0.00
11886,THA,5,Thinkaow Pleumjit ,MB,15,1,3,18.52,19,15,4,13,32,34.38,1,5,4,10,-40.00,3,0,9,12,25.00,1,0,3,4,25.00,5,2,8,37.50,0,0,5,5,0.00
11886,THA,6,Sittirak Onuma ,OH,9,0,0,-13.79,9,9,12,17,38,-7.89,0,4,2,6,-66.67,0,1,13,14,-7.14,4,0,3,7,57.14,8,2,12,50.00,0,0,2,2,0.00
11886,THA,9,Chuewulim Sutadta ,OH,1,0,0,-10.00,1,1,2,2,5,-20.00,0,0,1,1,0.00,0,0,4,4,0.00,1,1,7,9,0.00,2,2,5,0.00,0,0,3,3,0.00
11886,THA,10,Apinyapong Wilavan ,L,0,0,0, ,0,0,0,0,0, ,0,0,0,0, ,0,0,0,0, ,2,0,1,3,66.67,10,1,12,75.00,0,0,5,5,0.00
11886,THA,11,Hyapha Amporn ,MB,2,1,1,4.76,4,2,2,5,9,0.00,1,1,0,2,0.00,1,0,9,10,10.00,1,1,1,3,0.00,2,0,2,100.00,0,0,2,2,0.00
11886,THA,12,Chaisri Tapaphaipun ,L,1,0,0,25.00,1,1,0,1,2,50.00,0,0,1,1,0.00,0,0,1,1,0.00,0,0,4,4,0.00,2,0,2,100.00,0,0,1,1,0.00
11886,THA,13,Tomkom Nootsara ,S,1,0,1,-10.00,2,1,0,2,3,33.33,0,4,3,7,-57.14,1,0,9,10,10.00,0,0,0,0, ,12,0,14,85.71,20,0,60,80,25.00
11886,THA,14,Juangjan Pattiya ,OH,1,0,0,-25.00,1,1,1,0,2,0.00,0,0,0,0, ,0,1,1,2,-50.00,0,0,1,1,0.00,0,0,0, ,0,0,0,0, 
11886,THA,15,Kanthong Malika ,O,6,2,0,-2.44,8,6,3,10,19,15.79,2,5,4,11,-27.27,0,1,10,11,-9.09,3,0,9,12,25.00,3,3,7,0.00,0,0,3,3,0.00
11886,THA,17,Piampongsan Gullapa ,S,0,0,0,-20.00,0,0,0,2,2,0.00,0,1,0,1,-100.00,0,0,2,2,0.00,0,0,0,0, ,0,0,0, ,4,0,24,28,14.29
11886,THA,19,Krause Karina ,MB,7,0,0,33.33,7,7,0,2,9,77.78,0,1,0,1,-100.00,0,1,4,5,-20.00,0,0,0,0, ,1,0,1,100.00,0,0,0,0, 
11886,THA,22,Nilapa Chatsuda ,OH,1,0,1,7.14,2,1,1,9,11,0.00,0,0,0,0, ,1,0,2,3,33.33,1,1,0,2,0.00,2,1,3,33.33,0,0,0,0, 
11886,THA,24,Nuanjam Watchareeya ,MB,0,0,0, ,0,0,0,0,0, ,0,0,0,0, ,0,0,0,0, ,0,0,0,0, ,0,0,0, ,0,0,0,0, 
11887,TUR,2,Akoz Simge Sebnem ,L,0,0,0, ,0,0,0,0,0, ,0,0,0,0, ,0,0,0,0, ,4,1,1,6,50.00,3,2,5,20.00,0,0,8,8,0.00
11887,TUR,3,Ãzbay Cansu ,S,0,1,0,20.00,1,0,0,1,1,0.00,1,0,0,1,100.00,0,0,3,3,0.00,0,0,0,0, ,3,3,6,0.00,5,0,32,37,13.51
11887,TUR,4,Senoglu Tugba ,OH,10,1,2,21.21,13,10,3,10,23,30.43,1,1,0,2,0.00,2,2,4,8,0.00,8,0,9,17,47.06,4,1,5,60.00,0,0,2,2,0.00
11887,TUR,5,Ercan Seyma ,OH,0,0,0, ,0,0,0,0,0, ,0,0,0,0, ,0,0,0,0, ,0,0,0,0, ,0,0,0, ,0,0,0,0, 
11887,TUR,6,Caliskan Kubra ,MB,1,1,0,-21.05,2,1,3,1,5,-40.00,1,2,2,5,-20.00,0,1,8,9,-11.11,0,0,0,0, ,0,2,2,-100.00,0,0,0,0, 
11887,TUR,7,Baladin Hande ,OH,2,0,0,-11.11,2,2,2,7,11,0.00,0,2,1,3,-66.67,0,0,4,4,0.00,3,1,5,9,22.22,1,2,3,-33.33,0,0,0,0, 
11887,TUR,9,Ismailoglu Meliha ,OH,5,0,0,2.78,5,5,2,9,16,18.75,0,2,2,4,-50.00,0,0,16,16,0.00,14,1,20,35,37.14,3,5,8,-25.00,0,0,1,1,0.00
11887,TUR,10,Aykac Ayca ,L,0,0,0, ,0,0,0,0,0, ,0,0,0,0, ,0,0,0,0, ,9,1,6,16,50.00,7,4,12,25.00,0,0,5,5,0.00
11887,TUR,11,Aydemir Akyol Naz ,S,0,1,0,-16.67,1,0,0,0,0, ,1,1,0,2,0.00,0,2,8,10,-20.00,0,0,0,0, ,2,1,3,33.33,16,2,65,83,16.87
11887,TUR,13,Boz Meryem ,O,9,1,0,2.63,10,9,5,15,29,13.79,1,2,0,3,-33.33,0,2,4,6,-33.33,0,0,0,0, ,0,2,2,-100.00,0,0,0,0, 
11887,TUR,14,Erdem DÃ¼ndar Eda ,MB,6,2,2,6.45,10,6,5,4,15,6.67,2,2,0,4,0.00,2,1,9,12,8.33,0,0,1,1,0.00,1,0,1,100.00,0,0,0,0, 
11887,TUR,18,Gunes Zehra ,MB,4,0,0,42.86,4,4,0,0,4,100.00,0,0,0,0, ,0,1,2,3,-33.33,0,0,0,0, ,0,0,0, ,0,0,0,0, 
11887,TUR,19,Kalac Asli ,MB,0,1,0,9.09,1,0,0,3,3,0.00,1,0,0,1,100.00,0,0,7,7,0.00,0,0,0,0, ,0,1,1,-100.00,0,0,0,0, 
11887,TUR,99,Karakurt Ebrar ,OH,8,1,1,-9.09,10,8,8,14,30,0.00,1,5,0,6,-66.67,1,1,6,8,0.00,0,0,0,0, ,2,0,2,100.00,0,0,1,1,0.00
11887,DOM,1,Vargas Valdez Annerys Victoria ,MB,3,1,0,-15.38,4,3,2,6,11,9.09,1,5,1,7,-57.14,0,1,7,8,-12.50,0,0,1,1,0.00,0,0,0, ,0,0,0,0, 
11887,DOM,3,Eve Mejia Lisvel Elisa ,U,0,0,0, ,0,0,0,0,0, ,0,0,0,0, ,0,0,0,0, ,0,0,1,1,0.00,0,0,0, ,0,0,0,0, 
11887,DOM,5,Castillo Brenda ,L,0,0,0, ,0,0,0,0,0, ,0,0,0,0, ,0,0,0,0, ,7,1,9,17,35.29,5,5,10,0.00,0,0,21,21,0.00
11887,DOM,6,Dominguez Martinez Camil Inmaculada ,S,0,0,0, ,0,0,0,0,0, ,0,0,0,0, ,0,0,0,0, ,0,0,0,0, ,0,0,0, ,0,0,0,0, 
11887,DOM,7,Marte Frica Niverka Dharlenis ,S,2,0,0,-9.09,2,2,0,1,3,66.67,0,2,2,4,-50.00,0,2,13,15,-13.33,0,0,0,0, ,3,3,6,0.00,4,2,96,102,1.96
11887,DOM,11,Rodriguez Marifranchi ,MB,0,0,0, ,0,0,0,0,0, ,0,0,0,0, ,0,0,0,0, ,0,0,0,0, ,0,0,0, ,0,0,0,0, 
11887,DOM,12,Perez Flores Yokaty ,S,0,0,0, ,0,0,0,0,0, ,0,0,0,0, ,0,0,0,0, ,0,0,0,0, ,0,0,0, ,0,0,0,0, 
11887,DOM,14,Rivera Brens Prisilla ,OH,0,0,0,0.00,0,0,0,1,1,0.00,0,0,0,0, ,0,0,7,7,0.00,0,0,2,2,0.00,0,1,1,-100.00,0,0,0,0, 
11887,DOM,16,PeÃ±a Isabel Yonkaira Paola ,OH,18,1,1,18.03,20,18,7,12,37,29.73,1,0,2,3,33.33,1,2,18,21,-4.76,8,0,16,24,33.33,9,5,14,28.57,0,0,2,2,0.00
11887,DOM,17,Mambru Casilla Gina Altagracia ,O,2,0,0,-26.32,2,2,5,4,11,-27.27,0,0,0,0, ,0,2,6,8,-25.00,0,0,0,0, ,2,1,3,33.33,0,0,1,1,0.00
11887,DOM,18,De La Cruz De PeÃ±a Bethania ,OH,11,0,2,20.59,13,11,1,9,21,47.62,0,3,3,6,-50.00,2,2,3,7,0.00,7,3,4,14,28.57,1,1,2,0.00,0,0,0,0, 
11887,DOM,20,Martinez Brayelin Elizabeth ,OH,15,1,0,16.07,16,15,4,21,40,27.50,1,1,2,4,0.00,0,2,10,12,-16.67,5,0,11,16,31.25,4,1,7,42.86,0,0,2,2,0.00
11887,DOM,21,Martinez Jineiry ,MB,3,6,1,18.18,10,3,0,3,6,50.00,6,2,0,8,50.00,1,2,16,19,-5.26,0,1,0,1,-100.00,3,1,4,50.00,0,0,1,1,0.00
11887,DOM,25,Martinez Caro Larysmer ,OH,0,0,0, ,0,0,0,0,0, ,0,0,0,0, ,0,0,0,0, ,0,0,0,0, ,0,0,0, ,0,0,0,0, 
11888,CAN,1,Bujan Cassandra ,L,0,0,0, ,0,0,0,0,0, ,0,0,0,0, ,0,0,0,0, ,4,1,8,13,23.08,6,4,11,18.18,0,0,7,7,0.00
11888,CAN,3,Van Ryk Kiera ,OH,6,2,1,16.00,9,6,1,7,14,35.71,2,3,2,7,-14.29,1,1,2,4,0.00,0,1,5,6,-16.67,1,0,3,33.33,0,0,2,2,0.00
11888,CAN,7,Van Buskirk Layne ,MB,0,0,0,-25.00,0,0,0,2,2,0.00,0,0,0,0, ,0,1,1,2,-50.00,0,0,0,0, ,1,0,1,100.00,0,0,0,0, 
11888,CAN,8,Ogoms Alicia ,MB,2,1,0,12.50,3,2,0,0,2,100.00,1,2,0,3,-33.33,0,0,3,3,0.00,0,0,0,0, ,0,0,0, ,0,0,0,0, 
11888,CAN,11,Mitrovic Andrea ,OH,3,0,1,-10.00,4,3,3,11,17,0.00,0,2,3,5,-40.00,1,2,5,8,-12.50,10,2,18,30,26.67,5,1,7,57.14,0,0,1,1,0.00
11888,CAN,12,Cross Jennifer ,MB,1,2,0,-5.56,3,1,2,3,6,-16.67,2,1,3,6,16.67,0,1,5,6,-16.67,0,0,0,0, ,4,1,5,60.00,0,0,1,1,0.00
11888,CAN,13,King Brie ,S,0,0,0,-22.22,0,0,0,1,1,0.00,0,2,0,2,-100.00,0,0,6,6,0.00,0,0,0,0, ,3,1,6,33.33,3,1,35,39,5.13
11888,CAN,14,Howe Hilary ,OH,4,2,0,-7.69,6,4,5,10,19,-5.26,2,1,0,3,33.33,0,2,2,4,-50.00,2,2,13,17,0.00,7,2,9,55.56,0,0,2,2,0.00
11888,CAN,15,Joseph Shainah ,O,6,1,0,0.00,7,6,3,9,18,16.67,1,3,4,8,-25.00,0,1,4,5,-20.00,0,0,0,0, ,3,0,3,100.00,0,0,0,0, 
11888,CAN,16,Livingston Caroline ,OH,0,0,0, ,0,0,0,0,0, ,0,0,0,0, ,0,0,0,0, ,2,0,3,5,40.00,1,0,1,100.00,0,0,0,0, 
11888,CAN,18,Robitaille Kim ,S,0,0,0,-14.29,0,0,0,0,0, ,0,1,4,5,-20.00,0,0,2,2,0.00,0,0,0,0, ,1,2,4,-25.00,4,1,36,41,7.32
11888,CAN,19,Maglio Emily ,MB,3,1,0,-14.81,4,3,0,7,10,30.00,1,6,3,10,-50.00,0,2,5,7,-28.57,0,0,0,0, ,0,0,1,0.00,0,0,2,2,0.00
11888,CAN,22,Snape Kennedy Brooklyn ,L,0,0,0, ,0,0,0,0,0, ,0,0,0,0, ,0,0,0,0, ,0,0,0,0, ,0,1,1,-100.00,0,0,0,0, 
11888,CAN,23,Austin Parker Jane ,OH,0,0,0, ,0,0,0,0,0, ,0,0,0,0, ,0,0,0,0, ,0,0,0,0, ,0,0,0, ,0,0,0,0, 
11888,JPN,1,Kurogo Ai ,OH,12,0,1,17.02,13,12,3,5,20,45.00,0,2,2,4,-50.00,1,0,22,23,4.35,0,0,0,0, ,15,3,18,66.67,0,0,1,1,0.00
11888,JPN,2,Koga Sarina ,OH,9,0,0,12.50,9,9,3,13,25,24.00,0,1,5,6,-16.67,0,0,9,9,0.00,9,0,8,17,52.94,11,1,12,83.33,0,0,2,2,0.00
11888,JPN,3,Shimamura Haruyo ,MB,0,0,0, ,0,0,0,0,0, ,0,0,0,0, ,0,0,0,0, ,0,0,0,0, ,0,0,0, ,0,0,0,0, 
11888,JPN,5,Araki Erika ,MB,0,0,0, ,0,0,0,0,0, ,0,0,0,0, ,0,0,0,0, ,0,0,0,0, ,0,0,0, ,0,0,0,0, 
11888,JPN,7,Ishii Yuki ,OH,0,0,0, ,0,0,0,0,0, ,0,0,0,0, ,0,0,0,0, ,0,0,0,0, ,0,0,0, ,0,0,0,0, 
11888,JPN,8,Ishikawa Mayu ,OH,8,0,5,12.77,13,8,5,12,25,12.00,0,2,2,4,-50.00,5,0,13,18,27.78,4,1,1,6,50.00,9,0,10,90.00,0,0,1,1,0.00
11888,JPN,10,Akutagawa Aika ,MB,2,0,0,11.11,2,2,0,4,6,33.33,0,0,0,0, ,0,1,2,3,-33.33,0,0,0,0, ,3,0,3,100.00,0,0,0,0, 
11888,JPN,11,Nabeya Yurie ,OH,1,0,0,25.00,1,1,0,0,1,100.00,0,0,0,0, ,0,0,3,3,0.00,0,0,0,0, ,0,0,0, ,0,0,0,0, 
11888,JPN,14,Kobata Mako ,L,0,0,0, ,0,0,0,0,0, ,0,0,0,0, ,0,0,0,0, ,6,1,7,14,35.71,14,1,18,72.22,0,0,4,4,0.00
11888,JPN,15,Inoue Kotoe ,L,0,0,0, ,0,0,0,0,0, ,0,0,0,0, ,0,0,0,0, ,0,0,0,0, ,0,0,0, ,0,0,0,0, 
11888,JPN,19,Yamada Nichika ,MB,9,1,0,16.13,10,9,3,7,19,31.58,1,1,1,3,0.00,0,1,8,9,-11.11,0,0,0,0, ,7,0,7,100.00,0,0,0,0, 
11888,JPN,20,Seki Nanami ,S,0,0,0,0.00,0,0,0,0,0, ,0,0,0,0, ,0,0,4,4,0.00,0,0,0,0, ,0,1,1,-100.00,3,0,3,6,50.00
11888,JPN,21,Hayashi Kotona ,OH,0,0,0,0.00,0,0,0,0,0, ,0,0,0,0, ,0,0,2,2,0.00,0,0,0,0, ,0,0,0, ,0,0,0,0, 
11888,JPN,24,Momii Aki ,S,0,3,0,0.00,3,0,0,2,2,0.00,3,2,2,7,14.29,0,1,2,3,-33.33,0,0,0,0, ,4,0,4,100.00,13,1,70,84,14.29
11889,CHN,3,Diao Linyu ,S,2,1,1,-8.70,4,2,0,0,2,100.00,1,5,0,6,-66.67,1,1,13,15,0.00,0,0,0,0, ,3,5,8,-25.00,6,3,98,107,2.80
11889,CHN,4,Yang Hanyu ,MB,7,5,0,31.25,12,7,0,4,11,63.64,5,1,0,6,66.67,0,1,14,15,-6.67,0,0,0,0, ,0,1,1,-100.00,0,0,0,0, 
11889,CHN,5,Gao Yi ,MB,2,1,0,22.22,3,2,0,2,4,50.00,1,1,1,3,0.00,0,0,2,2,0.00,0,0,0,0, ,0,0,0, ,0,0,0,0, 
11889,CHN,7,Wang Yuanyuan ,MB,7,2,0,20.00,9,7,2,3,12,41.67,2,2,1,5,0.00,0,0,8,8,0.00,0,0,0,0, ,0,0,0, ,0,0,1,1,0.00
11889,CHN,8,Li Yao ,OH,8,4,1,14.89,13,8,4,15,27,14.81,4,2,2,8,25.00,1,0,11,12,8.33,3,2,12,17,5.88,2,2,5,0.00,0,0,1,1,0.00
11889,CHN,9,Zhang Changning ,OH,0,0,0, ,0,0,0,0,0, ,0,0,0,0, ,0,0,0,0, ,0,0,0,0, ,0,0,0, ,0,0,0,0, 
11889,CHN,10,Liu Xiaotong ,OH,12,0,0,14.58,12,12,4,17,33,24.24,0,0,3,3,0.00,0,1,11,12,-8.33,15,1,19,35,40.00,4,1,5,60.00,0,0,2,2,0.00
11889,CHN,11,Yao Di ,S,0,0,0,-100.00,0,0,0,0,0, ,0,1,0,1,-100.00,0,0,0,0, ,0,0,0,0, ,0,0,0, ,0,0,5,5,0.00
11889,CHN,14,Zheng Yixin ,MB,0,0,0, ,0,0,0,0,0, ,0,0,0,0, ,0,0,0,0, ,0,0,0,0, ,0,0,0, ,0,0,0,0, 
11889,CHN,15,Lin Li ,L,0,0,0, ,0,0,0,0,0, ,0,0,0,0, ,0,0,0,0, ,8,1,6,15,46.67,9,5,16,25.00,0,0,8,8,0.00
11889,CHN,18,Wang Mengjie ,L,0,0,0, ,0,0,0,0,0, ,0,0,0,0, ,0,0,0,0, ,0,0,0,0, ,0,0,0, ,0,0,0,0, 
11889,CHN,19,Liu Yanhan ,OH,5,0,0,0.00,5,5,2,13,20,15.00,0,3,0,3,-100.00,0,0,9,9,0.00,0,1,3,4,-25.00,1,3,4,-50.00,0,0,1,1,0.00
11889,CHN,22,Duan Fang ,OH,5,0,1,14.71,6,5,1,13,19,21.05,0,0,0,0, ,1,0,14,15,6.67,3,3,8,14,0.00,2,1,3,33.33,0,0,0,0, 
11889,SRB,2,Lazovic Katarina ,OH,22,1,3,15.71,26,22,12,14,48,20.83,1,2,1,4,-25.00,3,1,14,18,11.11,14,0,22,36,38.89,9,3,12,50.00,0,0,3,3,0.00
11889,SRB,3,Caric Sara ,O,20,2,0,19.67,22,20,5,17,42,35.71,2,4,0,6,-33.33,0,1,12,13,-7.69,0,0,0,0, ,6,2,9,44.44,0,0,0,0, 
11889,SRB,6,Uzelac Aleksandra ,OH,0,0,0, ,0,0,0,0,0, ,0,0,0,0, ,0,0,0,0, ,0,0,0,0, ,0,0,0, ,0,0,0,0, 
11889,SRB,7,Jaksic Ana ,S,3,0,1,4.76,4,3,0,1,4,75.00,0,1,0,1,-100.00,1,2,13,16,-6.25,0,0,0,0, ,2,5,7,-42.86,5,0,71,76,6.58
11889,SRB,21,Kocic Jovana ,MB,7,2,0,26.92,9,7,2,5,14,35.71,2,0,1,3,66.67,0,0,9,9,0.00,0,0,0,0, ,4,0,4,100.00,0,0,0,0, 
11889,SRB,22,Lozo Sara ,O,11,2,3,16.67,16,11,5,14,30,20.00,2,1,0,3,33.33,3,2,10,15,6.67,12,1,14,27,40.74,10,2,12,66.67,0,0,4,4,0.00
11889,SRB,23,Djordjevic Mila ,S,0,0,0,-75.00,0,0,0,0,0, ,0,1,0,1,-100.00,0,2,1,3,-66.67,0,0,0,0, ,2,0,2,100.00,2,0,46,48,4.17
11889,SRB,24,Medic Sofija ,MB,3,1,1,0.00,5,3,2,3,8,12.50,1,3,1,5,-40.00,1,0,16,17,5.88,0,0,0,0, ,1,0,1,100.00,0,0,1,1,0.00
11889,SRB,25,Markovic Bozica ,MB,0,0,0,0.00,0,0,0,0,0, ,0,0,0,0, ,0,0,1,1,0.00,0,0,0,0, ,0,1,1,-100.00,0,0,0,0, 
11889,SRB,27,Bukilic Vanja ,O,0,0,0,-100.00,0,0,1,0,1,-100.00,0,0,0,0, ,0,0,0,0, ,0,0,0,0, ,0,0,0, ,0,0,0,0, 
11889,SRB,28,Delic Jelena ,MB,0,0,0, ,0,0,0,0,0, ,0,0,0,0, ,0,0,0,0, ,0,0,0,0, ,0,0,0, ,0,0,0,0, 
11889,SRB,31,Djurdjevic Sanja ,L,0,0,0, ,0,0,0,0,0, ,0,0,0,0, ,0,0,0,0, ,9,2,11,22,31.82,6,5,12,8.33,0,0,12,12,0.00
11889,SRB,32,Gocanin Bojana ,L,0,0,0, ,0,0,0,0,0, ,0,0,0,0, ,0,0,0,0, ,0,0,0,0, ,0,0,0, ,0,0,0,0, 
11889,SRB,34,Mirosavljevic Jovana ,OH,0,0,0,0.00,0,0,0,0,0, ,0,0,0,0, ,0,0,1,1,0.00,0,0,0,0, ,0,0,0, ,0,0,0,0, 
11890,KOR,1,Lee Soyoung ,OH,0,0,0, ,0,0,0,0,0, ,0,0,0,0, ,0,0,0,0, ,0,0,0,0, ,0,0,0, ,0,0,0,0, 
11890,KOR,2,Lee Dahyeon ,MB,1,1,0,-5.88,2,1,0,6,7,14.29,1,2,1,4,-25.00,0,1,5,6,-16.67,0,0,0,0, ,3,0,3,100.00,0,0,2,2,0.00
11890,KOR,3,Yeum Hye Seon ,S,0,0,2,40.00,2,0,0,0,0, ,0,0,0,0, ,2,0,3,5,40.00,0,0,0,0, ,3,2,6,16.67,2,1,15,18,5.56
11890,KOR,5,Han Dahye ,L,0,0,0, ,0,0,0,0,0, ,0,0,0,0, ,0,0,0,0, ,2,1,7,10,10.00,10,2,13,61.54,0,0,9,9,0.00
11890,KOR,6,Kim Dain ,S,0,0,1,-12.50,1,0,0,1,1,0.00,0,0,0,0, ,1,2,4,7,-14.29,0,0,0,0, ,5,2,7,42.86,7,0,54,61,11.48
11890,KOR,8,Park Eunjin ,MB,2,0,0,50.00,2,2,0,1,3,66.67,0,0,0,0, ,0,0,1,1,0.00,0,0,0,0, ,1,0,1,100.00,0,0,1,1,0.00
11890,KOR,9,Oh Jiyoung ,L,0,0,0, ,0,0,0,0,0, ,0,0,0,0, ,0,0,0,0, ,0,0,0,0, ,1,0,1,100.00,0,0,1,1,0.00
11890,KOR,10,Kim Yeon Koung ,OH,0,0,0, ,0,0,0,0,0, ,0,0,0,0, ,0,0,0,0, ,0,0,0,0, ,0,0,0, ,0,0,0,0, 
11890,KOR,12,Han Songyi ,MB,1,0,0,-15.00,1,1,1,4,6,0.00,0,2,2,4,-50.00,0,1,9,10,-10.00,0,0,0,0, ,2,1,3,33.33,0,1,0,1,-100.00
11890,KOR,13,Park Jeongah ,OH,3,0,0,-14.81,3,3,4,11,18,-5.56,0,2,2,4,-50.00,0,1,4,5,-20.00,3,1,5,9,22.22,5,1,7,57.14,0,0,3,3,0.00
11890,KOR,14,Yang Hyo Jin ,MB,0,0,0, ,0,0,0,0,0, ,0,0,0,0, ,0,0,0,0, ,0,0,0,0, ,0,0,0, ,0,0,0,0, 
11890,KOR,15,Yuk Seoyoung ,OH,5,0,0,5.56,5,5,3,7,15,13.33,0,0,0,0, ,0,1,2,3,-33.33,4,4,15,23,0.00,4,2,6,33.33,0,0,0,0, 
11890,KOR,16,Jeong Jiyun ,O,2,0,1,-13.33,3,2,7,13,22,-22.73,0,0,4,4,0.00,1,0,3,4,25.00,0,0,0,0, ,5,1,6,66.67,0,0,1,1,0.00
11890,KOR,19,Pyo Seungju ,OH,4,1,0,-11.76,5,4,5,14,23,-4.35,1,4,2,7,-42.86,0,0,4,4,0.00,4,4,18,26,0.00,3,0,4,75.00,0,0,0,0, 
11890,USA,1,Hancock Micha ,S,1,1,3,7.14,5,1,0,2,3,33.33,1,3,7,11,-18.18,3,0,11,14,21.43,0,0,0,0, ,9,1,10,80.00,26,1,40,67,37.31
11890,USA,2,Poulter Jordyn ,S,0,0,0, ,0,0,0,0,0, ,0,0,0,0, ,0,0,0,0, ,0,0,0,0, ,0,0,0, ,0,0,0,0, 
11890,USA,3,Plummer Kathryn ,OH,0,0,0, ,0,0,0,0,0, ,0,0,0,0, ,0,0,0,0, ,0,0,0,0, ,0,0,0, ,0,0,0,0, 
11890,USA,4,Wong-Orantes Justine ,L,0,0,0, ,0,0,0,0,0, ,0,0,0,0, ,0,0,0,0, ,9,1,3,13,61.54,9,1,11,72.73,0,0,7,7,0.00
11890,USA,6,Dixon Tetori ,MB,0,0,0, ,0,0,0,0,0, ,0,0,0,0, ,0,0,0,0, ,0,0,0,0, ,0,0,0, ,0,0,0,0, 
11890,USA,8,Tapp Hannah ,MB,0,0,0, ,0,0,0,0,0, ,0,0,0,0, ,0,0,0,0, ,0,0,0,0, ,0,0,0, ,0,0,0,0, 
11890,USA,10,Larson Jordan ,OH,6,0,1,13.04,7,6,2,4,12,33.33,0,1,1,2,-50.00,1,1,7,9,0.00,3,0,2,5,60.00,3,0,3,100.00,0,0,1,1,0.00
11890,USA,11,Drews Andrea ,O,0,0,0, ,0,0,0,0,0, ,0,0,0,0, ,0,0,0,0, ,0,0,0,0, ,0,0,0, ,0,0,0,0, 
11890,USA,12,Thompson Jordan ,O,7,1,1,4.88,9,7,3,11,21,19.05,1,3,2,6,-33.33,1,1,12,14,0.00,0,0,0,0, ,7,1,8,75.00,0,0,1,1,0.00
11890,USA,13,Wilhite Sarah ,OH,0,0,0, ,0,0,0,0,0, ,0,0,0,0, ,0,0,0,0, ,0,0,0,0, ,0,0,0, ,0,0,0,0, 
11890,USA,14,Bartsch-Hackley Michelle ,OH,7,1,0,2.70,8,7,3,10,20,20.00,1,3,4,8,-25.00,0,1,8,9,-11.11,6,3,5,14,21.43,11,1,14,71.43,0,0,2,2,0.00
11890,USA,15,Hill Kimberly ,OH,4,0,0,7.69,4,4,3,3,10,10.00,0,0,1,1,0.00,0,0,2,2,0.00,4,0,2,6,66.67,4,0,4,100.00,0,0,0,0, 
11890,USA,22,Washington Haleigh ,MB,7,3,5,27.03,15,7,0,3,10,70.00,3,4,5,12,-8.33,5,1,9,15,26.67,0,0,1,1,0.00,4,0,4,100.00,0,0,3,3,0.00
11890,USA,24,Ogbogu Chiaka ,MB,5,4,0,20.69,9,5,1,1,7,57.14,4,1,7,12,25.00,0,1,9,10,-10.00,0,0,0,0, ,1,0,2,50.00,0,0,0,0, 
11891,POL,1,Nowicka Julia ,S,0,0,1,-17.86,1,0,0,0,0, ,0,2,5,7,-28.57,1,4,16,21,-14.29,0,0,1,1,0.00,14,1,17,76.47,33,0,71,104,31.73
11891,POL,3,Alagierska Klaudia ,MB,2,0,0,22.22,2,2,0,1,3,66.67,0,0,2,2,0.00,0,0,4,4,0.00,0,0,0,0, ,2,0,2,100.00,0,0,1,1,0.00
11891,POL,5,Kakolewska Agnieszka ,MB,7,0,1,-2.33,8,7,4,5,16,18.75,0,3,10,13,-23.08,1,2,11,14,-7.14,0,1,0,1,-100.00,4,1,8,37.50,0,0,1,1,0.00
11891,POL,8,Stenzel Maria ,L,0,0,0, ,0,0,0,0,0, ,0,0,0,0, ,0,0,0,0, ,13,1,20,34,35.29,4,1,5,60.00,0,0,8,8,0.00
11891,POL,9,Stysiak Magdalena ,O,8,0,0,16.67,8,8,2,5,15,40.00,0,2,0,2,-100.00,0,1,0,1,-100.00,0,0,0,0, ,0,0,0, ,0,0,1,1,0.00
11891,POL,10,Efimienko-Mlotkowska Zuzanna ,MB,10,2,1,8.89,13,10,1,3,14,64.29,2,7,9,18,-27.78,1,1,11,13,0.00,0,0,0,0, ,3,0,3,100.00,0,0,0,0, 
11891,POL,11,Lukasik Martyna ,O,13,3,2,10.94,18,13,2,19,34,32.35,3,5,3,11,-18.18,2,4,13,19,-10.53,3,4,28,35,-2.86,14,0,15,93.33,0,0,3,3,0.00
11891,POL,13,Jagla Monika ,L,0,0,0, ,0,0,0,0,0, ,0,0,0,0, ,0,0,0,0, ,0,0,0,0, ,7,0,8,87.50,0,0,4,4,0.00
11891,POL,17,Smarzek Malwina ,O,16,3,0,11.11,19,16,8,23,47,17.02,3,3,2,8,0.00,0,1,7,8,-12.50,0,0,0,0, ,5,1,6,66.67,1,0,2,3,33.33
11891,POL,20,Czyrnianska Martyna ,OH,11,1,0,13.46,12,11,3,12,26,30.77,1,2,6,9,-11.11,0,0,17,17,0.00,3,1,19,23,8.70,14,5,23,39.13,0,0,2,2,0.00
11891,POL,21,Druzkowska Karolina ,O,0,0,0, ,0,0,0,0,0, ,0,0,0,0, ,0,0,0,0, ,0,0,0,0, ,0,0,0, ,0,0,0,0, 
11891,POL,27,Åazowska Martyna ,S,0,0,0,-12.50,0,0,0,0,0, ,0,1,0,1,-100.00,0,0,7,7,0.00,0,0,0,0, ,0,1,1,-100.00,3,0,19,22,13.64
11891,POL,30,Rozanski Olivia ,OH,0,0,0, ,0,0,0,0,0, ,0,0,0,0, ,0,0,0,0, ,0,0,0,0, ,0,0,0, ,0,0,0,0, 
11891,POL,88,Gorecka Zuzanna ,OH,0,0,0, ,0,0,0,0,0, ,0,0,0,0, ,0,0,0,0, ,0,1,2,3,-33.33,0,0,0, ,0,0,0,0, 
11891,NED,1,Knip Kirsten ,L,0,0,0, ,0,0,0,0,0, ,0,0,0,0, ,0,0,0,0, ,1,0,5,6,16.67,10,4,16,37.50,0,0,2,2,0.00
11891,NED,4,Plak Celeste ,OH,0,0,0,-100.00,0,0,0,0,0, ,0,0,0,0, ,0,1,0,1,-100.00,0,0,0,0, ,0,0,0, ,0,0,0,0, 
11891,NED,7,Lohuis Juliet ,MB,6,1,1,0.00,8,6,1,4,11,45.45,1,5,8,14,-28.57,1,2,14,17,-5.88,0,0,0,0, ,2,2,5,0.00,0,0,1,1,0.00
11891,NED,8,Korevaar Demi ,MB,0,0,0, ,0,0,0,0,0, ,0,0,0,0, ,0,0,0,0, ,0,0,0,0, ,0,0,0, ,0,0,0,0, 
11891,NED,9,Schoot Myrthe ,L,0,0,0, ,0,0,0,0,0, ,0,0,0,0, ,0,0,0,0, ,0,0,3,3,0.00,5,1,7,57.14,0,0,7,7,0.00
11891,NED,10,van Aalen Sarah ,S,0,0,0, ,0,0,0,0,0, ,0,0,0,0, ,0,0,0,0, ,0,0,0,0, ,0,0,0, ,0,0,0,0, 
11891,NED,11,Buijs Anne ,OH,16,1,0,8.11,17,16,7,22,45,20.00,1,4,3,8,-37.50,0,0,21,21,0.00,15,2,30,47,27.66,11,3,15,53.33,0,0,2,2,0.00
11891,NED,12,Bongaerts Britt ,S,2,1,0,10.00,3,2,0,1,3,66.67,1,1,2,4,0.00,0,0,13,13,0.00,0,1,0,1,-100.00,12,1,14,78.57,29,0,97,126,23.02
11891,NED,16,Baijens Indy ,MB,3,0,0,7.69,3,3,0,2,5,60.00,0,2,5,7,-28.57,0,0,1,1,0.00,0,1,0,1,-100.00,1,0,1,100.00,0,1,0,1,-100.00
11891,NED,18,Jasper Marrit ,OH,0,0,1,11.11,1,0,0,3,3,0.00,0,0,0,0, ,1,0,5,6,16.67,3,0,3,6,50.00,3,1,4,50.00,0,0,0,0, 
11891,NED,19,Daalderop Nika ,OH,16,1,1,11.29,18,16,7,16,39,23.08,1,3,7,11,-18.18,1,1,10,12,0.00,6,1,17,24,20.83,4,4,10,0.00,0,0,2,2,0.00
11891,NED,23,Timmerman Eline ,MB,10,5,1,8.20,16,10,1,4,15,60.00,5,8,13,26,-11.54,1,2,17,20,-5.00,0,0,1,1,0.00,6,2,9,44.44,0,0,4,4,0.00
11891,NED,26,Dambrink Elles ,O,13,0,4,19.15,17,13,3,13,29,34.48,0,1,3,4,-25.00,4,4,6,14,0.00,1,0,1,2,50.00,6,0,9,66.67,0,0,1,1,0.00
11891,NED,27,Scholten Iris ,O,0,0,0,-50.00,0,0,1,0,1,-100.00,0,1,0,1,-100.00,0,0,2,2,0.00,0,0,0,0, ,2,0,2,100.00,0,0,0,0, 
11892,GER,1,Bock Linda ,L,0,0,0, ,0,0,0,0,0, ,0,0,0,0, ,0,0,0,0, ,5,0,3,8,62.50,3,1,4,50.00,0,0,0,0, 
11892,GER,2,KÃ¤stner Pia ,S,1,2,0,14.29,3,1,0,0,1,100.00,2,1,1,4,25.00,0,0,9,9,0.00,0,0,0,0, ,6,2,9,44.44,16,0,39,55,29.09
11892,GER,4,Imoudu Denise ,S,0,0,0,-50.00,0,0,0,0,0, ,0,0,0,0, ,0,1,1,2,-50.00,0,0,0,0, ,0,0,0, ,9,0,15,24,37.50
11892,GER,5,Poll Jana Franziska ,OH,0,0,0,-60.00,0,0,2,1,3,-66.67,0,1,0,1,-100.00,0,0,1,1,0.00,2,0,2,4,50.00,1,1,3,0.00,0,0,0,0, 
11892,GER,7,Vanjak Ivana ,OH,3,0,0,-8.33,3,3,3,4,10,0.00,0,0,0,0, ,0,1,1,2,-50.00,0,1,0,1,-100.00,2,0,3,66.67,0,0,1,1,0.00
11892,GER,8,Drewniok Kimberly ,O,7,1,0,12.90,8,7,2,13,22,22.73,1,1,2,4,0.00,0,1,4,5,-20.00,0,0,0,0, ,5,1,6,66.67,0,0,1,1,0.00
11892,GER,9,Alsmeier Lina ,OH,11,2,0,8.33,13,11,5,7,23,26.09,2,3,2,7,-14.29,0,2,4,6,-33.33,6,1,10,17,29.41,1,2,3,-33.33,0,0,3,3,0.00
11892,GER,10,Stigrot Lena ,OH,2,0,0,-6.67,2,2,1,6,9,11.11,0,2,0,2,-100.00,0,0,4,4,0.00,6,3,12,21,14.29,1,2,5,-20.00,0,0,1,1,0.00
11892,GER,12,Orthmann Hanna ,OH,6,0,0,21.43,6,6,3,2,11,27.27,0,0,1,1,0.00,0,0,2,2,0.00,1,1,6,8,0.00,2,0,2,100.00,0,0,0,0, 
11892,GER,14,SchÃ¶lzel Marie ,MB,1,1,0,-9.52,2,1,1,3,5,0.00,1,2,0,3,-33.33,0,1,12,13,-7.69,0,1,0,1,-100.00,1,0,1,100.00,0,0,1,1,0.00
11892,GER,16,Ambrosius Lea ,MB,0,0,0, ,0,0,0,0,0, ,0,0,0,0, ,0,0,0,0, ,0,0,0,0, ,0,0,0, ,0,0,0,0, 
11892,GER,17,Pogany Anna ,L,0,0,0, ,0,0,0,0,0, ,0,0,0,0, ,0,0,0,0, ,6,1,1,8,62.50,5,2,7,42.86,0,0,6,6,0.00
11892,GER,21,Weitzel Camilla ,MB,3,1,1,-12.12,5,3,0,8,11,27.27,1,7,6,14,-42.86,1,2,5,8,-12.50,0,0,0,0, ,4,0,4,100.00,0,0,0,0, 
11892,GER,24,Cekulaev Anastasia ,MB,0,0,0, ,0,0,0,0,0, ,0,0,0,0, ,0,0,0,0, ,0,0,0,0, ,0,0,0, ,0,0,0,0, 
11892,ITA,2,Bosio Francesca ,S,1,0,2,9.52,3,1,0,0,1,100.00,0,1,1,2,-50.00,2,0,16,18,11.11,0,0,0,0, ,8,1,9,77.78,15,1,52,68,20.59
11892,ITA,4,Bonifacio Sara ,MB,4,0,1,17.65,5,4,0,2,6,66.67,0,2,1,3,-66.67,1,0,7,8,12.50,0,0,0,0, ,1,0,1,100.00,0,0,2,2,0.00
11892,ITA,12,Guerra Anastasia ,OH,8,1,1,5.41,10,8,4,6,18,22.22,1,3,0,4,-50.00,1,1,13,15,0.00,2,1,7,10,10.00,6,2,8,50.00,0,0,0,0, 
11892,ITA,15,Nwakalor Sylvia Chinelo ,O,0,0,0, ,0,0,0,0,0, ,0,0,0,0, ,0,0,0,0, ,0,0,0,0, ,0,0,0, ,0,0,0,0, 
11892,ITA,19,Mingardi Camilla ,OH,17,1,1,31.91,19,17,3,15,35,40.00,1,0,1,2,50.00,1,1,8,10,0.00,0,0,0,0, ,9,1,10,80.00,0,0,3,3,0.00
11892,ITA,21,Lubian Marina ,MB,0,0,0, ,0,0,0,0,0, ,0,0,0,0, ,0,0,0,0, ,0,0,1,1,0.00,0,0,0, ,0,0,0,0, 
11892,ITA,23,De Bortoli Chiara ,L,0,0,0, ,0,0,0,0,0, ,0,0,0,0, ,0,0,0,0, ,0,0,2,2,0.00,0,1,1,-100.00,0,0,0,0, 
11892,ITA,24,Mazzaro Alessia ,MB,3,2,3,23.08,8,3,1,4,8,25.00,2,0,2,4,50.00,3,1,10,14,14.29,0,0,0,0, ,3,2,5,20.00,0,0,3,3,0.00
11892,ITA,26,Battistoni Ilaria ,S,0,0,0, ,0,0,0,0,0, ,0,0,0,0, ,0,0,0,0, ,0,0,0,0, ,0,0,0, ,0,0,0,0, 
11892,ITA,27,Furlan Eleonora ,MB,0,0,0, ,0,0,0,0,0, ,0,0,0,0, ,0,0,0,0, ,0,0,0,0, ,0,0,0, ,0,0,0,0, 
11892,ITA,28,Melli Giulia ,OH,1,1,0,40.00,2,1,0,0,1,100.00,1,0,1,2,50.00,0,0,2,2,0.00,0,0,0,0, ,0,0,0, ,0,0,0,0, 
11892,ITA,29,D'Odorico Sofia ,OH,7,0,0,3.33,7,7,0,10,17,41.18,0,3,3,6,-50.00,0,3,4,7,-42.86,6,0,8,14,42.86,7,1,8,75.00,0,0,1,1,0.00
11892,ITA,31,Fersino Eleonora ,L,0,0,0, ,0,0,0,0,0, ,0,0,0,0, ,0,0,0,0, ,9,0,8,17,52.94,13,2,18,61.11,0,0,10,10,0.00
11892,ITA,32,Omoruyi Oghosasere Loveth ,OH,0,0,0, ,0,0,0,0,0, ,0,0,0,0, ,0,0,0,0, ,0,0,0,0, ,0,0,0, ,0,0,0,0, 
11893,BEL,2,Van Sas Elise ,S,0,0,0,-25.00,0,0,0,0,0, ,0,0,1,1,0.00,0,1,2,3,-33.33,0,0,0,0, ,0,1,1,-100.00,3,0,20,23,13.04
11893,BEL,3,Herbots Britt ,OH,12,0,0,13.51,12,12,4,11,27,29.63,0,3,0,3,-100.00,0,0,7,7,0.00,5,0,14,19,26.32,2,1,5,20.00,0,0,0,0, 
11893,BEL,4,Lemmens Nathalie ,MB,0,0,0, ,0,0,0,0,0, ,0,0,0,0, ,0,0,0,0, ,0,0,0,0, ,0,0,0, ,0,0,0,0, 
11893,BEL,5,Guilliams Jodie ,OH,1,0,1,-26.09,2,1,1,8,10,0.00,0,6,0,6,-100.00,1,1,5,7,0.00,3,1,13,17,11.76,2,2,6,0.00,0,0,1,1,0.00
11893,BEL,7,Van Gestel Celine ,OH,8,1,0,13.51,9,8,4,15,27,14.81,1,0,2,3,33.33,0,0,7,7,0.00,2,1,9,12,8.33,6,4,11,18.18,0,0,1,1,0.00
11893,BEL,9,Demeyer Nel ,L,0,0,0, ,0,0,0,0,0, ,0,0,0,0, ,0,0,0,0, ,0,0,0,0, ,0,0,0, ,0,0,0,0, 
11893,BEL,10,Sobolska Dominika ,MB,3,1,0,0.00,4,3,0,1,4,75.00,1,2,0,3,-33.33,0,2,4,6,-33.33,0,0,0,0, ,1,0,2,50.00,0,1,0,1,-100.00
11893,BEL,12,Krenicky Charlotte ,S,0,0,0,-20.00,0,0,0,0,0, ,0,0,2,2,0.00,0,1,2,3,-33.33,0,0,0,0, ,2,1,3,33.33,6,0,10,16,37.50
11893,BEL,13,Janssens Marlies ,MB,4,1,0,11.76,5,4,1,2,7,42.86,1,2,0,3,-33.33,0,0,7,7,0.00,0,0,0,0, ,2,3,5,-20.00,0,0,0,0, 
11893,BEL,14,De Valkeneer Lise ,OH,3,0,0,-5.88,3,3,3,3,9,0.00,0,0,4,4,0.00,0,1,3,4,-25.00,0,0,1,1,0.00,2,0,2,100.00,0,0,0,0, 
11893,BEL,17,Van De Vyver Ilka ,S,0,0,0,0.00,0,0,0,1,1,0.00,0,0,1,1,0.00,0,0,3,3,0.00,0,0,0,0, ,6,4,10,20.00,11,2,30,43,20.93
11893,BEL,18,Rampelberg Britt ,L,0,0,0, ,0,0,0,0,0, ,0,0,0,0, ,0,0,0,0, ,4,0,12,16,25.00,7,1,11,54.55,0,0,8,8,0.00
11893,BEL,19,Van Avermaet Silke ,MB,2,2,1,12.50,5,2,3,1,6,-16.67,2,0,3,5,40.00,1,0,4,5,20.00,0,0,1,1,0.00,3,0,3,100.00,0,0,2,2,0.00
11893,BEL,21,Stragier Manon ,OH,0,0,0, ,0,0,0,0,0, ,0,0,0,0, ,0,0,0,0, ,0,0,1,1,0.00,0,0,0, ,0,0,0,0, 
11893,BRA,2,De Oliveira Saad Gattaz Caroline ,MB,6,0,0,4.00,6,6,1,1,8,62.50,0,3,8,11,-27.27,0,1,5,6,-16.67,1,0,2,3,33.33,1,2,3,-33.33,0,0,3,3,0.00
11893,BRA,6,Alexandre Costa Nunes Nyeme Victoria ,L,0,0,0, ,0,0,0,0,0, ,0,0,0,0, ,0,0,0,0, ,0,0,0,0, ,0,0,0, ,0,0,0,0, 
11893,BRA,7,Montibeller Rosamaria ,OH,4,0,0,57.14,4,4,0,1,5,80.00,0,0,1,1,0.00,0,0,1,1,0.00,0,0,0,0, ,0,0,1,0.00,0,0,0,0, 
11893,BRA,8,Silva Carneiro Macris Fernanda ,S,0,1,0,-6.25,1,0,0,0,0, ,1,1,2,4,0.00,0,1,11,12,-8.33,0,0,0,0, ,2,0,2,100.00,25,0,39,64,39.06
11893,BRA,9,Ratzke Roberta Silva ,S,0,0,0,0.00,0,0,0,0,0, ,0,0,0,0, ,0,0,1,1,0.00,0,0,0,0, ,1,0,1,100.00,2,0,9,11,18.18
11893,BRA,10,Braga Guimaraes Gabriela ,OH,8,1,2,15.79,11,8,4,9,21,19.05,1,0,2,3,33.33,2,1,11,14,7.14,5,0,8,13,38.46,10,1,14,64.29,0,0,1,1,0.00
11893,BRA,11,Caixeta Tandara ,OH,16,1,0,27.50,17,16,1,7,24,62.50,1,3,1,5,-40.00,0,2,9,11,-18.18,0,0,0,0, ,3,2,7,14.29,0,0,1,1,0.00
11893,BRA,13,Castro De Paula Blassioli Sheilla ,O,0,0,0, ,0,0,0,0,0, ,0,0,0,0, ,0,0,0,0, ,0,0,0,0, ,0,0,0, ,0,0,0,0, 
11893,BRA,15,Da Silva Ana Carolina ,MB,3,2,0,0.00,5,3,0,0,3,100.00,2,5,2,9,-33.33,0,0,7,7,0.00,0,0,0,0, ,1,0,1,100.00,0,0,1,1,0.00
11893,BRA,16,Rodrigues Fernanda ,OH,9,0,0,4.76,9,9,3,10,22,27.27,0,2,3,5,-40.00,0,2,13,15,-13.33,7,1,10,18,33.33,6,2,9,44.44,0,0,1,1,0.00
11893,BRA,18,Brait Camila ,L,0,0,0, ,0,0,0,0,0, ,0,0,0,0, ,0,0,0,0, ,5,1,5,11,36.36,16,1,18,83.33,0,0,3,3,0.00
11893,BRA,20,Correa Ana Beatriz ,MB,1,1,0,12.50,2,1,0,1,2,50.00,1,1,1,3,0.00,0,0,3,3,0.00,1,0,0,1,100.00,1,0,1,100.00,0,0,1,1,0.00
11893,BRA,24,Geraldo Teixeira Lorenne ,O,0,0,0,0.00,0,0,0,0,0, ,0,0,0,0, ,0,0,4,4,0.00,0,0,0,0, ,1,0,1,100.00,0,0,0,0, 
11893,BRA,28,Araujo De Souza Mayany Cristina ,MB,0,0,0, ,0,0,0,0,0, ,0,0,0,0, ,0,0,0,0, ,0,0,0,0, ,0,0,0, ,0,0,0,0, 
11894,THA,2,Pannoy Piyanut ,L,0,0,0, ,0,0,0,0,0, ,0,0,0,0, ,0,0,0,0, ,20,1,19,40,47.50,4,0,4,100.00,0,0,9,9,0.00
11894,THA,5,Thinkaow Pleumjit ,MB,9,3,0,13.95,12,9,3,16,28,21.43,3,2,1,6,16.67,0,1,8,9,-11.11,0,0,0,0, ,1,2,4,-25.00,0,0,1,1,0.00
11894,THA,6,Sittirak Onuma ,OH,6,0,1,-2.17,7,6,6,25,37,0.00,0,2,1,3,-66.67,1,0,5,6,16.67,3,0,0,3,100.00,5,2,7,42.86,1,0,0,1,100.00
11894,THA,9,Chuewulim Sutadta ,OH,4,0,0,4.00,4,4,1,7,12,25.00,0,2,0,2,-100.00,0,0,11,11,0.00,1,1,3,5,0.00,3,1,4,50.00,0,0,0,0, 
11894,THA,10,Apinyapong Wilavan ,L,0,0,0, ,0,0,0,0,0, ,0,0,0,0, ,0,0,0,0, ,0,0,0,0, ,4,8,12,-33.33,0,0,1,1,0.00
11894,THA,11,Hyapha Amporn ,MB,3,0,0,0.00,3,3,0,5,8,37.50,0,2,1,3,-66.67,0,1,3,4,-25.00,0,0,0,0, ,3,1,4,50.00,0,0,0,0, 
11894,THA,12,Chaisri Tapaphaipun ,L,0,0,0, ,0,0,0,0,0, ,0,0,0,0, ,0,0,0,0, ,0,0,0,0, ,2,0,2,100.00,0,0,0,0, 
11894,THA,13,Tomkom Nootsara ,S,0,0,0,-14.29,0,0,0,3,3,0.00,0,1,2,3,-33.33,0,0,1,1,0.00,0,0,0,0, ,2,2,4,0.00,12,0,36,48,25.00
11894,THA,14,Juangjan Pattiya ,OH,1,0,0,-14.29,1,1,2,1,4,-25.00,0,0,0,0, ,0,0,3,3,0.00,0,0,2,2,0.00,1,1,2,0.00,0,0,0,0, 
11894,THA,15,Kanthong Malika ,O,3,0,0,-17.86,3,3,5,11,19,-10.53,0,2,0,2,-100.00,0,1,6,7,-14.29,7,1,7,15,40.00,6,2,8,50.00,0,1,1,2,-50.00
11894,THA,19,Krause Karina ,MB,6,0,0,25.00,6,6,1,2,9,55.56,0,1,1,2,-50.00,0,0,5,5,0.00,0,0,0,0, ,2,0,2,100.00,0,0,2,2,0.00
11894,THA,20,Phomla Soraya ,S,1,0,0,0.00,1,1,0,4,5,20.00,0,1,0,1,-100.00,0,0,8,8,0.00,0,0,1,1,0.00,4,1,5,60.00,10,1,48,59,15.25
11894,THA,22,Nilapa Chatsuda ,OH,0,0,0,-11.11,0,0,1,5,6,-16.67,0,0,0,0, ,0,0,3,3,0.00,0,0,3,3,0.00,0,0,0, ,0,0,2,2,0.00
11894,THA,24,Nuanjam Watchareeya ,MB,0,0,0, ,0,0,0,0,0, ,0,0,0,0, ,0,0,0,0, ,0,0,0,0, ,0,0,0, ,0,0,0,0, 
11894,DOM,1,Vargas Valdez Annerys Victoria ,MB,2,5,0,0.00,7,2,0,9,11,18.18,5,6,1,12,-8.33,0,1,14,15,-6.67,1,0,0,1,100.00,0,2,2,-100.00,0,0,0,0, 
11894,DOM,3,Eve Mejia Lisvel Elisa ,U,0,0,0, ,0,0,0,0,0, ,0,0,0,0, ,0,0,0,0, ,0,0,0,0, ,0,0,0, ,0,0,0,0, 
11894,DOM,5,Castillo Brenda ,L,0,0,0, ,0,0,0,0,0, ,0,0,0,0, ,0,0,0,0, ,12,0,6,18,66.67,16,1,18,83.33,0,0,11,11,0.00
11894,DOM,6,Dominguez Martinez Camil Inmaculada ,S,0,0,0, ,0,0,0,0,0, ,0,0,0,0, ,0,0,0,0, ,0,0,0,0, ,0,0,0, ,0,0,11,11,0.00
11894,DOM,7,Marte Frica Niverka Dharlenis ,S,0,1,1,0.00,2,0,0,2,2,0.00,1,1,3,5,0.00,1,1,10,12,0.00,0,0,0,0, ,4,1,5,60.00,21,4,75,100,17.00
11894,DOM,11,Rodriguez Marifranchi ,MB,1,0,0,0.00,1,1,1,5,7,0.00,0,0,4,4,0.00,0,0,3,3,0.00,0,0,0,0, ,1,1,2,0.00,0,0,0,0, 
11894,DOM,12,Perez Flores Yokaty ,S,0,0,0, ,0,0,0,0,0, ,0,0,0,0, ,0,0,0,0, ,0,0,0,0, ,0,0,0, ,0,0,0,0, 
11894,DOM,14,Rivera Brens Prisilla ,OH,10,1,0,9.30,11,10,3,13,26,26.92,1,3,2,6,-33.33,0,1,10,11,-9.09,2,0,8,10,20.00,6,4,10,20.00,0,0,0,0, 
11894,DOM,16,PeÃ±a Isabel Yonkaira Paola ,OH,16,0,2,23.73,18,16,1,18,35,42.86,0,2,4,6,-33.33,2,1,15,18,5.56,12,1,12,25,44.00,12,2,14,71.43,0,0,0,0, 
11894,DOM,17,Mambru Casilla Gina Altagracia ,O,2,1,0,7.69,3,2,2,4,8,0.00,1,0,1,2,50.00,0,0,3,3,0.00,0,0,0,0, ,0,1,1,-100.00,0,0,0,0, 
11894,DOM,18,De La Cruz De PeÃ±a Bethania ,OH,0,0,0, ,0,0,0,0,0, ,0,0,0,0, ,0,0,0,0, ,0,0,0,0, ,0,0,0, ,0,0,0,0, 
11894,DOM,20,Martinez Brayelin Elizabeth ,OH,9,3,0,30.30,12,9,1,13,23,34.78,3,0,0,3,100.00,0,1,6,7,-14.29,0,0,0,0, ,6,1,9,55.56,0,0,0,0, 
11894,DOM,21,Martinez Jineiry ,MB,5,0,0,28.57,5,5,0,3,8,62.50,0,1,0,1,-100.00,0,0,5,5,0.00,0,0,0,0, ,1,0,1,100.00,0,0,1,1,0.00
11894,DOM,25,Martinez Caro Larysmer ,OH,0,0,0, ,0,0,0,0,0, ,0,0,0,0, ,0,0,0,0, ,0,0,0,0, ,0,0,0, ,0,0,0,0, 
11895,TUR,2,Akoz Simge Sebnem ,L,0,0,0, ,0,0,0,0,0, ,0,0,0,0, ,0,0,0,0, ,11,3,5,19,42.11,18,7,26,42.31,0,0,8,8,0.00
11895,TUR,3,Ãzbay Cansu ,S,2,3,2,3.45,7,2,0,3,5,40.00,3,3,3,9,0.00,2,3,10,15,-6.67,0,0,0,0, ,9,3,12,50.00,32,0,71,103,31.07
11895,TUR,4,Senoglu Tugba ,OH,12,2,2,15.52,16,12,4,11,27,29.63,2,3,5,10,-10.00,2,0,19,21,9.52,13,2,19,34,32.35,8,1,10,70.00,0,0,1,1,0.00
11895,TUR,6,Caliskan Kubra ,MB,0,0,1,0.00,1,0,0,0,0, ,0,0,0,0, ,1,1,1,3,0.00,0,0,0,0, ,0,0,0, ,0,0,0,0, 
11895,TUR,7,Baladin Hande ,OH,3,0,0,8.33,3,3,1,3,7,28.57,0,0,0,0, ,0,1,4,5,-20.00,2,0,3,5,40.00,4,1,5,60.00,0,0,0,0, 
11895,TUR,8,Guveli Yasemin ,MB,0,0,0, ,0,0,0,0,0, ,0,0,0,0, ,0,0,0,0, ,0,0,0,0, ,0,0,0, ,0,0,0,0, 
11895,TUR,9,Ismailoglu Meliha ,OH,3,1,0,-3.23,4,3,2,13,18,5.56,1,2,2,5,-20.00,0,1,7,8,-12.50,8,1,14,23,30.43,3,3,7,0.00,0,0,3,3,0.00
11895,TUR,10,Aykac Ayca ,L,0,0,0, ,0,0,0,0,0, ,0,0,0,0, ,0,0,0,0, ,0,0,0,0, ,0,0,0, ,0,0,0,0, 
11895,TUR,11,Aydemir Akyol Naz ,S,1,0,0,33.33,1,1,0,0,1,100.00,0,0,1,1,0.00,0,0,1,1,0.00,0,0,0,0, ,4,1,5,60.00,7,0,15,22,31.82
11895,TUR,13,Boz Meryem ,O,5,0,0,11.11,5,5,3,5,13,15.38,0,0,1,1,0.00,0,0,4,4,0.00,0,0,0,0, ,2,0,2,100.00,0,1,0,1,-100.00
11895,TUR,14,Erdem DÃ¼ndar Eda ,MB,7,8,2,22.22,17,7,2,7,16,31.25,8,4,4,16,25.00,2,1,10,13,7.69,2,0,1,3,66.67,6,1,7,71.43,0,0,5,5,0.00
11895,TUR,18,Gunes Zehra ,MB,6,4,0,-3.12,10,6,2,4,12,33.33,4,5,4,13,-7.69,0,4,3,7,-57.14,0,0,0,0, ,3,0,3,100.00,0,0,0,0, 
11895,TUR,19,Kalac Asli ,MB,1,0,0,-22.22,1,1,1,1,3,0.00,0,2,0,2,-100.00,0,0,4,4,0.00,0,0,0,0, ,0,0,0, ,0,0,0,0, 
11895,TUR,99,Karakurt Ebrar ,OH,22,0,3,22.86,25,22,7,17,46,32.61,0,0,0,0, ,3,2,19,24,4.17,0,0,0,0, ,14,1,16,81.25,0,0,0,0, 
11895,RUS,4,Pilipenko Daria ,L,0,0,0, ,0,0,0,0,0, ,0,0,0,0, ,0,0,0,0, ,7,5,12,24,8.33,10,5,19,26.32,0,0,6,6,0.00
11895,RUS,5,Fedorovtseva Arina ,OH,11,1,1,13.95,13,11,5,11,27,22.22,1,0,0,1,100.00,1,2,12,15,-6.67,6,3,19,28,10.71,5,4,13,7.69,0,0,1,1,0.00
11895,RUS,6,Koroleva Irina ,MB,3,5,0,-2.78,8,3,0,5,8,37.50,5,7,3,15,-13.33,0,2,11,13,-15.38,0,0,1,1,0.00,2,1,3,33.33,0,0,1,1,0.00
11895,RUS,8,Goncharova Nataliya ,O,13,1,0,4.26,14,13,7,9,29,20.69,1,3,2,6,-33.33,0,2,10,12,-16.67,0,0,0,0, ,6,1,8,62.50,0,0,3,3,0.00
11895,RUS,9,Gorbunova Valeriia ,O,0,0,0, ,0,0,0,0,0, ,0,0,0,0, ,0,0,0,0, ,0,0,0,0, ,0,0,0, ,0,0,0,0, 
11895,RUS,10,Matveeva Polina ,S,0,0,0,-25.00,0,0,0,1,1,0.00,0,1,1,2,-50.00,0,0,1,1,0.00,0,0,0,0, ,1,1,4,0.00,0,0,13,13,0.00
11895,RUS,11,Brovkina Yulia ,MB,0,0,0, ,0,0,0,0,0, ,0,0,0,0, ,0,0,0,0, ,0,0,0,0, ,0,0,0, ,0,0,0,0, 
11895,RUS,13,Startseva Evgeniya ,S,1,0,0,-8.70,1,1,0,2,3,33.33,0,3,5,8,-37.50,0,0,12,12,0.00,0,0,0,0, ,4,3,8,12.50,6,0,74,80,7.50
11895,RUS,14,Fetisova Irina ,MB,5,6,1,16.67,12,5,0,5,10,50.00,6,5,8,19,5.26,1,0,12,13,7.69,1,0,4,5,20.00,5,2,7,42.86,0,0,3,3,0.00
11895,RUS,16,Voronkova Irina ,OH,9,0,1,4.35,10,9,6,15,30,10.00,0,1,4,5,-20.00,1,1,9,11,0.00,5,1,13,19,21.05,10,1,11,81.82,0,0,1,1,0.00
11895,RUS,20,Lazareva Ekaterina ,S,0,0,0,0.00,0,0,0,0,0, ,0,0,1,1,0.00,0,0,1,1,0.00,0,0,0,0, ,0,0,0, ,2,1,14,17,5.88
11895,RUS,23,Kapustina Irina ,OH,0,0,0, ,0,0,0,0,0, ,0,0,0,0, ,0,0,0,0, ,0,0,0,0, ,0,0,0, ,0,0,0,0, 
11895,RUS,24,Pipunyrova Ekaterina ,OH,0,0,1,-16.67,1,0,0,0,0, ,0,0,0,0, ,1,2,3,6,-16.67,0,0,0,0, ,2,2,4,0.00,0,0,0,0, 
11895,RUS,25,Smirnova Kseniia ,OH,10,0,2,14.29,12,10,3,6,19,36.84,0,2,2,4,-50.00,2,2,8,12,0.00,2,1,12,15,6.67,6,2,8,50.00,0,0,1,1,0.00
11896,CAN,1,Bujan Cassandra ,L,0,0,0, ,0,0,0,0,0, ,0,0,0,0, ,0,0,0,0, ,1,2,15,18,-5.56,8,4,12,33.33,0,0,3,3,0.00
11896,CAN,3,Van Ryk Kiera ,OH,6,0,0,-4.00,6,6,4,7,17,11.76,0,1,0,1,-100.00,0,2,5,7,-28.57,1,0,0,1,100.00,2,2,4,0.00,0,0,0,0, 
11896,CAN,6,White Jazmine  Ruth ,MB,0,0,0, ,0,0,0,0,0, ,0,0,0,0, ,0,0,0,0, ,0,0,0,0, ,0,0,0, ,0,0,0,0, 
11896,CAN,7,Van Buskirk Layne ,MB,0,0,0, ,0,0,0,0,0, ,0,0,0,0, ,0,0,0,0, ,0,0,0,0, ,0,0,0, ,0,0,0,0, 
11896,CAN,8,Ogoms Alicia ,MB,2,0,0,16.67,2,2,0,0,2,100.00,0,0,0,0, ,0,0,10,10,0.00,0,0,0,0, ,1,1,2,0.00,0,0,0,0, 
11896,CAN,11,Mitrovic Andrea ,OH,8,0,0,3.12,8,8,5,11,24,12.50,0,1,0,1,-100.00,0,1,6,7,-14.29,4,1,16,21,14.29,2,2,4,0.00,0,1,3,4,-25.00
11896,CAN,12,Cross Jennifer ,MB,1,0,0,0.00,1,1,1,5,7,0.00,0,0,1,1,0.00,0,0,4,4,0.00,0,0,0,0, ,0,1,1,-100.00,0,0,0,0, 
11896,CAN,13,King Brie ,S,0,0,1,0.00,1,0,1,1,2,-50.00,0,0,1,1,0.00,1,0,4,5,20.00,0,0,0,0, ,0,4,5,-80.00,5,0,40,45,11.11
11896,CAN,14,Howe Hilary ,OH,8,1,0,-2.94,9,8,5,10,23,13.04,1,3,0,4,-50.00,0,2,5,7,-28.57,5,1,21,27,14.81,4,2,7,28.57,0,0,0,0, 
11896,CAN,15,Joseph Shainah ,O,4,0,0,10.53,4,4,2,9,15,13.33,0,0,2,2,0.00,0,0,2,2,0.00,0,0,0,0, ,3,1,4,50.00,0,0,0,0, 
11896,CAN,18,Robitaille Kim ,S,0,1,0,0.00,1,0,0,1,1,0.00,1,0,0,1,100.00,0,1,1,2,-50.00,0,0,0,0, ,2,1,3,33.33,3,0,42,45,6.67
11896,CAN,19,Maglio Emily ,MB,4,2,1,19.23,7,4,1,7,12,25.00,2,1,2,5,20.00,1,0,8,9,11.11,0,0,1,1,0.00,2,2,4,0.00,0,0,2,2,0.00
11896,CAN,22,Snape Kennedy Brooklyn ,L,0,0,0, ,0,0,0,0,0, ,0,0,0,0, ,0,0,0,0, ,0,0,0,0, ,0,0,0, ,0,0,0,0, 
11896,CAN,23,Austin Parker Jane ,OH,0,0,0, ,0,0,0,0,0, ,0,0,0,0, ,0,0,0,0, ,0,0,0,0, ,0,0,0, ,0,0,0,0, 
11896,NED,2,Savelkoel Fleur ,OH,0,0,0, ,0,0,0,0,0, ,0,0,0,0, ,0,0,0,0, ,0,0,0,0, ,0,0,0, ,0,0,0,0, 
11896,NED,4,Plak Celeste ,OH,4,0,0,4.76,4,4,1,5,10,30.00,0,2,0,2,-100.00,0,0,9,9,0.00,0,0,0,0, ,3,1,4,50.00,0,0,0,0, 
11896,NED,7,Lohuis Juliet ,MB,10,1,1,32.14,12,10,0,2,12,83.33,1,3,1,5,-40.00,1,0,10,11,9.09,0,0,0,0, ,3,1,4,50.00,0,0,0,0, 
11896,NED,8,Korevaar Demi ,MB,0,1,0,20.00,1,0,0,1,1,0.00,1,0,1,2,50.00,0,0,2,2,0.00,0,0,0,0, ,1,0,1,100.00,0,0,0,0, 
11896,NED,9,Schoot Myrthe ,L,0,0,0, ,0,0,0,0,0, ,0,0,0,0, ,0,0,0,0, ,6,1,9,16,31.25,10,1,11,81.82,0,0,6,6,0.00
11896,NED,10,van Aalen Sarah ,S,0,0,0, ,0,0,0,0,0, ,0,0,0,0, ,0,0,0,0, ,0,0,0,0, ,0,0,0, ,0,0,0,0, 
11896,NED,11,Buijs Anne ,OH,11,3,1,26.19,15,11,2,10,23,39.13,3,2,0,5,20.00,1,0,13,14,7.14,6,0,10,16,37.50,2,1,3,33.33,0,0,0,0, 
11896,NED,12,Bongaerts Britt ,S,1,2,1,11.76,4,1,0,2,3,33.33,2,1,3,6,16.67,1,1,6,8,0.00,0,0,0,0, ,4,3,8,12.50,10,1,67,78,11.54
11896,NED,13,Jasper Hester ,OH,0,0,0, ,0,0,0,0,0, ,0,0,0,0, ,0,0,0,0, ,0,0,0,0, ,0,0,0, ,0,0,0,0, 
11896,NED,18,Jasper Marrit ,OH,0,0,0,-33.33,0,0,1,1,2,-50.00,0,0,0,0, ,0,0,1,1,0.00,0,0,4,4,0.00,2,2,4,0.00,0,0,1,1,0.00
11896,NED,19,Daalderop Nika ,OH,7,1,1,13.16,9,7,3,11,21,19.05,1,0,1,2,50.00,1,1,13,15,0.00,3,1,7,11,18.18,3,4,8,-12.50,0,0,0,0, 
11896,NED,23,Timmerman Eline ,MB,6,4,0,15.38,10,6,1,4,11,45.45,4,2,1,7,28.57,0,3,5,8,-37.50,0,0,0,0, ,3,1,5,40.00,0,0,1,1,0.00
11896,NED,26,Dambrink Elles ,O,5,0,0,15.00,5,5,0,5,10,50.00,0,1,3,4,-25.00,0,1,5,6,-16.67,0,0,0,0, ,1,0,1,100.00,0,0,0,0, 
11896,NED,27,Scholten Iris ,O,0,0,0, ,0,0,0,0,0, ,0,0,0,0, ,0,0,0,0, ,0,0,0,0, ,0,0,0, ,0,0,0,0, 
11897,JPN,1,Kurogo Ai ,OH,19,0,2,12.00,21,19,7,22,48,25.00,0,4,2,6,-66.67,2,1,18,21,4.76,0,0,0,0, ,13,5,20,40.00,1,0,2,3,33.33
11897,JPN,2,Koga Sarina ,OH,24,2,0,21.43,26,24,5,14,43,44.19,2,4,3,9,-22.22,0,2,16,18,-11.11,17,0,22,39,43.59,13,2,16,68.75,0,0,2,2,0.00
11897,JPN,3,Shimamura Haruyo ,MB,0,0,0, ,0,0,0,0,0, ,0,0,0,0, ,0,0,0,0, ,0,0,0,0, ,0,0,0, ,0,0,0,0, 
11897,JPN,5,Araki Erika ,MB,8,1,0,4.00,9,8,2,9,19,31.58,1,4,6,11,-27.27,0,1,19,20,-5.00,0,0,1,1,0.00,6,0,6,100.00,0,0,0,0, 
11897,JPN,7,Ishii Yuki ,OH,0,0,0, ,0,0,0,0,0, ,0,0,0,0, ,0,0,0,0, ,0,0,6,6,0.00,2,1,3,33.33,0,0,0,0, 
11897,JPN,8,Ishikawa Mayu ,OH,19,1,1,13.43,21,19,7,16,42,28.57,1,2,4,7,-14.29,1,3,14,18,-11.11,20,0,14,34,58.82,10,5,15,33.33,0,0,1,1,0.00
11897,JPN,10,Akutagawa Aika ,MB,0,0,0, ,0,0,0,0,0, ,0,0,0,0, ,0,0,0,0, ,0,0,0,0, ,0,0,0, ,0,0,0,0, 
11897,JPN,11,Nabeya Yurie ,OH,0,0,1,16.67,1,0,0,0,0, ,0,0,0,0, ,1,0,5,6,16.67,0,0,0,0, ,0,2,3,-66.67,0,0,0,0, 
11897,JPN,14,Kobata Mako ,L,0,0,0, ,0,0,0,0,0, ,0,0,0,0, ,0,0,0,0, ,8,0,6,14,57.14,10,3,13,53.85,0,0,7,7,0.00
11897,JPN,15,Inoue Kotoe ,L,0,0,0, ,0,0,0,0,0, ,0,0,0,0, ,0,0,0,0, ,0,0,0,0, ,4,2,6,33.33,0,0,0,0, 
11897,JPN,19,Yamada Nichika ,MB,3,3,1,-5.88,7,3,4,4,11,-9.09,3,5,2,10,-20.00,1,0,12,13,7.69,0,0,2,2,0.00,3,0,5,60.00,0,0,0,0, 
11897,JPN,20,Seki Nanami ,S,0,0,0,-100.00,0,0,0,0,0, ,0,0,0,0, ,0,1,0,1,-100.00,0,0,0,0, ,0,0,0, ,0,0,0,0, 
11897,JPN,21,Hayashi Kotona ,OH,0,0,0, ,0,0,0,0,0, ,0,0,0,0, ,0,0,0,0, ,0,0,0,0, ,0,0,0, ,0,0,0,0, 
11897,JPN,24,Momii Aki ,S,0,0,0,-22.22,0,0,0,0,0, ,0,3,3,6,-50.00,0,1,11,12,-8.33,0,0,0,0, ,5,7,13,-15.38,57,0,94,151,37.75
11897,POL,1,Nowicka Julia ,S,4,1,0,-8.33,5,4,0,4,8,50.00,1,7,0,8,-75.00,0,1,19,20,-5.00,0,0,0,0, ,6,2,9,44.44,29,2,95,126,21.43
11897,POL,3,Alagierska Klaudia ,MB,5,2,0,0.00,7,5,1,2,8,50.00,2,4,2,8,-25.00,0,2,22,24,-8.33,0,0,0,0, ,4,4,8,0.00,0,0,0,0, 
11897,POL,5,Kakolewska Agnieszka ,MB,5,2,0,0.00,7,5,1,8,14,28.57,2,5,4,11,-27.27,0,1,12,13,-7.69,0,0,0,0, ,3,0,3,100.00,0,0,1,1,0.00
11897,POL,8,Stenzel Maria ,L,0,0,0, ,0,0,0,0,0, ,0,0,0,0, ,0,0,0,0, ,10,0,13,23,43.48,10,3,14,50.00,0,0,12,12,0.00
11897,POL,9,Stysiak Magdalena ,O,33,2,0,23.46,35,33,8,17,58,43.10,2,4,1,7,-28.57,0,4,12,16,-25.00,0,0,0,0, ,14,3,19,57.89,0,0,2,2,0.00
11897,POL,11,Lukasik Martyna ,O,3,0,0,5.26,3,3,0,4,7,42.86,0,0,3,3,0.00,0,2,7,9,-22.22,3,0,3,6,50.00,4,1,5,60.00,0,0,1,1,0.00
11897,POL,13,Jagla Monika ,L,0,0,0, ,0,0,0,0,0, ,0,0,0,0, ,0,0,0,0, ,0,0,0,0, ,6,4,11,18.18,0,0,4,4,0.00
11897,POL,17,Smarzek Malwina ,O,0,0,0, ,0,0,0,0,0, ,0,0,0,0, ,0,0,0,0, ,0,0,0,0, ,0,0,0, ,0,0,0,0, 
11897,POL,19,Fedusio Monika ,OH,0,0,0, ,0,0,0,0,0, ,0,0,0,0, ,0,0,0,0, ,0,0,0,0, ,0,0,0, ,0,0,0,0, 
11897,POL,20,Czyrnianska Martyna ,OH,0,0,0, ,0,0,0,0,0, ,0,0,0,0, ,0,0,0,0, ,0,0,0,0, ,0,0,0, ,0,0,0,0, 
11897,POL,27,Åazowska Martyna ,S,0,1,0,0.00,1,0,0,0,0, ,1,1,1,3,0.00,0,0,0,0, ,0,0,0,0, ,0,0,0, ,0,0,2,2,0.00
11897,POL,30,Rozanski Olivia ,OH,9,3,0,17.50,12,9,3,14,26,23.08,3,0,2,5,60.00,0,2,7,9,-22.22,1,1,12,14,0.00,5,3,10,20.00,0,0,0,0, 
11897,POL,78,Gryka Aleksandra ,MB,0,0,0,-100.00,0,0,0,0,0, ,0,1,0,1,-100.00,0,0,0,0, ,0,0,0,0, ,0,0,0, ,0,0,0,0, 
11897,POL,88,Gorecka Zuzanna ,OH,15,4,0,25.00,19,15,2,19,36,36.11,4,1,1,6,50.00,0,1,17,18,-5.56,14,4,39,57,17.54,13,4,18,50.00,0,0,4,4,0.00
11898,CHN,3,Diao Linyu ,S,0,0,0,0.00,0,0,0,0,0, ,0,0,0,0, ,0,0,2,2,0.00,0,0,0,0, ,3,1,4,50.00,11,0,16,27,40.74
11898,CHN,4,Yang Hanyu ,MB,13,1,0,15.69,14,13,1,7,21,57.14,1,5,9,15,-26.67,0,0,15,15,0.00,0,0,0,0, ,0,2,2,-100.00,0,0,3,3,0.00
11898,CHN,5,Gao Yi ,MB,0,0,0, ,0,0,0,0,0, ,0,0,0,0, ,0,0,0,0, ,0,0,0,0, ,0,0,0, ,0,0,0,0, 
11898,CHN,7,Wang Yuanyuan ,MB,8,3,0,7.84,11,8,1,10,19,36.84,3,5,8,16,-12.50,0,1,15,16,-6.25,0,0,0,0, ,3,2,5,20.00,0,0,3,3,0.00
11898,CHN,8,Li Yao ,OH,4,0,0,-10.64,4,4,3,15,22,4.55,0,6,3,9,-66.67,0,0,16,16,0.00,5,0,14,19,26.32,9,8,24,4.17,0,0,4,4,0.00
11898,CHN,9,Zhang Changning ,OH,32,2,2,32.56,36,32,4,24,60,46.67,2,4,3,9,-22.22,2,0,15,17,11.76,5,1,10,16,25.00,10,2,17,47.06,0,0,4,4,0.00
11898,CHN,10,Liu Xiaotong ,OH,8,1,0,-5.45,9,8,6,21,35,5.71,1,6,1,8,-62.50,0,0,12,12,0.00,7,1,29,37,16.22,15,2,19,68.42,0,0,6,6,0.00
11898,CHN,11,Yao Di ,S,0,2,0,0.00,2,0,0,0,0, ,2,1,6,9,11.11,0,1,14,15,-6.67,0,0,0,0, ,13,2,16,68.75,52,2,64,118,42.37
11898,CHN,14,Zheng Yixin ,MB,0,0,0, ,0,0,0,0,0, ,0,0,0,0, ,0,0,0,0, ,0,0,0,0, ,0,0,0, ,0,0,0,0, 
11898,CHN,15,Lin Li ,L,0,0,0, ,0,0,0,0,0, ,0,0,0,0, ,0,0,0,0, ,0,0,0,0, ,0,0,0, ,0,0,0,0, 
11898,CHN,18,Wang Mengjie ,L,0,0,0, ,0,0,0,0,0, ,0,0,0,0, ,0,0,0,0, ,12,0,10,22,54.55,21,5,29,55.17,0,0,10,10,0.00
11898,CHN,19,Liu Yanhan ,OH,2,0,0,0.00,2,2,1,9,12,8.33,0,1,1,2,-50.00,0,0,2,2,0.00,0,0,0,0, ,6,1,8,62.50,0,0,0,0, 
11898,CHN,22,Duan Fang ,OH,2,0,0,12.50,2,2,0,4,6,33.33,0,1,0,1,-100.00,0,0,1,1,0.00,1,0,3,4,25.00,1,0,1,100.00,0,0,0,0, 
11898,BRA,2,De Oliveira Saad Gattaz Caroline ,MB,16,2,1,16.36,19,16,1,7,24,62.50,2,7,12,21,-23.81,1,2,7,10,-10.00,0,0,1,1,0.00,4,1,5,60.00,0,0,3,3,0.00
11898,BRA,3,Rodrigues Lins Dos Santos Danielle ,S,0,0,0,0.00,0,0,0,0,0, ,0,0,0,0, ,0,0,6,6,0.00,0,0,0,0, ,2,0,4,50.00,4,1,14,19,15.79
11898,BRA,5,Da Silva Adenizia ,MB,0,0,0, ,0,0,0,0,0, ,0,0,0,0, ,0,0,0,0, ,0,0,0,0, ,0,0,0, ,0,0,0,0, 
11898,BRA,6,Alexandre Costa Nunes Nyeme Victoria ,L,0,0,0, ,0,0,0,0,0, ,0,0,0,0, ,0,0,0,0, ,0,0,0,0, ,0,0,0, ,0,0,0,0, 
11898,BRA,7,Montibeller Rosamaria ,OH,7,0,0,23.53,7,7,2,4,13,38.46,0,1,3,4,-25.00,0,0,0,0, ,0,0,0,0, ,0,0,2,0.00,0,0,0,0, 
11898,BRA,8,Silva Carneiro Macris Fernanda ,S,3,0,0,4.00,3,3,0,3,6,50.00,0,1,1,2,-50.00,0,1,16,17,-5.88,0,0,1,1,0.00,13,2,16,68.75,45,0,79,124,36.29
11898,BRA,10,Braga Guimaraes Gabriela ,OH,15,3,1,22.22,19,15,5,10,30,33.33,3,1,3,7,28.57,1,1,15,17,0.00,11,0,21,32,34.38,21,3,28,64.29,0,0,3,3,0.00
11898,BRA,11,Caixeta Tandara ,OH,22,4,0,17.05,26,22,5,31,58,29.31,4,6,3,13,-15.38,0,0,17,17,0.00,0,0,0,0, ,9,1,12,66.67,0,0,2,2,0.00
11898,BRA,15,Da Silva Ana Carolina ,MB,4,0,0,-17.65,4,4,2,3,9,22.22,0,7,7,14,-50.00,0,1,10,11,-9.09,0,0,0,0, ,2,1,4,25.00,0,0,6,6,0.00
11898,BRA,16,Rodrigues Fernanda ,OH,12,3,0,6.06,15,12,3,20,35,25.71,3,7,7,17,-23.53,0,1,13,14,-7.14,9,2,22,33,21.21,13,5,19,42.11,0,0,2,2,0.00
11898,BRA,17,Menezes Oliveira de Souza Ana Cristina ,OH,0,0,0, ,0,0,0,0,0, ,0,0,0,0, ,0,0,0,0, ,0,0,0,0, ,0,0,0, ,0,0,0,0, 
11898,BRA,18,Brait Camila ,L,0,0,0, ,0,0,0,0,0, ,0,0,0,0, ,0,0,0,0, ,8,0,18,26,30.77,21,5,30,53.33,0,0,12,12,0.00
11898,BRA,20,Correa Ana Beatriz ,MB,2,0,0,-4.55,2,2,0,2,4,50.00,0,2,7,9,-22.22,0,1,8,9,-11.11,0,0,1,1,0.00,2,0,3,66.67,0,0,1,1,0.00
11898,BRA,24,Geraldo Teixeira Lorenne ,O,0,0,0,0.00,0,0,0,0,0, ,0,0,0,0, ,0,0,4,4,0.00,0,0,0,0, ,0,0,0, ,0,0,0,0, 
11899,GER,1,Bock Linda ,L,0,0,0, ,0,0,0,0,0, ,0,0,0,0, ,0,0,0,0, ,5,0,2,7,71.43,7,1,8,75.00,0,0,6,6,0.00
11899,GER,2,KÃ¤stner Pia ,S,0,0,0, ,0,0,0,0,0, ,0,0,0,0, ,0,0,0,0, ,0,0,0,0, ,0,0,0, ,0,0,0,0, 
11899,GER,4,Imoudu Denise ,S,2,0,1,-9.52,3,2,0,1,3,66.67,0,2,2,4,-50.00,1,3,10,14,-14.29,0,0,0,0, ,10,0,11,90.91,14,0,58,72,19.44
11899,GER,5,Poll Jana Franziska ,OH,0,0,0, ,0,0,0,0,0, ,0,0,0,0, ,0,0,0,0, ,0,0,0,0, ,0,0,0, ,0,0,0,0, 
11899,GER,7,Vanjak Ivana ,OH,0,0,0, ,0,0,0,0,0, ,0,0,0,0, ,0,0,0,0, ,0,0,0,0, ,0,0,0, ,0,0,0,0, 
11899,GER,8,Drewniok Kimberly ,O,10,4,0,11.32,14,10,5,12,27,18.52,4,2,9,15,13.33,0,1,10,11,-9.09,0,0,0,0, ,7,7,15,0.00,0,0,2,2,0.00
11899,GER,9,Alsmeier Lina ,OH,14,1,0,38.71,15,14,1,3,18,72.22,1,0,1,2,50.00,0,2,9,11,-18.18,6,1,9,16,31.25,11,0,11,100.00,0,1,2,3,-33.33
11899,GER,10,Stigrot Lena ,OH,0,0,0, ,0,0,0,0,0, ,0,0,0,0, ,0,0,0,0, ,0,0,0,0, ,0,0,0, ,0,0,0,0, 
11899,GER,12,Orthmann Hanna ,OH,13,3,3,31.11,19,13,4,8,25,36.00,3,0,2,5,60.00,3,1,11,15,13.33,10,1,15,26,34.62,5,1,9,44.44,0,1,2,3,-33.33
11899,GER,14,SchÃ¶lzel Marie ,MB,5,1,0,3.85,6,5,1,5,11,36.36,1,3,4,8,-25.00,0,1,6,7,-14.29,1,0,2,3,33.33,2,0,2,100.00,0,0,0,0, 
11899,GER,17,Pogany Anna ,L,0,0,0, ,0,0,0,0,0, ,0,0,0,0, ,0,0,0,0, ,0,0,0,0, ,0,0,0, ,0,0,0,0, 
11899,GER,20,Bock Josepha ,MB,0,0,0, ,0,0,0,0,0, ,0,0,0,0, ,0,0,0,0, ,0,0,0,0, ,0,0,0, ,0,0,0,0, 
11899,GER,21,Weitzel Camilla ,MB,6,1,0,-2.94,7,6,1,4,11,45.45,1,6,1,8,-62.50,0,1,14,15,-6.67,0,0,1,1,0.00,3,1,4,50.00,0,0,4,4,0.00
11899,GER,24,Cekulaev Anastasia ,MB,0,0,0, ,0,0,0,0,0, ,0,0,0,0, ,0,0,0,0, ,0,0,0,0, ,0,0,0, ,0,0,0,0, 
11899,KOR,1,Lee Soyoung ,OH,2,0,1,-9.52,3,2,4,8,14,-14.29,0,0,0,0, ,1,1,5,7,0.00,5,2,14,21,14.29,5,1,7,57.14,0,0,3,3,0.00
11899,KOR,3,Yeum Hye Seon ,S,0,0,0,-25.00,0,0,0,1,1,0.00,0,1,0,1,-100.00,0,1,5,6,-16.67,0,0,1,1,0.00,7,2,9,55.56,1,1,42,44,0.00
11899,KOR,5,Han Dahye ,L,0,0,0, ,0,0,0,0,0, ,0,0,0,0, ,0,0,0,0, ,0,0,2,2,0.00,0,0,0, ,0,0,0,0, 
11899,KOR,6,Kim Dain ,S,0,0,0, ,0,0,0,0,0, ,0,0,0,0, ,0,0,0,0, ,0,0,0,0, ,0,0,0, ,0,0,0,0, 
11899,KOR,7,An Hyejin ,S,0,0,1,0.00,1,0,0,0,0, ,0,0,0,0, ,1,1,6,8,0.00,0,0,0,0, ,3,1,4,50.00,2,0,37,39,5.13
11899,KOR,8,Park Eunjin ,MB,1,0,0,-15.38,1,1,1,6,8,0.00,0,1,0,1,-100.00,0,1,3,4,-25.00,0,0,0,0, ,3,1,4,50.00,0,0,0,0, 
11899,KOR,9,Oh Jiyoung ,L,0,0,0, ,0,0,0,0,0, ,0,0,0,0, ,0,0,0,0, ,5,1,14,20,20.00,7,4,12,25.00,0,0,7,7,0.00
11899,KOR,10,Kim Yeon Koung ,OH,10,0,0,15.79,10,10,3,12,25,28.00,0,1,1,2,-50.00,0,0,11,11,0.00,2,0,14,16,12.50,7,3,10,40.00,0,0,5,5,0.00
11899,KOR,12,Han Songyi ,MB,0,0,0,0.00,0,0,0,0,0, ,0,0,0,0, ,0,0,1,1,0.00,0,0,0,0, ,0,0,0, ,0,0,0,0, 
11899,KOR,13,Park Jeongah ,OH,11,2,0,21.43,13,11,3,17,31,25.81,2,1,1,4,25.00,0,0,7,7,0.00,0,1,3,4,-25.00,7,2,9,55.56,0,0,1,1,0.00
11899,KOR,14,Yang Hyo Jin ,MB,2,1,0,0.00,3,2,2,2,6,0.00,1,1,2,4,0.00,0,0,9,9,0.00,0,0,0,0, ,2,0,5,40.00,0,0,5,5,0.00
11899,KOR,15,Yuk Seoyoung ,OH,0,0,0, ,0,0,0,0,0, ,0,0,0,0, ,0,0,0,0, ,0,0,0,0, ,0,0,0, ,0,0,0,0, 
11899,KOR,16,Jeong Jiyun ,O,4,0,0,0.00,4,4,3,6,13,7.69,0,1,1,2,-50.00,0,0,3,3,0.00,0,0,0,0, ,1,2,3,-33.33,0,0,0,0, 
11899,KOR,19,Pyo Seungju ,OH,0,0,0,0.00,0,0,0,0,0, ,0,0,0,0, ,0,0,1,1,0.00,0,0,0,0, ,0,0,0, ,0,0,0,0, 
11900,BEL,2,Van Sas Elise ,S,0,0,0, ,0,0,0,0,0, ,0,0,0,0, ,0,0,0,0, ,0,0,0,0, ,0,0,0, ,1,0,6,7,14.29
11900,BEL,3,Herbots Britt ,OH,27,1,0,11.00,28,27,7,43,77,25.97,1,7,1,9,-66.67,0,3,11,14,-21.43,3,0,4,7,42.86,13,4,20,45.00,0,0,4,4,0.00
11900,BEL,4,Lemmens Nathalie ,MB,0,0,0,0.00,0,0,0,0,0, ,0,0,1,1,0.00,0,0,0,0, ,0,0,0,0, ,0,0,0, ,0,0,0,0, 
11900,BEL,5,Guilliams Jodie ,OH,9,3,2,3.12,14,9,7,21,37,5.41,3,2,2,7,14.29,2,3,15,20,-5.00,3,1,20,24,8.33,15,4,21,52.38,0,1,3,4,-25.00
11900,BEL,6,Gilson Helena ,OH,0,0,0,0.00,0,0,0,3,3,0.00,0,0,0,0, ,0,0,0,0, ,0,0,1,1,0.00,0,0,0, ,0,0,0,0, 
11900,BEL,7,Van Gestel Celine ,OH,8,1,1,3.51,10,8,3,23,34,14.71,1,4,1,6,-50.00,1,1,15,17,0.00,14,2,40,56,21.43,19,3,25,64.00,0,0,2,2,0.00
11900,BEL,9,Demeyer Nel ,L,0,0,0, ,0,0,0,0,0, ,0,0,0,0, ,0,0,0,0, ,0,0,0,0, ,0,1,1,-100.00,0,0,0,0, 
11900,BEL,10,Sobolska Dominika ,MB,0,0,0, ,0,0,0,0,0, ,0,0,0,0, ,0,0,0,0, ,0,0,0,0, ,0,0,0, ,0,0,0,0, 
11900,BEL,13,Janssens Marlies ,MB,10,1,2,8.93,13,10,2,10,22,36.36,1,4,9,14,-21.43,2,2,16,20,0.00,0,0,0,0, ,4,0,7,57.14,0,0,2,2,0.00
11900,BEL,15,Van De Vyver Jutta ,S,0,0,0, ,0,0,0,0,0, ,0,0,0,0, ,0,0,0,0, ,0,0,0,0, ,0,0,0, ,0,0,0,0, 
11900,BEL,17,Van De Vyver Ilka ,S,0,0,2,-2.94,2,0,0,2,2,0.00,0,2,9,11,-18.18,2,1,18,21,4.76,0,0,0,0, ,19,4,26,57.69,40,1,117,158,24.68
11900,BEL,18,Rampelberg Britt ,L,0,0,0, ,0,0,0,0,0, ,0,0,0,0, ,0,0,0,0, ,5,1,4,10,40.00,25,9,41,39.02,0,0,17,17,0.00
11900,BEL,19,Van Avermaet Silke ,MB,11,7,1,14.29,19,11,3,11,25,32.00,7,6,8,21,4.76,1,1,15,17,0.00,0,0,0,0, ,6,1,8,62.50,0,0,2,2,0.00
11900,BEL,21,Stragier Manon ,OH,0,0,0,-40.00,0,0,1,1,2,-50.00,0,0,0,0, ,0,1,2,3,-33.33,0,0,0,0, ,2,0,2,100.00,0,0,0,0, 
11900,SRB,2,Lazovic Katarina ,OH,14,2,0,-2.25,16,14,9,32,55,9.09,2,6,7,15,-26.67,0,3,16,19,-15.79,5,0,21,26,19.23,24,2,34,64.71,0,0,5,5,0.00
11900,SRB,3,Caric Sara ,O,18,1,0,10.13,19,18,5,24,47,27.66,1,5,11,17,-23.53,0,1,14,15,-6.67,0,0,0,0, ,12,4,17,47.06,0,0,3,3,0.00
11900,SRB,6,Uzelac Aleksandra ,OH,1,0,0,-21.43,1,1,2,4,7,-14.29,0,2,1,3,-66.67,0,0,4,4,0.00,0,0,0,0, ,1,0,1,100.00,0,0,1,1,0.00
11900,SRB,7,Jaksic Ana ,S,1,2,1,6.90,4,1,0,2,3,33.33,2,1,4,7,14.29,1,1,17,19,0.00,0,0,0,0, ,8,3,12,41.67,23,3,104,130,15.38
11900,SRB,21,Kocic Jovana ,MB,5,4,1,3.70,10,5,0,6,11,45.45,4,8,12,24,-16.67,1,0,18,19,5.26,0,0,0,0, ,9,0,9,100.00,0,0,3,3,0.00
11900,SRB,22,Lozo Sara ,O,13,1,2,12.50,16,13,3,27,43,23.26,1,3,8,12,-16.67,2,1,14,17,5.88,8,4,24,36,11.11,16,1,18,83.33,0,0,7,7,0.00
11900,SRB,23,Djordjevic Mila ,S,0,1,0,-33.33,1,0,1,0,1,-100.00,1,1,0,2,0.00,0,0,0,0, ,0,0,0,0, ,2,2,4,0.00,2,0,19,21,9.52
11900,SRB,24,Medic Sofija ,MB,0,1,0,-16.67,1,0,0,0,0, ,1,2,1,4,-25.00,0,0,2,2,0.00,0,0,0,0, ,0,0,0, ,0,0,1,1,0.00
11900,SRB,25,Markovic Bozica ,MB,9,1,0,-2.27,10,9,1,3,13,61.54,1,9,13,23,-34.78,0,1,7,8,-12.50,0,0,0,0, ,2,1,4,25.00,0,0,1,1,0.00
11900,SRB,27,Bukilic Vanja ,O,0,0,0, ,0,0,0,0,0, ,0,0,0,0, ,0,0,0,0, ,0,0,0,0, ,0,0,0, ,0,0,0,0, 
11900,SRB,28,Delic Jelena ,MB,0,0,0, ,0,0,0,0,0, ,0,0,0,0, ,0,0,0,0, ,0,0,0,0, ,0,0,0, ,0,0,0,0, 
11900,SRB,32,Gocanin Bojana ,L,0,0,0, ,0,0,0,0,0, ,0,0,0,0, ,0,0,0,0, ,5,4,26,35,2.86,25,2,28,82.14,0,1,11,12,-8.33
11900,SRB,33,Cvetkovic Jovana ,OH,0,0,0, ,0,0,0,0,0, ,0,0,0,0, ,0,0,0,0, ,0,0,0,0, ,0,0,0, ,0,0,0,0, 
11900,SRB,34,Mirosavljevic Jovana ,OH,1,0,0,20.00,1,1,0,1,2,50.00,0,0,1,1,0.00,0,0,2,2,0.00,0,0,3,3,0.00,0,0,0, ,0,0,0,0, 
11901,ITA,2,Bosio Francesca ,S,0,0,1,4.55,1,0,0,1,1,0.00,0,0,4,4,0.00,1,0,16,17,5.88,0,0,0,0, ,6,2,8,50.00,12,0,82,94,12.77
11901,ITA,4,Bonifacio Sara ,MB,0,0,0, ,0,0,0,0,0, ,0,0,0,0, ,0,0,0,0, ,0,0,0,0, ,0,0,0, ,0,0,0,0, 
11901,ITA,12,Guerra Anastasia ,OH,0,0,0, ,0,0,0,0,0, ,0,0,0,0, ,0,0,0,0, ,0,0,0,0, ,0,0,0, ,0,0,0,0, 
11901,ITA,15,Nwakalor Sylvia Chinelo ,O,6,2,0,-23.53,8,6,7,6,19,-5.26,2,5,2,9,-33.33,0,4,2,6,-66.67,0,0,0,0, ,8,1,9,77.78,0,0,2,2,0.00
11901,ITA,19,Mingardi Camilla ,OH,9,0,0,17.86,9,9,1,10,20,40.00,0,2,2,4,-50.00,0,1,3,4,-25.00,0,0,0,0, ,5,3,10,20.00,0,0,0,0, 
11901,ITA,21,Lubian Marina ,MB,7,1,4,17.65,12,7,0,4,11,63.64,1,4,2,7,-42.86,4,2,10,16,12.50,0,0,0,0, ,2,0,2,100.00,0,0,2,2,0.00
11901,ITA,23,De Bortoli Chiara ,L,0,0,0, ,0,0,0,0,0, ,0,0,0,0, ,0,0,0,0, ,1,3,6,10,-20.00,13,3,18,55.56,0,0,6,6,0.00
11901,ITA,24,Mazzaro Alessia ,MB,2,1,0,6.67,3,2,0,3,5,40.00,1,2,0,3,-33.33,0,0,7,7,0.00,0,0,0,0, ,1,1,2,0.00,0,0,0,0, 
11901,ITA,26,Battistoni Ilaria ,S,0,0,0, ,0,0,0,0,0, ,0,0,0,0, ,0,0,0,0, ,0,0,0,0, ,0,0,0, ,0,0,6,6,0.00
11901,ITA,27,Furlan Eleonora ,MB,3,2,0,9.09,5,3,0,4,7,42.86,2,2,3,7,0.00,0,1,7,8,-12.50,0,0,0,0, ,0,0,1,0.00,0,0,0,0, 
11901,ITA,28,Melli Giulia ,OH,10,2,0,18.75,12,10,3,7,20,35.00,2,1,0,3,33.33,0,2,7,9,-22.22,8,2,38,48,12.50,3,1,5,40.00,0,0,3,3,0.00
11901,ITA,29,D'Odorico Sofia ,OH,10,0,1,1.92,11,10,4,19,33,18.18,0,3,3,6,-50.00,1,3,9,13,-15.38,6,2,10,18,22.22,4,1,6,50.00,0,0,1,1,0.00
11901,ITA,31,Fersino Eleonora ,L,0,0,0, ,0,0,0,0,0, ,0,0,0,0, ,0,0,0,0, ,1,0,1,2,50.00,4,1,5,60.00,0,0,0,0, 
11901,ITA,32,Omoruyi Oghosasere Loveth ,OH,0,0,0,-50.00,0,0,1,0,1,-100.00,0,0,0,0, ,0,0,1,1,0.00,0,0,5,5,0.00,0,2,2,-100.00,0,0,2,2,0.00
11901,USA,1,Hancock Micha ,S,0,0,0, ,0,0,0,0,0, ,0,0,0,0, ,0,0,0,0, ,0,0,0,0, ,0,0,0, ,0,0,0,0, 
11901,USA,2,Poulter Jordyn ,S,1,1,1,7.41,3,1,1,3,5,0.00,1,0,1,2,50.00,1,0,19,20,5.00,0,1,0,1,-100.00,6,1,7,71.43,16,0,95,111,14.41
11901,USA,4,Wong-Orantes Justine ,L,0,0,0, ,0,0,0,0,0, ,0,0,0,0, ,0,0,0,0, ,8,2,19,29,20.69,20,6,26,53.85,0,0,5,5,0.00
11901,USA,6,Dixon Tetori ,MB,0,0,0, ,0,0,0,0,0, ,0,0,0,0, ,0,0,0,0, ,0,0,0,0, ,0,0,0, ,0,0,0,0, 
11901,USA,8,Tapp Hannah ,MB,0,0,0, ,0,0,0,0,0, ,0,0,0,0, ,0,0,0,0, ,0,0,0,0, ,0,0,0, ,0,0,0,0, 
11901,USA,10,Larson Jordan ,OH,0,0,0, ,0,0,0,0,0, ,0,0,0,0, ,0,0,0,0, ,0,0,0,0, ,0,0,0, ,0,0,0,0, 
11901,USA,11,Drews Andrea ,O,18,0,2,25.00,20,18,3,9,30,50.00,0,3,1,4,-75.00,2,1,15,18,5.56,0,0,0,0, ,9,1,11,72.73,0,0,0,0, 
11901,USA,12,Thompson Jordan ,O,0,0,0, ,0,0,0,0,0, ,0,0,0,0, ,0,0,0,0, ,0,0,0,0, ,0,0,0, ,0,0,0,0, 
11901,USA,13,Wilhite Sarah ,OH,0,0,0, ,0,0,0,0,0, ,0,0,0,0, ,0,0,0,0, ,0,0,0,0, ,0,0,0, ,0,0,0,0, 
11901,USA,14,Bartsch-Hackley Michelle ,OH,16,2,1,30.61,19,16,2,15,33,42.42,2,0,2,4,50.00,1,2,9,12,-8.33,6,3,20,29,10.34,7,4,12,25.00,0,0,2,2,0.00
11901,USA,15,Hill Kimberly ,OH,0,0,0, ,0,0,0,0,0, ,0,0,0,0, ,0,0,0,0, ,0,0,0,0, ,0,0,0, ,0,0,0,0, 
11901,USA,16,Akinradewo Foluke ,MB,7,4,0,-3.85,11,7,2,4,13,38.46,4,8,10,22,-18.18,0,3,14,17,-17.65,0,0,0,0, ,5,2,7,42.86,0,0,1,1,0.00
11901,USA,22,Washington Haleigh ,MB,6,1,2,0.00,9,6,1,5,12,41.67,1,6,7,14,-35.71,2,2,10,14,0.00,0,0,0,0, ,2,0,3,66.67,0,0,0,0, 
11901,USA,23,Robinson Kelsey ,OH,9,1,1,-1.96,11,9,6,17,32,9.38,1,3,2,6,-33.33,1,3,9,13,-15.38,5,0,4,9,55.56,14,1,16,81.25,0,0,7,7,0.00
11748,SRB,2,Kovacevic Uros ,OH,9,1,1,6.67,11,9,1,11,21,38.10,1,5,0,6,-66.67,1,2,15,18,-5.56,3,1,11,15,13.33,6,2,9,44.44,0,0,5,5,0.00
11748,SRB,3,Kapur Milorad ,L,0,0,0, ,0,0,0,0,0, ,0,0,0,0, ,0,0,0,0, ,0,0,0,0, ,4,0,5,80.00,0,0,0,0, 
11748,SRB,6,Pekovic Nikola ,L,0,0,0, ,0,0,0,0,0, ,0,0,0,0, ,0,0,0,0, ,3,1,16,20,10.00,1,1,2,0.00,0,0,2,2,0.00
11748,SRB,7,Krsmanovic Petar ,MB,6,2,1,10.81,9,6,0,2,8,75.00,2,3,8,13,-7.69,1,2,13,16,-6.25,0,0,1,1,0.00,1,1,4,0.00,0,0,1,1,0.00
11748,SRB,8,Ivovic Marko ,OH,0,0,0,-40.00,0,0,1,3,4,-25.00,0,0,0,0, ,0,1,0,1,-100.00,2,2,4,8,0.00,4,0,4,100.00,0,0,1,1,0.00
11748,SRB,9,Jovovic Nikola ,S,0,0,0,0.00,0,0,0,1,1,0.00,0,0,0,0, ,0,0,1,1,0.00,0,0,0,0, ,2,0,3,66.67,5,1,3,9,44.44
11748,SRB,10,KujundÅ¾iÄ Miran ,OH,0,0,0, ,0,0,0,0,0, ,0,0,0,0, ,0,0,0,0, ,0,0,0,0, ,0,0,0, ,0,0,0,0, 
11748,SRB,12,Peric Pavle ,OH,12,1,2,10.53,15,12,3,4,19,47.37,1,2,3,6,-16.67,2,6,5,13,-30.77,3,2,7,12,8.33,7,3,12,33.33,0,0,2,2,0.00
11748,SRB,13,Simic Stevan ,MB,0,0,0, ,0,0,0,0,0, ,0,0,0,0, ,0,0,0,0, ,0,0,0,0, ,0,0,0, ,0,0,0,0, 
11748,SRB,14,Atanasijevic Aleksandar ,O,1,0,0,-16.67,1,1,0,1,2,50.00,0,1,2,3,-33.33,0,1,0,1,-100.00,0,0,0,0, ,0,0,0, ,0,0,0,0, 
11748,SRB,16,Luburic Drazen ,O,13,0,2,11.36,15,13,4,11,28,32.14,0,1,2,3,-33.33,2,5,6,13,-23.08,0,0,0,0, ,3,3,6,0.00,0,0,1,1,0.00
11748,SRB,18,Podrascanin Marko ,MB,3,4,1,6.45,8,3,0,3,6,50.00,4,3,4,11,9.09,1,3,10,14,-14.29,0,0,0,0, ,3,0,4,75.00,0,0,2,2,0.00
11748,SRB,21,Todorovic Vuk ,S,1,0,0,-10.00,1,1,0,0,1,100.00,0,1,3,4,-25.00,0,2,13,15,-13.33,0,0,0,0, ,4,1,5,60.00,25,0,39,64,39.06
11748,SRB,26,Kovac Davide ,OH,0,1,0,0.00,1,0,0,1,1,0.00,1,0,1,2,50.00,0,1,0,1,-100.00,1,0,3,4,25.00,1,0,1,100.00,0,0,1,1,0.00
11748,GER,1,Fromm Christian ,OH,8,0,0,3.33,8,8,3,9,20,25.00,0,2,2,4,-50.00,0,2,4,6,-33.33,2,1,2,5,20.00,4,2,7,28.57,0,0,1,1,0.00
11748,GER,3,Schott Ruben ,OH,9,0,4,12.50,13,9,5,7,21,19.05,0,0,2,2,0.00,4,3,10,17,5.88,10,3,23,36,19.44,8,3,14,35.71,0,1,7,8,-12.50
11748,GER,5,Reichert Moritz ,OH,4,0,0,0.00,4,4,1,5,10,30.00,0,1,0,1,-100.00,0,2,6,8,-25.00,0,1,2,3,-33.33,4,1,6,50.00,0,0,0,0, 
11748,GER,8,BÃ¶hme Marcus ,MB,0,0,0, ,0,0,0,0,0, ,0,0,0,0, ,0,0,0,0, ,0,0,0,0, ,0,0,0, ,0,0,0,0, 
11748,GER,10,Zenger Julian ,L,0,0,0, ,0,0,0,0,0, ,0,0,0,0, ,0,0,0,0, ,4,2,17,23,8.70,14,2,18,66.67,0,1,5,6,-16.67
11748,GER,13,Hirsch Simon ,O,0,0,0, ,0,0,0,0,0, ,0,0,0,0, ,0,0,0,0, ,0,0,0,0, ,0,0,0, ,0,0,0,0, 
11748,GER,15,BaxpÃ¶hler Noah ,MB,0,0,0,-50.00,0,0,0,0,0, ,0,3,0,3,-100.00,0,0,3,3,0.00,0,0,0,0, ,0,0,0, ,0,0,0,0, 
11748,GER,16,BurggrÃ¤f Eric ,S,0,0,0,0.00,0,0,0,0,0, ,0,0,0,0, ,0,0,1,1,0.00,0,0,0,0, ,0,0,0, ,0,0,0,0, 
11748,GER,17,Zimmermann Jan ,S,0,0,1,-20.00,1,0,1,1,2,-50.00,0,1,1,2,-50.00,1,2,8,11,-9.09,0,0,0,0, ,1,2,5,-20.00,33,0,49,82,40.24
11748,GER,18,Krage Florian ,MB,2,1,0,-12.50,3,2,2,1,5,0.00,1,2,3,6,-16.67,0,2,11,13,-15.38,0,0,0,0, ,0,0,0, ,0,0,0,0, 
11748,GER,19,RÃ¶hrs Erik ,OH,1,0,0,0.00,1,1,0,1,2,50.00,0,0,0,0, ,0,1,0,1,-100.00,0,0,1,1,0.00,0,0,0, ,0,0,0,0, 
11748,GER,20,Weber Linus ,O,13,1,1,11.90,15,13,4,8,25,36.00,1,2,4,7,-14.29,1,4,5,10,-30.00,1,0,0,1,100.00,1,0,2,50.00,0,0,1,1,0.00
11748,GER,21,Krick Tobias ,MB,4,3,0,-11.76,7,4,3,1,8,12.50,3,3,9,15,0.00,0,5,6,11,-45.45,0,0,1,1,0.00,3,0,3,100.00,0,0,0,0, 
11748,GER,25,Maase Lukas ,O,0,0,0,-100.00,0,0,0,0,0, ,0,2,0,2,-100.00,0,0,0,0, ,0,0,0,0, ,0,1,1,-100.00,0,0,0,0, 
11749,JPN,1,Shimizu Kunihiro ,O,15,1,1,18.18,17,15,4,12,31,35.48,1,2,3,6,-16.67,1,1,16,18,0.00,0,0,0,0, ,4,2,6,33.33,0,0,1,1,0.00
11749,JPN,2,Onodera Taishi ,MB,7,2,0,0.00,9,7,3,6,16,25.00,2,4,4,10,-20.00,0,2,8,10,-20.00,0,0,2,2,0.00,1,2,3,-33.33,0,0,0,0, 
11749,JPN,3,Fujii Naonobu ,S,0,1,0,-20.00,1,0,0,0,0, ,1,4,0,5,-60.00,0,2,18,20,-10.00,0,0,0,0, ,7,1,9,66.67,36,0,58,94,38.30
11749,JPN,4,Otake Issei ,O,2,0,0,-6.25,2,2,2,5,9,0.00,0,1,4,5,-20.00,0,0,2,2,0.00,0,0,0,0, ,2,0,3,66.67,0,0,1,1,0.00
11749,JPN,5,Fukuzawa Tatsuya ,OH,0,0,0, ,0,0,0,0,0, ,0,0,0,0, ,0,0,0,0, ,0,0,0,0, ,0,0,0, ,0,0,0,0, 
11749,JPN,6,Yamauchi Akihiro ,MB,0,0,0, ,0,0,0,0,0, ,0,0,0,0, ,0,0,0,0, ,0,0,0,0, ,0,0,0, ,0,0,0,0, 
11749,JPN,12,Sekita Masahiro ,S,0,0,0,0.00,0,0,0,0,0, ,0,0,0,0, ,0,0,1,1,0.00,0,0,0,0, ,2,2,4,0.00,5,0,8,13,38.46
11749,JPN,14,Ishikawa Yuki ,OH,20,0,2,21.31,22,20,2,9,31,58.06,0,4,6,10,-40.00,2,3,15,20,-5.00,11,0,17,28,39.29,12,1,14,78.57,1,0,6,7,14.29
11749,JPN,15,Ri Haku ,MB,7,3,1,14.71,11,7,1,2,10,60.00,3,3,3,9,0.00,1,2,12,15,-6.67,2,0,0,2,100.00,3,0,3,100.00,0,0,0,0, 
11749,JPN,17,Takanashi Kenta ,OH,2,0,0,-8.33,2,2,1,3,6,16.67,0,1,1,2,-50.00,0,1,3,4,-25.00,3,0,2,5,60.00,3,2,5,20.00,0,0,1,1,0.00
11749,JPN,19,Otsuka Tatsunori ,OH,0,0,0,0.00,0,0,0,0,0, ,0,0,1,1,0.00,0,0,0,0, ,0,0,0,0, ,0,0,0, ,0,0,0,0, 
11749,JPN,20,Yamamoto Tomohiro ,L,0,0,0, ,0,0,0,0,0, ,0,0,0,0, ,0,0,0,0, ,16,0,12,28,57.14,15,5,23,43.48,0,0,2,2,0.00
11749,JPN,21,Takahashi Ran ,OH,11,1,1,5.56,13,11,6,6,23,21.74,1,3,0,4,-50.00,1,2,6,9,-11.11,6,1,7,14,35.71,4,0,5,80.00,1,0,5,6,16.67
11749,JPN,24,Ogawa Tomohiro ,L,0,0,0, ,0,0,0,0,0, ,0,0,0,0, ,0,0,0,0, ,0,0,0,0, ,0,0,0, ,0,0,0,0, 
11749,AUS,1,Graham Beau ,MB,5,0,0,4.17,5,5,2,3,10,30.00,0,2,3,5,-40.00,0,0,9,9,0.00,0,0,0,0, ,1,5,6,-66.67,0,0,2,2,0.00
11749,AUS,2,Dosanjh Arshdeep ,S,2,2,0,-10.71,4,2,1,4,7,14.29,2,4,2,8,-25.00,0,2,11,13,-15.38,0,0,1,1,0.00,9,5,15,26.67,26,1,75,102,24.51
11749,AUS,7,Weir James ,MB,0,0,0,0.00,0,0,0,0,0, ,0,0,0,0, ,0,0,1,1,0.00,0,0,0,0, ,0,0,0, ,0,0,0,0, 
11749,AUS,8,O'Dea Trent ,MB,8,0,0,-2.63,8,8,1,5,14,50.00,0,5,6,11,-45.45,0,3,10,13,-23.08,1,0,0,1,100.00,1,1,2,0.00,0,0,0,0, 
11749,AUS,11,Perry Luke ,L,0,0,0, ,0,0,0,0,0, ,0,0,0,0, ,0,0,0,0, ,7,1,11,19,31.58,14,5,19,47.37,0,0,15,15,0.00
11749,AUS,12,Mote Nehemiah ,MB,11,3,0,16.28,14,11,2,2,15,60.00,3,2,6,11,9.09,0,3,14,17,-17.65,2,0,1,3,66.67,6,4,12,16.67,0,0,1,1,0.00
11749,AUS,15,Smith Luke ,OH,18,0,1,20.34,19,18,3,16,37,40.54,0,2,3,5,-40.00,1,2,14,17,-5.88,6,3,28,37,8.11,8,2,10,60.00,0,0,3,3,0.00
11749,AUS,21,Butler Nicholas ,S,0,0,0, ,0,0,0,0,0, ,0,0,0,0, ,0,0,0,0, ,0,0,0,0, ,0,0,0, ,0,0,0,0, 
11749,AUS,27,Senica Max ,OH,7,3,0,12.82,10,7,3,9,19,21.05,3,1,3,7,28.57,0,1,12,13,-7.69,2,0,15,17,11.76,4,0,5,80.00,0,0,1,1,0.00
11749,AUS,28,Taylor Tim ,OH,2,0,0,-18.18,2,2,2,2,6,0.00,0,0,1,1,0.00,0,2,2,4,-50.00,4,1,3,8,37.50,1,2,4,-25.00,0,0,0,0, 
11749,AUS,29,Garrett Ethan ,OH,0,0,0, ,0,0,0,0,0, ,0,0,0,0, ,0,0,0,0, ,0,0,0,0, ,0,0,0, ,0,0,0,0, 
11749,AUS,31,Aubrey Matthew ,O,0,0,0, ,0,0,0,0,0, ,0,0,0,0, ,0,0,0,0, ,0,0,0,0, ,0,0,0, ,0,0,0,0, 
11749,AUS,32,Azeez Oluwatobi Elliot ,OH,6,0,0,3.70,6,6,1,11,18,27.78,0,2,0,2,-100.00,0,2,5,7,-28.57,0,0,0,0, ,1,0,2,50.00,0,0,0,0, 
11749,AUS,34,Greber Billy ,L,0,0,0, ,0,0,0,0,0, ,0,0,0,0, ,0,0,0,0, ,0,0,0,0, ,0,0,0, ,0,0,0,0, 
11750,FRA,1,Chinenyeze BarthÃ©lÃ©my ,MB,2,3,0,-3.03,5,2,0,6,8,25.00,3,5,8,16,-12.50,0,1,8,9,-11.11,0,0,0,0, ,4,1,6,50.00,0,0,3,3,0.00
11750,FRA,2,Grebennikov Jenia ,L,0,0,0, ,0,0,0,0,0, ,0,0,0,0, ,0,0,0,0, ,6,0,10,16,37.50,15,2,18,72.22,0,0,4,4,0.00
11750,FRA,4,Patry Jean ,O,14,0,4,11.48,18,14,5,13,32,28.12,0,3,4,7,-42.86,4,3,15,22,4.55,0,0,0,0, ,5,5,10,0.00,0,0,2,2,0.00
11750,FRA,6,Toniutti Benjamin ,S,0,0,0, ,0,0,0,0,0, ,0,0,0,0, ,0,0,0,0, ,0,0,0,0, ,0,0,0, ,0,0,0,0, 
11750,FRA,7,Tillie Kevin ,OH,0,0,0,-20.00,0,0,0,0,0, ,0,0,0,0, ,0,1,4,5,-20.00,0,0,0,0, ,2,0,2,100.00,0,0,0,0, 
11750,FRA,9,Ngapeth Earvin ,OH,18,0,3,18.52,21,18,6,7,31,38.71,0,1,2,3,-33.33,3,4,13,20,-5.00,8,1,20,29,24.14,8,1,11,63.64,0,0,7,7,0.00
11750,FRA,11,Brizard Antoine ,S,2,0,0,-22.22,2,2,0,0,2,100.00,0,5,4,9,-55.56,0,3,13,16,-18.75,0,0,2,2,0.00,4,0,5,80.00,33,0,53,86,38.37
11750,FRA,12,Boyer Stephen ,O,0,0,0, ,0,0,0,0,0, ,0,0,0,0, ,0,0,0,0, ,0,0,0,0, ,0,0,0, ,0,0,0,0, 
11750,FRA,14,Le Goff Nicolas ,MB,7,5,0,20.59,12,7,1,2,10,60.00,5,3,6,14,14.29,0,1,9,10,-10.00,0,0,0,0, ,1,0,1,100.00,0,0,0,0, 
11750,FRA,16,Bultor Daryl ,MB,0,0,0, ,0,0,0,0,0, ,0,0,0,0, ,0,0,0,0, ,0,0,0,0, ,0,0,0, ,0,0,0,0, 
11750,FRA,17,Clevenot Trevor ,OH,13,1,0,15.56,14,13,2,9,24,45.83,1,2,2,5,-20.00,0,3,13,16,-18.75,5,2,14,21,14.29,5,3,10,20.00,0,0,2,2,0.00
11750,FRA,18,Rossard Thibault ,OH,0,0,0,-66.67,0,0,0,0,0, ,0,0,0,0, ,0,2,1,3,-66.67,0,0,0,0, ,0,0,0, ,0,0,0,0, 
11750,FRA,20,Diez Benjamin ,L,0,0,0, ,0,0,0,0,0, ,0,0,0,0, ,0,0,0,0, ,0,0,0,0, ,0,0,0, ,0,0,0,0, 
11750,FRA,24,Gueye Mousse ,MB,0,0,0, ,0,0,0,0,0, ,0,0,0,0, ,0,0,0,0, ,0,0,0,0, ,0,0,0, ,0,0,0,0, 
11750,RUS,1,Podlesnykh Yaroslav ,OH,0,0,1,33.33,1,0,0,0,0, ,0,0,0,0, ,1,0,2,3,33.33,0,0,0,0, ,0,0,0, ,0,0,0,0, 
11750,RUS,2,Vlasov Ilia ,MB,6,2,0,-18.42,8,6,2,3,11,36.36,2,9,8,19,-36.84,0,4,4,8,-50.00,0,0,2,2,0.00,2,0,3,66.67,0,0,0,0, 
11750,RUS,4,Volvich Artem ,MB,0,0,0, ,0,0,0,0,0, ,0,0,0,0, ,0,0,0,0, ,0,0,0,0, ,0,0,0, ,0,0,0,0, 
11750,RUS,6,Baranov Evgeny ,L,0,0,0, ,0,0,0,0,0, ,0,0,0,0, ,0,0,0,0, ,3,2,18,23,4.35,8,1,11,63.64,0,0,2,2,0.00
11750,RUS,7,Volkov Dmitry ,OH,6,0,0,4.17,6,6,3,6,15,20.00,0,1,1,2,-50.00,0,1,6,7,-14.29,3,1,6,10,20.00,3,2,5,20.00,0,0,2,2,0.00
11750,RUS,10,Bogdan Denis ,OH,6,2,0,3.70,8,6,1,5,12,41.67,2,3,2,7,-14.29,0,3,5,8,-37.50,6,1,11,18,27.78,1,1,2,0.00,0,0,3,3,0.00
11750,RUS,11,Pankov Pavel ,S,2,0,0,-28.57,2,2,0,0,2,100.00,0,3,1,4,-75.00,0,3,5,8,-37.50,0,0,1,1,0.00,3,0,3,100.00,19,0,32,51,37.25
11750,RUS,13,Muserskiy Dmitriy ,MB,5,0,1,3.70,6,5,2,8,15,20.00,0,2,4,6,-33.33,1,1,4,6,0.00,0,0,0,0, ,1,0,2,50.00,0,0,2,2,0.00
11750,RUS,15,Poletaev Victor ,O,5,0,0,0.00,5,5,1,3,9,44.44,0,1,3,4,-25.00,0,3,7,10,-30.00,0,0,0,0, ,1,0,1,100.00,0,0,0,0, 
11750,RUS,17,Mikhaylov Maxim ,O,2,0,0,-21.43,2,2,3,2,7,-14.29,0,0,0,0, ,0,2,5,7,-28.57,0,0,1,1,0.00,0,0,0, ,0,0,0,0, 
11750,RUS,18,Kliuka Egor ,OH,14,0,1,10.00,15,14,3,10,27,40.74,0,5,0,5,-100.00,1,2,15,18,-5.56,8,3,16,27,18.52,9,2,11,63.64,0,0,4,4,0.00
11750,RUS,20,Kurkaev Ilyas ,MB,8,1,0,3.03,9,8,0,4,12,66.67,1,5,2,8,-50.00,0,3,10,13,-23.08,0,0,1,1,0.00,3,0,3,100.00,0,0,0,0, 
11750,RUS,24,Kobzar Igor ,S,0,0,0,-57.14,0,0,0,0,0, ,0,3,1,4,-75.00,0,1,2,3,-33.33,0,0,0,0, ,1,1,2,0.00,14,0,26,40,35.00
11750,RUS,27,Golubev Valentin ,L,0,0,0, ,0,0,0,0,0, ,0,0,0,0, ,0,0,0,0, ,0,0,0,0, ,0,0,0, ,0,0,0,0, 
11751,SLO,1,Å tern TonÄek ,O,14,1,2,21.43,17,14,4,5,23,43.48,1,1,0,2,0.00,2,3,12,17,-5.88,0,0,0,0, ,6,1,8,62.50,0,0,3,3,0.00
11751,SLO,2,Pajenk Alen ,MB,4,0,1,-3.70,5,4,0,1,5,80.00,0,3,5,8,-37.50,1,3,10,14,-14.29,1,0,0,1,100.00,0,0,0, ,0,0,0,0, 
11751,SLO,4,Kozamernik Jan ,MB,3,1,0,0.00,4,3,0,2,5,60.00,1,2,2,5,-20.00,0,2,9,11,-18.18,0,0,1,1,0.00,0,0,0, ,0,0,1,1,0.00
11751,SLO,5,Å ket Alen ,O,0,0,0, ,0,0,0,0,0, ,0,0,0,0, ,0,0,0,0, ,0,0,0,0, ,0,0,0, ,0,0,0,0, 
11751,SLO,6,Gasparini Mitja ,O,0,0,0, ,0,0,0,0,0, ,0,0,0,0, ,0,0,0,0, ,0,0,0,0, ,0,0,0, ,0,0,0,0, 
11751,SLO,9,Vincic Dejan ,S,0,0,0, ,0,0,0,0,0, ,0,0,0,0, ,0,0,0,0, ,0,0,0,0, ,0,0,0, ,0,0,0,0, 
11751,SLO,10,Å talekar SaÅ¡o ,MB,0,0,0, ,0,0,0,0,0, ,0,0,0,0, ,0,0,0,0, ,0,0,0,0, ,0,0,0, ,0,0,0,0, 
11751,SLO,11,Å tern Å½iga ,OH,0,0,0, ,0,0,0,0,0, ,0,0,0,0, ,0,0,0,0, ,0,0,0,0, ,0,0,0, ,0,0,0,0, 
11751,SLO,13,KovaÄiÄ Jani ,L,0,0,0, ,0,0,0,0,0, ,0,0,0,0, ,0,0,0,0, ,6,0,9,15,40.00,6,2,8,50.00,0,0,7,7,0.00
11751,SLO,15,VideÄnik Matic ,MB,0,0,0, ,0,0,0,0,0, ,0,0,0,0, ,0,0,0,0, ,0,0,0,0, ,0,0,0, ,0,0,1,1,0.00
11751,SLO,16,Ropret Gregor ,S,1,0,0,-25.00,1,1,0,0,1,100.00,0,1,2,3,-33.33,0,3,5,8,-37.50,0,0,0,0, ,7,2,10,50.00,14,0,44,58,24.14
11751,SLO,17,Urnaut Tine ,OH,9,1,0,20.69,10,9,2,6,17,41.18,1,1,0,2,0.00,0,1,9,10,-10.00,7,2,11,20,25.00,5,4,9,11.11,0,0,1,1,0.00
11751,SLO,18,Äebulj Klemen ,OH,10,0,2,20.69,12,10,4,4,18,33.33,0,1,1,2,-50.00,2,1,6,9,11.11,5,0,6,11,45.45,1,1,2,0.00,0,0,1,1,0.00
11751,SLO,19,MoÅ¾iÄ Rok ,OH,3,0,0,12.50,3,3,0,0,3,100.00,0,0,0,0, ,0,2,3,5,-40.00,0,0,2,2,0.00,1,1,2,0.00,0,0,1,1,0.00
11751,CAN,1,Sanders Tyler ,S,0,0,1,-16.67,1,0,0,0,0, ,0,1,0,1,-100.00,1,2,8,11,-9.09,0,0,0,0, ,2,3,5,-20.00,9,1,49,59,13.56
11751,CAN,2,Perrin John Gordon ,OH,10,0,0,14.63,10,10,1,12,23,39.13,0,1,1,2,-50.00,0,2,14,16,-12.50,4,1,7,12,25.00,3,5,9,-22.22,0,0,1,1,0.00
11751,CAN,3,Marshall Steven ,OH,0,0,0, ,0,0,0,0,0, ,0,0,0,0, ,0,0,0,0, ,5,2,8,15,20.00,2,4,7,-28.57,0,0,2,2,0.00
11751,CAN,4,Hoag Nicholas ,OH,14,1,1,20.00,16,14,3,6,23,47.83,1,3,0,4,-50.00,1,3,4,8,-25.00,4,2,22,28,7.14,2,0,3,66.67,0,0,1,1,0.00
11751,CAN,6,Pereira Jordan ,OH,0,0,0, ,0,0,0,0,0, ,0,0,0,0, ,0,0,0,0, ,0,0,0,0, ,0,0,0, ,0,0,0,0, 
11751,CAN,7,Maar Stephen Timothy ,OH,0,0,0, ,0,0,0,0,0, ,0,0,0,0, ,0,0,0,0, ,0,0,0,0, ,0,0,0, ,0,0,0,0, 
11751,CAN,8,Blankenau Jay ,S,0,0,0,0.00,0,0,0,0,0, ,0,0,0,0, ,0,0,1,1,0.00,0,0,0,0, ,0,0,0, ,0,0,3,3,0.00
11751,CAN,10,Sclater Ryan Joseph ,O,1,0,0,-10.00,1,1,0,3,4,25.00,0,1,1,2,-50.00,0,1,3,4,-25.00,0,0,0,0, ,2,0,2,100.00,0,0,0,0, 
11751,CAN,11,Jansen Vandoorn Daniel ,MB,2,1,0,20.00,3,2,0,0,2,100.00,1,1,1,3,0.00,0,0,5,5,0.00,0,0,0,0, ,0,0,0, ,0,0,0,0, 
11751,CAN,12,Van Berkel Lucas ,MB,3,2,0,12.50,5,3,0,1,4,75.00,2,3,3,8,-12.50,0,0,4,4,0.00,0,0,2,2,0.00,0,0,0, ,0,0,0,0, 
11751,CAN,13,Vernon-Evans Sharone ,O,4,0,0,-25.00,4,4,3,1,8,12.50,0,1,0,1,-100.00,0,4,3,7,-57.14,0,0,0,0, ,4,1,6,50.00,0,0,1,1,0.00
11751,CAN,14,Loeppky Eric ,OH,0,0,0,-100.00,0,0,0,0,0, ,0,1,0,1,-100.00,0,0,0,0, ,0,0,0,0, ,0,0,0, ,0,0,0,0, 
11751,CAN,20,Szwarc Arthur ,O,0,1,0,-17.65,1,0,0,3,3,0.00,1,2,3,6,-16.67,0,2,6,8,-25.00,1,0,1,2,50.00,0,1,1,-100.00,0,2,4,6,-33.33
11751,CAN,23,Demyanenko Danny ,MB,0,0,0, ,0,0,0,0,0, ,0,0,0,0, ,0,0,0,0, ,0,0,0,0, ,0,0,0, ,0,0,0,0, 
11752,ARG,2,Pereyra Federico ,O,1,0,0,0.00,1,1,0,2,3,33.33,0,1,0,1,-100.00,0,0,0,0, ,0,0,0,0, ,0,0,0, ,0,0,0,0, 
11752,ARG,3,Martinez Franchi Jan ,OH,5,0,0,9.52,5,5,3,8,16,12.50,0,0,0,0, ,0,0,5,5,0.00,5,2,6,13,23.08,2,0,2,100.00,0,0,0,0, 
11752,ARG,5,Uriarte Nicolas ,S,0,0,0,-22.22,0,0,0,3,3,0.00,0,0,1,1,0.00,0,2,3,5,-40.00,0,0,1,1,0.00,0,1,1,-100.00,16,0,38,54,29.63
11752,ARG,7,Conte Facundo ,OH,0,1,0,-20.00,1,0,4,6,10,-40.00,1,0,0,1,100.00,0,0,4,4,0.00,3,2,7,12,8.33,2,1,3,33.33,0,0,1,1,0.00
11752,ARG,8,Loser Agustin ,MB,3,4,1,26.32,8,3,0,1,4,75.00,4,0,2,6,66.67,1,3,5,9,-22.22,0,1,2,3,-33.33,0,1,1,-100.00,0,0,0,0, 
11752,ARG,9,Danani Santiago ,L,0,0,0, ,0,0,0,0,0, ,0,0,0,0, ,0,0,0,0, ,4,0,7,11,36.36,7,6,14,7.14,0,0,4,4,0.00
11752,ARG,10,Lazo NicolÃ¡s ,OH,4,2,0,8.00,6,4,4,9,17,0.00,2,0,0,2,100.00,0,0,6,6,0.00,2,0,5,7,28.57,1,1,2,0.00,0,0,0,0, 
11752,ARG,11,SolÃ© Sebastian ,MB,6,2,0,5.13,8,6,1,7,14,35.71,2,3,3,8,-12.50,0,2,15,17,-11.76,0,0,1,1,0.00,2,0,2,100.00,0,0,1,1,0.00
11752,ARG,12,Lima Bruno ,O,10,0,0,-8.33,10,10,8,4,22,9.09,0,0,3,3,0.00,0,5,6,11,-45.45,1,0,0,1,100.00,4,2,6,33.33,0,0,0,0, 
11752,ARG,15,De Cecco Luciano ,S,0,0,0,-16.67,0,0,0,0,0, ,0,1,0,1,-100.00,0,0,5,5,0.00,0,0,0,0, ,1,0,1,100.00,7,0,32,39,17.95
11752,ARG,16,Palonsky Luciano ,OH,0,0,0, ,0,0,0,0,0, ,0,0,0,0, ,0,0,0,0, ,0,0,0,0, ,0,0,0, ,0,0,0,0, 
11752,ARG,17,Mendez Nicolas ,OH,8,0,0,18.18,8,8,1,4,13,53.85,0,1,1,2,-50.00,0,2,5,7,-28.57,3,1,10,14,14.29,1,3,4,-50.00,0,0,2,2,0.00
11752,ARG,18,Ramos Martin ,MB,1,0,0,-33.33,1,1,1,1,3,0.00,0,2,0,2,-100.00,0,0,1,1,0.00,0,0,1,1,0.00,1,0,1,100.00,0,0,0,0, 
11752,ARG,19,Massimino Franco ,L,0,0,0, ,0,0,0,0,0, ,0,0,0,0, ,0,0,0,0, ,0,0,0,0, ,0,0,0, ,0,0,0,0, 
11752,ITA,1,Gardini Davide ,OH,0,0,0, ,0,0,0,0,0, ,0,0,0,0, ,0,0,0,0, ,0,0,0,0, ,0,0,0, ,0,0,0,0, 
11752,ITA,7,Balaso Fabio ,L,0,0,0, ,0,0,0,0,0, ,0,0,0,0, ,0,0,0,0, ,10,1,9,20,45.00,8,5,14,21.43,0,0,9,9,0.00
11752,ITA,15,Sbertoli Riccardo ,S,2,1,0,-12.50,3,2,0,0,2,100.00,1,5,2,8,-50.00,0,1,13,14,-7.14,0,0,0,0, ,2,2,6,0.00,14,0,64,78,17.95
11752,ITA,18,Michieletto Alessandro ,OH,14,4,0,35.90,18,14,0,11,25,56.00,4,1,1,6,50.00,0,3,5,8,-37.50,8,0,17,25,32.00,2,1,3,33.33,0,0,2,2,0.00
11752,ITA,20,Nelli Gabriele ,O,6,0,2,-11.76,8,6,5,8,19,5.26,0,4,1,5,-80.00,2,3,5,10,-10.00,0,0,0,0, ,5,2,7,42.86,0,0,0,0, 
11752,ITA,21,Spirito Luca ,S,0,0,0,-100.00,0,0,1,0,1,-100.00,0,0,0,0, ,0,0,0,0, ,0,0,0,0, ,0,0,0, ,0,0,0,0, 
11752,ITA,23,Pinali Giulio ,O,2,0,0,14.29,2,2,0,2,4,50.00,0,0,0,0, ,0,1,2,3,-33.33,0,0,0,0, ,0,0,0, ,0,0,0,0, 
11752,ITA,24,Cavuto Oreste ,OH,0,0,0, ,0,0,0,0,0, ,0,0,0,0, ,0,0,0,0, ,0,0,0,0, ,0,0,0, ,0,0,0,0, 
11752,ITA,25,Vitelli Marco ,MB,1,4,2,8.33,7,1,1,4,6,0.00,4,0,1,5,80.00,2,4,7,13,-15.38,0,0,0,0, ,1,2,3,-33.33,0,0,0,0, 
11752,ITA,26,Cortesia Lorenzo ,MB,2,4,1,18.52,7,2,0,4,6,33.33,4,1,3,8,37.50,1,1,11,13,0.00,0,0,0,0, ,1,0,1,100.00,0,0,0,0, 
11752,ITA,28,Recine Francesco ,OH,11,2,1,15.22,14,11,4,13,28,25.00,2,1,0,3,33.33,1,2,12,15,-6.67,4,0,6,10,40.00,5,4,11,9.09,0,0,0,0, 
11752,ITA,29,Bottolo Mattia ,OH,0,0,0, ,0,0,0,0,0, ,0,0,0,0, ,0,0,0,0, ,0,0,0,0, ,0,0,0, ,0,0,0,0, 
11752,ITA,30,Mosca Leandro Ausibio ,MB,0,1,0,0.00,1,0,0,0,0, ,1,1,0,2,0.00,0,0,3,3,0.00,1,0,0,1,100.00,0,0,0, ,0,0,0,0, 
11752,ITA,31,Federici Filippo ,L,0,0,0, ,0,0,0,0,0, ,0,0,0,0, ,0,0,0,0, ,0,0,0,0, ,0,0,0, ,0,0,0,0, 
11753,IRI,2,Ebadipour Ghara H. Milad ,OH,6,0,0,0.00,6,6,3,12,21,14.29,0,2,1,3,-66.67,0,1,11,12,-8.33,7,1,15,23,26.09,5,1,7,57.14,0,0,5,5,0.00
11753,IRI,3,Abedini Reza ,MB,0,0,0, ,0,0,0,0,0, ,0,0,0,0, ,0,0,0,0, ,0,0,0,0, ,0,0,0, ,0,0,0,0, 
11753,IRI,4,Marouflakrani Mir Saeid ,S,2,0,0,0.00,2,2,0,3,5,40.00,0,1,5,6,-16.67,0,1,10,11,-9.09,0,0,1,1,0.00,2,2,4,0.00,12,3,61,76,11.84
11753,IRI,6,Mousavi Eraghi Seyed Mohammad ,MB,5,2,0,17.86,7,5,0,5,10,50.00,2,2,3,7,0.00,0,0,11,11,0.00,0,0,1,1,0.00,2,1,7,14.29,0,0,2,2,0.00
11753,IRI,7,Fayazi D. Purya ,OH,0,0,0, ,0,0,0,0,0, ,0,0,0,0, ,0,0,0,0, ,0,0,0,0, ,0,1,1,-100.00,0,0,0,0, 
11753,IRI,9,Gholami Masoud ,MB,6,2,0,11.54,8,6,1,1,8,62.50,2,2,2,6,0.00,0,2,10,12,-16.67,0,0,0,0, ,4,0,4,100.00,0,0,0,0, 
11753,IRI,11,Kazemi Saber ,O,12,2,5,18.87,19,12,4,11,27,29.63,2,2,4,8,0.00,5,3,10,18,11.11,0,0,1,1,0.00,7,1,10,60.00,0,0,1,1,0.00
11753,IRI,12,Sharifi Morteza ,OH,0,0,0, ,0,0,0,0,0, ,0,0,0,0, ,0,0,0,0, ,0,0,0,0, ,0,0,0, ,0,0,0,0, 
11753,IRI,16,Shafiei Ali ,MB,0,0,0, ,0,0,0,0,0, ,0,0,0,0, ,0,0,0,0, ,0,0,0,0, ,0,0,0, ,0,0,0,0, 
11753,IRI,17,Salehi Meisam ,OH,13,1,0,16.13,14,13,5,1,19,42.11,1,1,1,3,0.00,0,3,6,9,-33.33,5,0,12,17,29.41,3,0,4,75.00,0,0,3,3,0.00
11753,IRI,18,Vadi Mohammad Taher ,S,0,0,0, ,0,0,0,0,0, ,0,0,0,0, ,0,0,0,0, ,0,0,0,0, ,0,0,0, ,0,0,0,0, 
11753,IRI,21,Salehi Arman ,L,0,0,0, ,0,0,0,0,0, ,0,0,0,0, ,0,0,0,0, ,8,0,6,14,57.14,13,2,16,68.75,0,0,5,5,0.00
11753,IRI,22,Esfandiar Amirhossein ,OH,0,0,0, ,0,0,0,0,0, ,0,0,0,0, ,0,0,0,0, ,0,0,0,0, ,0,0,0, ,0,0,0,0, 
11753,IRI,23,Saadat Bardia ,O,0,0,0,0.00,0,0,0,1,1,0.00,0,0,0,0, ,0,0,0,0, ,0,0,0,0, ,0,0,0, ,0,0,0,0, 
11753,USA,3,Sander Taylor ,OH,0,0,0, ,0,0,0,0,0, ,0,0,0,0, ,0,0,0,0, ,0,0,0,0, ,0,0,0, ,0,0,0,0, 
11753,USA,4,Jendryk II Jeffrey ,MB,2,3,0,0.00,5,2,0,6,8,25.00,3,5,3,11,-18.18,0,0,10,10,0.00,1,0,0,1,100.00,3,0,3,100.00,0,0,0,0, 
11753,USA,5,Ensing Kyle ,O,2,1,0,12.50,3,2,1,1,4,25.00,1,1,1,3,0.00,0,0,1,1,0.00,0,0,0,0, ,1,0,1,100.00,0,0,0,0, 
11753,USA,6,Stahl Mitchell ,MB,0,0,0, ,0,0,0,0,0, ,0,0,0,0, ,0,0,0,0, ,0,0,0,0, ,0,0,0, ,0,0,0,0, 
11753,USA,7,Shoji Kawika ,S,1,0,0,0.00,1,1,0,0,1,100.00,0,1,3,4,-25.00,0,0,7,7,0.00,0,0,0,0, ,4,1,7,42.86,20,1,59,80,23.75
11753,USA,8,Defalco Torey ,OH,5,0,0,-2.94,5,5,5,12,22,0.00,0,0,3,3,0.00,0,1,8,9,-11.11,6,1,6,13,38.46,2,1,3,33.33,0,0,1,1,0.00
11753,USA,9,Hanes Jake ,O,0,0,0, ,0,0,0,0,0, ,0,0,0,0, ,0,0,0,0, ,0,0,0,0, ,0,0,0, ,0,0,0,0, 
11753,USA,13,Patch Benjamin ,O,14,0,0,10.26,14,14,3,9,26,42.31,0,2,1,3,-66.67,0,5,5,10,-50.00,0,0,0,0, ,4,2,8,25.00,0,0,1,1,0.00
11753,USA,15,Sander Brenden ,OH,0,0,1,-27.27,1,0,2,1,3,-66.67,0,1,0,1,-100.00,1,1,5,7,0.00,3,0,3,6,50.00,0,0,0, ,0,0,1,1,0.00
11753,USA,16,Tuaniga Joshua ,S,0,0,0, ,0,0,0,0,0, ,0,0,0,0, ,0,0,0,0, ,0,0,1,1,0.00,0,0,0, ,0,0,1,1,0.00
11753,USA,18,Muagututia Garrett ,OH,11,1,0,16.22,12,11,2,6,19,47.37,1,4,1,6,-50.00,0,0,12,12,0.00,8,4,14,26,15.38,9,1,11,72.73,0,0,1,1,0.00
11753,USA,19,Averill Taylor ,MB,2,1,0,-22.73,3,2,2,1,5,0.00,1,3,2,6,-33.33,0,3,8,11,-27.27,0,0,1,1,0.00,2,0,3,66.67,0,0,0,0, 
11753,USA,20,Smith David ,MB,0,0,0, ,0,0,0,0,0, ,0,0,0,0, ,0,0,0,0, ,0,0,0,0, ,0,0,0, ,0,0,0,0, 
11753,USA,22,Shoji Erik ,L,0,0,0, ,0,0,0,0,0, ,0,0,0,0, ,0,0,0,0, ,4,0,11,15,26.67,9,3,12,50.00,0,0,8,8,0.00
11754,POL,1,Nowakowski Piotr ,MB,0,0,0, ,0,0,0,0,0, ,0,0,0,0, ,0,0,0,0, ,0,0,0,0, ,0,0,0, ,0,0,0,0, 
11754,POL,2,Muzaj Maciej ,O,0,0,0, ,0,0,0,0,0, ,0,0,0,0, ,0,0,0,0, ,0,0,0,0, ,0,0,0, ,0,0,0,0, 
11754,POL,5,Kaczmarek Lukasz ,O,10,1,1,15.38,12,10,2,11,23,34.78,1,3,0,4,-50.00,1,1,10,12,0.00,0,0,0,0, ,1,1,2,0.00,0,0,0,0, 
11754,POL,9,Leon Venero Wilfredo ,OH,7,0,2,10.71,9,7,0,6,13,53.85,0,0,1,1,0.00,2,6,6,14,-28.57,3,0,8,11,27.27,4,2,6,33.33,0,0,3,3,0.00
11754,POL,10,Wojtaszek Damian ,L,0,0,0, ,0,0,0,0,0, ,0,0,0,0, ,0,0,0,0, ,2,1,9,12,8.33,6,1,7,71.43,0,0,3,3,0.00
11754,POL,11,Drzyzga Fabian ,S,0,0,1,-33.33,1,0,0,0,0, ,0,2,1,3,-66.67,1,5,9,15,-26.67,0,0,1,1,0.00,3,0,3,100.00,18,0,40,58,31.03
11754,POL,12,Lomacz Grzegorz ,S,0,0,0, ,0,0,0,0,0, ,0,0,0,0, ,0,0,0,0, ,0,0,0,0, ,0,0,0, ,0,0,0,0, 
11754,POL,14,Sliwka Aleksander ,OH,0,0,0, ,0,0,0,0,0, ,0,0,0,0, ,0,0,0,0, ,0,0,0,0, ,0,0,0, ,0,0,0,0, 
11754,POL,15,Kochanowski Jakub ,MB,4,3,1,16.00,8,4,0,0,4,100.00,3,2,1,6,16.67,1,2,12,15,-6.67,0,0,0,0, ,4,1,5,60.00,0,0,0,0, 
11754,POL,17,Zatorski Pawel ,L,0,0,0, ,0,0,0,0,0, ,0,0,0,0, ,0,0,0,0, ,0,0,0,0, ,0,0,0, ,0,0,0,0, 
11754,POL,21,Fornal Tomasz ,OH,0,0,0, ,0,0,0,0,0, ,0,0,0,0, ,0,0,0,0, ,0,0,0,0, ,0,0,0, ,0,0,0,0, 
11754,POL,22,Bednorz Bartosz ,OH,11,1,2,32.26,14,11,1,5,17,58.82,1,2,0,3,-33.33,2,1,8,11,9.09,9,0,1,10,90.00,1,1,2,0.00,0,0,3,3,0.00
11754,POL,77,Klos Karol ,MB,0,0,0, ,0,0,0,0,0, ,0,0,0,0, ,0,0,0,0, ,0,0,0,0, ,0,0,0, ,0,0,0,0, 
11754,POL,99,Huber Norbert ,MB,7,3,1,33.33,11,7,0,2,9,77.78,3,3,2,8,0.00,1,0,6,7,14.29,0,0,0,0, ,2,2,4,0.00,0,0,0,0, 
11754,BUL,1,Karyagin Denis ,O,2,0,1,0.00,3,2,2,2,6,0.00,0,0,0,0, ,1,1,2,4,0.00,1,0,0,1,100.00,0,0,0, ,0,0,1,1,0.00
11754,BUL,2,Chavdarov Stefan ,MB,0,0,0, ,0,0,0,0,0, ,0,0,0,0, ,0,0,0,0, ,0,0,0,0, ,0,0,0, ,0,0,0,0, 
11754,BUL,3,Kolev Nikolay ,MB,1,0,0,-27.27,1,1,2,1,4,-25.00,0,2,0,2,-100.00,0,0,5,5,0.00,0,0,1,1,0.00,0,1,1,-100.00,0,0,0,0, 
11754,BUL,4,Atanasov Martin ,OH,0,0,0, ,0,0,0,0,0, ,0,0,0,0, ,0,0,0,0, ,0,0,0,0, ,0,0,0, ,0,0,0,0, 
11754,BUL,9,Seganov Georgi ,S,1,0,0,-16.67,1,1,0,0,1,100.00,0,1,0,1,-100.00,0,1,3,4,-25.00,0,0,0,0, ,0,1,1,-100.00,7,0,36,43,16.28
11754,BUL,10,Stankov Svetoslav ,S,0,0,0,0.00,0,0,0,0,0, ,0,0,0,0, ,0,0,1,1,0.00,0,0,0,0, ,1,1,2,0.00,4,0,9,13,30.77
11754,BUL,12,Petrov Georgi ,OH,7,2,0,-3.12,9,7,3,9,19,21.05,2,3,0,5,-20.00,0,4,4,8,-50.00,7,3,16,26,15.38,1,1,2,0.00,0,0,0,0, 
11754,BUL,14,Asparuhov Asparuh ,OH,8,0,0,23.81,8,8,0,7,15,53.33,0,1,0,1,-100.00,0,2,3,5,-40.00,7,2,4,13,38.46,1,1,2,0.00,0,0,1,1,0.00
11754,BUL,15,Lyutskanov Gordan ,OH,0,0,0,-33.33,0,0,0,0,0, ,0,1,0,1,-100.00,0,0,2,2,0.00,0,0,0,0, ,0,0,0, ,0,0,0,0, 
11754,BUL,16,Ivanov Vladislav ,L,0,0,0, ,0,0,0,0,0, ,0,0,0,0, ,0,0,0,0, ,8,2,5,15,40.00,4,2,7,28.57,0,0,6,6,0.00
11754,BUL,22,Kartev Nikolay ,MB,2,0,0,-9.09,2,2,1,0,3,33.33,0,0,0,0, ,0,2,6,8,-25.00,0,0,0,0, ,1,1,2,0.00,0,0,1,1,0.00
11754,BUL,24,Ivanov Martin ,L,0,0,0, ,0,0,0,0,0, ,0,0,0,0, ,0,0,0,0, ,0,0,0,0, ,0,0,0, ,0,0,0,0, 
11754,BUL,25,Parapunov Radoslav ,O,6,0,0,-12.00,6,6,6,4,16,0.00,0,0,1,1,0.00,0,3,5,8,-37.50,0,0,0,0, ,0,3,3,-100.00,0,0,1,1,0.00
11754,BUL,26,Ivanov Svetoslav ,OH,0,0,0,0.00,0,0,0,1,1,0.00,0,0,0,0, ,0,0,2,2,0.00,0,1,2,3,-33.33,0,1,1,-100.00,0,0,0,0, 
11755,NED,4,Ter Horst Thijs ,OH,0,0,0, ,0,0,0,0,0, ,0,0,0,0, ,0,0,0,0, ,0,0,0,0, ,0,0,0, ,0,0,0,0, 
11755,NED,5,van der Ent Luuc ,MB,4,2,0,10.00,6,4,0,2,6,66.67,2,3,3,8,-12.50,0,1,5,6,-16.67,0,0,0,0, ,1,0,2,50.00,0,0,0,0, 
11755,NED,6,Dronkers Just ,L,0,0,0, ,0,0,0,0,0, ,0,0,0,0, ,0,0,0,0, ,4,1,12,17,17.65,9,2,11,63.64,0,0,6,6,0.00
11755,NED,8,Plak Fabian ,MB,0,0,0,0.00,0,0,0,0,0, ,0,0,0,0, ,0,0,1,1,0.00,0,0,1,1,0.00,0,0,0, ,0,0,0,0, 
11755,NED,10,van Zeist Maikel ,MB,0,0,0, ,0,0,0,0,0, ,0,0,0,0, ,0,0,0,0, ,0,0,0,0, ,0,0,0, ,0,0,0,0, 
11755,NED,12,Tuinstra Bennie Junior ,OH,12,1,0,6.82,13,12,4,12,28,28.57,1,3,0,4,-50.00,0,3,9,12,-25.00,4,2,17,23,8.70,4,2,7,28.57,0,0,1,1,0.00
11755,NED,13,Ottevanger Steven ,L,0,0,0, ,0,0,0,0,0, ,0,0,0,0, ,0,0,0,0, ,0,0,0,0, ,0,0,0, ,0,0,0,0, 
11755,NED,14,Abdel-Aziz Nimir ,O,15,2,3,10.00,20,15,8,8,31,22.58,2,2,0,4,0.00,3,5,7,15,-13.33,1,0,0,1,100.00,3,3,6,0.00,0,0,2,2,0.00
11755,NED,15,van Solkema Gijs ,S,0,0,0, ,0,0,0,0,0, ,0,0,0,0, ,0,0,0,0, ,0,0,0,0, ,0,0,0, ,1,0,1,2,50.00
11755,NED,17,Parkinson Michael ,MB,4,2,0,3.85,6,4,0,2,6,66.67,2,5,2,9,-33.33,0,0,11,11,0.00,0,0,1,1,0.00,2,0,2,100.00,0,0,0,0, 
11755,NED,18,Andringa Robbert ,L,4,0,0,-18.52,4,4,2,6,12,16.67,0,4,3,7,-57.14,0,3,5,8,-37.50,16,0,12,28,57.14,4,1,6,50.00,0,0,3,3,0.00
11755,NED,19,de Weijer Freek ,S,2,0,1,13.33,3,2,0,0,2,100.00,0,0,1,1,0.00,1,1,10,12,0.00,0,0,0,0, ,3,3,6,0.00,18,0,52,70,25.71
11755,NED,21,van Schie Stijn ,OH,0,0,0, ,0,0,0,0,0, ,0,0,0,0, ,0,0,0,0, ,0,0,0,0, ,0,0,0, ,0,0,0,0, 
11755,NED,25,van Tilburg Stijn ,OH,0,0,0,-25.00,0,0,0,1,1,0.00,0,0,1,1,0.00,0,1,1,2,-50.00,0,0,0,0, ,0,0,0, ,0,0,0,0, 
11755,BRA,1,Rezende Bruno Mossa ,S,2,1,0,16.67,3,2,0,1,3,66.67,1,0,3,4,25.00,0,0,11,11,0.00,0,0,0,0, ,8,0,8,100.00,18,1,49,68,25.00
11755,BRA,5,Borges Almeida Silva Mauricio ,OH,3,0,0,-17.14,3,3,6,7,16,-18.75,0,2,3,5,-40.00,0,1,13,14,-7.14,11,4,7,22,31.82,2,0,2,100.00,0,0,5,5,0.00
11755,BRA,6,Gil Kreling Fernando ,S,0,0,0, ,0,0,0,0,0, ,0,0,0,0, ,0,0,0,0, ,0,0,0,0, ,0,0,0, ,1,0,1,2,50.00
11755,BRA,8,De Souza Wallace ,O,12,2,1,26.19,15,12,0,7,19,63.16,2,2,4,8,0.00,1,2,12,15,-6.67,0,0,0,0, ,7,0,7,100.00,0,0,1,1,0.00
11755,BRA,9,Leal Hidalgo Yoandy ,OH,18,0,2,22.22,20,18,5,4,27,48.15,0,4,1,5,-80.00,2,1,10,13,7.69,3,0,11,14,21.43,4,1,6,50.00,0,0,2,2,0.00
11755,BRA,11,Kavalkievicz Gabriel ,OH,0,0,0,0.00,0,0,0,0,0, ,0,0,0,0, ,0,0,1,1,0.00,0,0,0,0, ,0,0,0, ,0,0,0,0, 
11755,BRA,12,Santos Isac ,MB,0,0,0, ,0,0,0,0,0, ,0,0,0,0, ,0,0,0,0, ,0,0,0,0, ,0,0,0, ,0,0,0,0, 
11755,BRA,13,De Souza Mauricio Luiz ,MB,3,4,0,7.69,7,3,1,2,6,33.33,4,4,3,11,0.00,0,0,9,9,0.00,0,0,0,0, ,1,1,3,0.00,2,0,0,2,100.00
11755,BRA,14,Correia De Souza Douglas ,OH,0,0,0, ,0,0,0,0,0, ,0,0,0,0, ,0,0,0,0, ,0,0,0,0, ,0,0,0, ,0,0,0,0, 
11755,BRA,15,Nascimento Maique Reis ,L,0,0,0, ,0,0,0,0,0, ,0,0,0,0, ,0,0,0,0, ,0,0,0,0, ,0,0,1,0.00,0,0,0,0, 
11755,BRA,17,Hoss Thales ,L,0,0,0, ,0,0,0,0,0, ,0,0,0,0, ,0,0,0,0, ,5,0,12,17,29.41,6,1,7,71.43,0,0,2,2,0.00
11755,BRA,18,Souza Ricardo Lucarelli ,OH,0,0,0,0.00,0,0,0,1,1,0.00,0,0,0,0, ,0,0,0,0, ,0,0,0,0, ,0,0,0, ,0,0,0,0, 
11755,BRA,21,Souza Alan ,O,1,0,0,100.00,1,1,0,0,1,100.00,0,0,0,0, ,0,0,0,0, ,0,0,0,0, ,0,0,0, ,0,0,0,0, 
11755,BRA,23,Resende Gualberto Flavio ,MB,5,2,0,3.45,7,5,2,2,9,33.33,2,3,2,7,-14.29,0,1,12,13,-7.69,0,0,0,0, ,3,0,3,100.00,0,0,0,0, 
11756,SRB,2,Kovacevic Uros ,OH,18,1,1,10.91,20,18,4,13,35,40.00,1,4,1,6,-50.00,1,6,7,14,-35.71,9,1,19,29,27.59,5,2,8,37.50,0,0,3,3,0.00
11756,SRB,3,Kapur Milorad ,L,0,0,0, ,0,0,0,0,0, ,0,0,0,0, ,0,0,0,0, ,0,0,0,0, ,0,0,0, ,0,0,0,0, 
11756,SRB,6,Pekovic Nikola ,L,0,0,0, ,0,0,0,0,0, ,0,0,0,0, ,0,0,0,0, ,10,1,16,27,33.33,5,8,13,-23.08,0,0,9,9,0.00
11756,SRB,7,Krsmanovic Petar ,MB,9,1,1,2.08,11,9,3,3,15,40.00,1,3,2,6,-33.33,1,4,22,27,-11.11,1,0,1,2,50.00,6,2,8,50.00,0,0,5,5,0.00
11756,SRB,8,Ivovic Marko ,OH,4,0,2,16.67,6,4,1,4,9,33.33,0,1,1,2,-50.00,2,0,11,13,15.38,4,2,4,10,20.00,2,5,7,-42.86,0,0,1,1,0.00
11756,SRB,9,Jovovic Nikola ,S,0,0,0,-8.33,0,0,0,0,0, ,0,1,2,3,-33.33,0,0,9,9,0.00,0,0,0,0, ,8,3,12,41.67,34,0,55,89,38.20
11756,SRB,10,KujundÅ¾iÄ Miran ,OH,0,0,0, ,0,0,0,0,0, ,0,0,0,0, ,0,0,0,0, ,0,0,0,0, ,0,0,0, ,0,0,0,0, 
11756,SRB,12,Peric Pavle ,OH,5,1,1,-6.45,7,5,4,5,14,7.14,1,1,2,4,0.00,1,4,8,13,-23.08,4,2,3,9,22.22,6,1,7,71.43,0,0,1,1,0.00
11756,SRB,13,Simic Stevan ,MB,0,0,0, ,0,0,0,0,0, ,0,0,0,0, ,0,0,0,0, ,0,0,0,0, ,0,0,0, ,0,0,0,0, 
11756,SRB,14,Atanasijevic Aleksandar ,O,2,0,0,20.00,2,2,1,0,3,33.33,0,0,0,0, ,0,0,2,2,0.00,0,0,0,0, ,0,0,0, ,0,0,1,1,0.00
11756,SRB,16,Luburic Drazen ,O,21,1,1,25.49,23,21,3,8,32,56.25,1,2,3,6,-16.67,1,5,7,13,-30.77,0,0,0,0, ,7,1,8,75.00,0,0,2,2,0.00
11756,SRB,18,Podrascanin Marko ,MB,6,8,3,24.44,17,6,0,2,8,75.00,8,4,4,16,25.00,3,2,16,21,4.76,0,0,1,1,0.00,3,3,8,0.00,0,0,2,2,0.00
11756,SRB,21,Todorovic Vuk ,S,0,0,0, ,0,0,0,0,0, ,0,0,0,0, ,0,0,0,0, ,0,0,1,1,0.00,0,0,0, ,3,0,0,3,100.00
11756,SRB,26,Kovac Davide ,OH,0,0,0, ,0,0,0,0,0, ,0,0,0,0, ,0,0,0,0, ,1,1,1,3,0.00,0,0,0, ,0,0,0,0, 
11756,IRI,2,Ebadipour Ghara H. Milad ,OH,0,0,0, ,0,0,0,0,0, ,0,0,0,0, ,0,0,0,0, ,0,0,0,0, ,0,0,0, ,0,0,0,0, 
11756,IRI,3,Abedini Reza ,MB,7,3,1,18.75,11,7,1,1,9,66.67,3,2,2,7,14.29,1,2,13,16,-6.25,0,0,0,0, ,1,0,2,50.00,0,0,1,1,0.00
11756,IRI,4,Marouflakrani Mir Saeid ,S,0,0,0,0.00,0,0,0,0,0, ,0,0,0,0, ,0,0,2,2,0.00,0,0,0,0, ,0,0,1,0.00,5,1,4,10,40.00
11756,IRI,7,Fayazi D. Purya ,OH,0,0,0, ,0,0,0,0,0, ,0,0,0,0, ,0,0,0,0, ,0,1,6,7,-14.29,1,0,1,100.00,0,0,0,0, 
11756,IRI,8,Hazratpourtalatappeh Mohammadreza ,L,0,0,0, ,0,0,0,0,0, ,0,0,0,0, ,0,0,0,0, ,9,0,10,19,47.37,3,3,8,0.00,0,0,13,13,0.00
11756,IRI,9,Gholami Masoud ,MB,0,0,0, ,0,0,0,0,0, ,0,0,0,0, ,0,0,0,0, ,0,0,0,0, ,0,0,0, ,0,0,0,0, 
11756,IRI,11,Kazemi Saber ,O,4,0,0,18.18,4,4,0,2,6,66.67,0,2,1,3,-66.67,0,0,2,2,0.00,0,0,0,0, ,0,0,1,0.00,0,0,0,0, 
11756,IRI,12,Sharifi Morteza ,OH,10,1,3,2.08,14,10,5,7,22,22.73,1,4,3,8,-37.50,3,4,11,18,-5.56,7,2,27,36,13.89,6,1,9,55.56,0,0,1,1,0.00
11756,IRI,16,Shafiei Ali ,MB,1,2,0,-3.23,3,1,2,3,6,-16.67,2,1,4,7,14.29,0,1,17,18,-5.56,0,1,1,2,-50.00,3,2,6,16.67,0,0,0,0, 
11756,IRI,17,Salehi Meisam ,OH,0,0,0, ,0,0,0,0,0, ,0,0,0,0, ,0,0,0,0, ,0,0,0,0, ,0,0,0, ,0,0,0,0, 
11756,IRI,18,Vadi Mohammad Taher ,S,0,1,0,-14.29,1,0,0,3,3,0.00,1,2,1,4,-25.00,0,2,12,14,-14.29,0,0,0,0, ,6,5,11,9.09,23,1,56,80,27.50
11756,IRI,21,Salehi Arman ,L,0,0,0, ,0,0,0,0,0, ,0,0,0,0, ,0,0,0,0, ,0,0,0,0, ,0,0,0, ,0,0,0,0, 
11756,IRI,22,Esfandiar Amirhossein ,OH,14,1,2,15.91,17,14,3,8,25,44.00,1,2,2,5,-20.00,2,5,7,14,-21.43,15,5,7,27,37.04,4,3,8,12.50,0,0,1,1,0.00
11756,IRI,23,Saadat Bardia ,O,15,0,1,1.75,16,15,7,13,35,22.86,0,6,2,8,-75.00,1,2,11,14,-7.14,0,0,0,0, ,2,1,3,33.33,0,0,0,0, 
11757,RUS,1,Podlesnykh Yaroslav ,OH,2,0,0,-20.00,2,2,2,4,8,0.00,0,1,0,1,-100.00,0,2,4,6,-33.33,4,0,9,13,30.77,4,1,5,60.00,0,0,0,0, 
11757,RUS,2,Vlasov Ilia ,MB,4,6,0,12.12,10,4,0,6,10,40.00,6,4,2,12,16.67,0,2,9,11,-18.18,0,0,0,0, ,0,1,1,-100.00,0,0,1,1,0.00
11757,RUS,4,Volvich Artem ,MB,8,4,1,25.71,13,8,0,2,10,80.00,4,1,1,6,50.00,1,3,15,19,-10.53,0,1,0,1,-100.00,1,0,1,100.00,0,0,0,0, 
11757,RUS,5,Semyshev Anton ,OH,0,0,0, ,0,0,0,0,0, ,0,0,0,0, ,0,0,0,0, ,0,0,0,0, ,0,0,0, ,0,0,0,0, 
11757,RUS,6,Baranov Evgeny ,L,0,0,0, ,0,0,0,0,0, ,0,0,0,0, ,0,0,0,0, ,6,1,13,20,25.00,7,6,13,7.69,0,0,1,1,0.00
11757,RUS,7,Volkov Dmitry ,OH,14,2,2,17.31,18,14,3,9,26,42.31,2,2,1,5,0.00,2,4,15,21,-9.52,8,2,13,23,26.09,3,2,5,20.00,0,0,3,3,0.00
11757,RUS,10,Bogdan Denis ,OH,0,0,0, ,0,0,0,0,0, ,0,0,0,0, ,0,0,0,0, ,0,0,0,0, ,0,0,0, ,0,0,0,0, 
11757,RUS,11,Pankov Pavel ,S,0,0,0, ,0,0,0,0,0, ,0,0,0,0, ,0,0,0,0, ,0,0,0,0, ,0,0,0, ,0,0,0,0, 
11757,RUS,15,Poletaev Victor ,O,0,0,0, ,0,0,0,0,0, ,0,0,0,0, ,0,0,0,0, ,0,0,0,0, ,0,0,0, ,0,0,0,0, 
11757,RUS,17,Mikhaylov Maxim ,O,19,1,2,25.86,22,19,3,10,32,50.00,1,1,1,3,0.00,2,3,18,23,-4.35,1,0,0,1,100.00,4,2,6,33.33,0,1,3,4,-25.00
11757,RUS,18,Kliuka Egor ,OH,4,0,0,5.88,4,4,1,6,11,27.27,0,0,0,0, ,0,2,4,6,-33.33,3,3,2,8,0.00,2,0,2,100.00,0,0,1,1,0.00
11757,RUS,20,Kurkaev Ilyas ,MB,0,0,0, ,0,0,0,0,0, ,0,0,0,0, ,0,0,0,0, ,0,0,0,0, ,0,0,0, ,0,0,0,0, 
11757,RUS,24,Kobzar Igor ,S,0,2,1,-16.67,3,0,0,0,0, ,2,3,2,7,-14.29,1,3,7,11,-18.18,0,0,2,2,0.00,3,1,4,50.00,14,2,73,89,13.48
11757,RUS,27,Golubev Valentin ,L,0,0,0, ,0,0,0,0,0, ,0,0,0,0, ,0,0,0,0, ,0,0,0,0, ,0,0,0, ,0,0,0,0, 
11757,CAN,1,Sanders Tyler ,S,0,0,0, ,0,0,0,0,0, ,0,0,0,0, ,0,0,0,0, ,0,0,0,0, ,0,0,0, ,0,0,0,0, 
11757,CAN,2,Perrin John Gordon ,OH,0,0,0, ,0,0,0,0,0, ,0,0,0,0, ,0,0,0,0, ,0,0,0,0, ,0,0,0, ,0,0,1,1,0.00
11757,CAN,3,Marshall Steven ,OH,0,0,0, ,0,0,0,0,0, ,0,0,0,0, ,0,0,0,0, ,11,3,15,29,27.59,10,5,15,33.33,0,0,3,3,0.00
11757,CAN,4,Hoag Nicholas ,OH,10,1,2,7.14,13,10,5,8,23,21.74,1,1,1,3,0.00,2,4,10,16,-12.50,8,2,17,27,22.22,4,3,7,14.29,0,0,3,3,0.00
11757,CAN,6,Pereira Jordan ,OH,0,0,0, ,0,0,0,0,0, ,0,0,0,0, ,0,0,0,0, ,0,0,0,0, ,1,0,1,100.00,0,0,0,0, 
11757,CAN,8,Blankenau Jay ,S,1,1,0,-5.88,2,1,0,2,3,33.33,1,1,0,2,0.00,0,2,10,12,-16.67,0,1,1,2,-50.00,5,6,12,-8.33,19,0,68,87,21.84
11757,CAN,10,Sclater Ryan Joseph ,O,0,0,0,-33.33,0,0,0,0,0, ,0,0,0,0, ,0,1,2,3,-33.33,0,0,0,0, ,0,1,1,-100.00,0,0,0,0, 
11757,CAN,11,Jansen Vandoorn Daniel ,MB,4,1,0,4.17,5,4,2,4,10,20.00,1,0,1,2,50.00,0,2,10,12,-16.67,1,0,1,2,50.00,2,1,3,33.33,0,0,1,1,0.00
11757,CAN,12,Van Berkel Lucas ,MB,0,0,0, ,0,0,0,0,0, ,0,0,0,0, ,0,0,0,0, ,0,0,0,0, ,0,0,0, ,0,0,0,0, 
11757,CAN,13,Vernon-Evans Sharone ,O,13,1,1,0.00,15,13,6,12,31,22.58,1,2,0,3,-33.33,1,7,7,15,-40.00,0,0,1,1,0.00,2,2,4,0.00,0,0,0,0, 
11757,CAN,14,Loeppky Eric ,OH,10,0,0,5.00,10,10,5,12,27,18.52,0,2,2,4,-50.00,0,1,8,9,-11.11,4,0,11,15,26.67,6,3,9,33.33,0,1,5,6,-16.67
11757,CAN,20,Szwarc Arthur ,O,6,1,4,17.65,11,6,3,2,11,27.27,1,2,2,5,-20.00,4,0,14,18,22.22,1,0,1,2,50.00,0,1,1,-100.00,0,0,1,1,0.00
11757,CAN,21,Walsh Brett James ,S,0,0,0, ,0,0,0,0,0, ,0,0,0,0, ,0,0,0,0, ,0,0,0,0, ,0,0,0, ,0,0,0,0, 
11757,CAN,23,Demyanenko Danny ,MB,0,0,0, ,0,0,0,0,0, ,0,0,0,0, ,0,0,0,0, ,0,0,0,0, ,0,0,0, ,0,0,0,0, 
11758,FRA,1,Chinenyeze BarthÃ©lÃ©my ,MB,0,0,0, ,0,0,0,0,0, ,0,0,0,0, ,0,0,0,0, ,0,0,0,0, ,0,0,0, ,0,0,0,0, 
11758,FRA,2,Grebennikov Jenia ,L,0,0,0, ,0,0,0,0,0, ,0,0,0,0, ,0,0,0,0, ,9,1,3,13,61.54,10,4,17,35.29,0,0,3,3,0.00
11758,FRA,6,Toniutti Benjamin ,S,0,0,0,-20.00,0,0,0,0,0, ,0,3,3,6,-50.00,0,1,13,14,-7.14,0,0,0,0, ,2,3,5,-20.00,38,0,33,71,53.52
11758,FRA,7,Tillie Kevin ,OH,5,0,0,6.25,5,5,1,5,11,36.36,0,1,0,1,-100.00,0,2,2,4,-50.00,3,2,7,12,8.33,1,1,2,0.00,0,0,0,0, 
11758,FRA,8,Lyneel Julien ,OH,0,0,1,-20.00,1,0,0,0,0, ,0,0,0,0, ,1,2,2,5,-20.00,0,0,0,0, ,0,0,0, ,0,0,0,0, 
11758,FRA,9,Ngapeth Earvin ,OH,12,1,1,21.21,14,12,2,2,16,62.50,1,1,2,4,0.00,1,4,8,13,-23.08,8,2,6,16,37.50,4,1,6,50.00,0,0,4,4,0.00
11758,FRA,11,Brizard Antoine ,S,0,0,0,-20.00,0,0,0,0,0, ,0,1,2,3,-33.33,0,0,2,2,0.00,0,0,0,0, ,1,2,3,-33.33,9,0,9,18,50.00
11758,FRA,12,Boyer Stephen ,O,8,0,0,-13.16,8,8,7,7,22,4.55,0,1,3,4,-25.00,0,5,7,12,-41.67,0,0,0,0, ,2,4,8,-25.00,0,0,1,1,0.00
11758,FRA,14,Le Goff Nicolas ,MB,4,2,0,11.11,6,4,1,1,6,50.00,2,1,4,7,14.29,0,1,13,14,-7.14,0,0,1,1,0.00,2,0,2,100.00,0,0,2,2,0.00
11758,FRA,16,Bultor Daryl ,MB,5,0,2,-15.91,7,5,3,8,16,12.50,0,8,5,13,-61.54,2,3,10,15,-6.67,0,0,1,1,0.00,2,1,3,33.33,0,0,0,0, 
11758,FRA,18,Rossard Thibault ,OH,12,0,2,10.42,14,12,3,11,26,34.62,0,2,2,4,-50.00,2,4,12,18,-11.11,12,0,14,26,46.15,10,6,17,23.53,0,0,1,1,0.00
11758,FRA,20,Diez Benjamin ,L,0,0,0, ,0,0,0,0,0, ,0,0,0,0, ,0,0,0,0, ,0,0,0,0, ,0,0,0, ,0,0,0,0, 
11758,FRA,21,Faure ThÃ©o ,O,2,0,0,0.00,2,2,2,2,6,0.00,0,0,2,2,0.00,0,0,4,4,0.00,0,0,0,0, ,1,1,4,0.00,0,0,0,0, 
11758,FRA,24,Gueye Mousse ,MB,0,0,0, ,0,0,0,0,0, ,0,0,0,0, ,0,0,0,0, ,0,0,0,0, ,0,0,0, ,0,0,0,0, 
11758,SLO,2,Pajenk Alen ,MB,11,1,1,2.56,13,11,1,3,15,66.67,1,4,5,10,-30.00,1,7,6,14,-42.86,0,0,0,0, ,2,0,2,100.00,0,0,0,0, 
11758,SLO,3,PernuÅ¡ Gregor ,S,0,0,0, ,0,0,0,0,0, ,0,0,0,0, ,0,0,0,0, ,0,0,0,0, ,0,0,0, ,0,0,0,0, 
11758,SLO,5,Å ket Alen ,O,9,0,1,4.88,10,9,0,10,19,47.37,0,4,6,10,-40.00,1,4,7,12,-25.00,0,0,0,0, ,7,2,11,45.45,0,0,1,1,0.00
11758,SLO,6,Gasparini Mitja ,O,4,0,0,-16.67,4,4,3,1,8,12.50,0,0,0,0, ,0,3,1,4,-75.00,0,0,0,0, ,0,0,0, ,0,0,0,0, 
11758,SLO,9,Vincic Dejan ,S,0,0,1,0.00,1,0,0,0,0, ,0,0,0,0, ,1,1,1,3,0.00,0,0,0,0, ,0,3,3,-100.00,16,2,7,25,56.00
11758,SLO,10,Å talekar SaÅ¡o ,MB,1,2,0,-15.38,3,1,3,0,4,-50.00,2,1,2,5,20.00,0,1,3,4,-25.00,0,0,0,0, ,0,1,1,-100.00,0,1,1,2,-50.00
11758,SLO,11,Å tern Å½iga ,OH,0,0,0,-42.86,0,0,0,2,2,0.00,0,1,0,1,-100.00,0,2,2,4,-50.00,1,2,5,8,-12.50,1,0,1,100.00,0,0,0,0, 
11758,SLO,12,Klobucar Jan ,L,0,0,0, ,0,0,0,0,0, ,0,0,0,0, ,0,0,0,0, ,0,0,0,0, ,0,0,0, ,0,0,0,0, 
11758,SLO,13,KovaÄiÄ Jani ,L,0,0,0, ,0,0,0,0,0, ,0,0,0,0, ,0,0,0,0, ,6,0,17,23,26.09,11,8,20,15.00,0,0,3,3,0.00
11758,SLO,15,VideÄnik Matic ,MB,1,0,0,-11.76,1,1,0,1,2,50.00,0,1,1,2,-50.00,0,2,11,13,-15.38,0,0,0,0, ,1,0,1,100.00,0,0,0,0, 
11758,SLO,16,Ropret Gregor ,S,0,3,0,-4.35,3,0,0,0,0, ,3,3,3,9,0.00,0,1,13,14,-7.14,0,0,0,0, ,5,0,7,71.43,38,1,28,67,55.22
11758,SLO,17,Urnaut Tine ,OH,0,0,0, ,0,0,0,0,0, ,0,0,0,0, ,0,0,0,0, ,0,0,0,0, ,0,0,0, ,0,0,0,0, 
11758,SLO,18,Äebulj Klemen ,OH,10,4,2,18.37,16,10,0,14,24,41.67,4,3,0,7,14.29,2,4,12,18,-11.11,9,2,19,30,23.33,5,0,7,71.43,0,0,5,5,0.00
11758,SLO,19,MoÅ¾iÄ Rok ,OH,19,1,0,5.45,20,19,2,10,31,54.84,1,8,0,9,-77.78,0,7,8,15,-46.67,3,2,13,18,5.56,6,0,7,85.71,0,0,3,3,0.00
11759,ARG,1,Sanchez Matias ,S,2,0,1,5.88,3,2,0,0,2,100.00,0,1,0,1,-100.00,1,1,12,14,0.00,0,0,0,0, ,3,4,7,-14.29,34,0,39,73,46.58
11759,ARG,2,Pereyra Federico ,O,12,0,3,10.53,15,12,4,5,21,38.10,0,3,0,3,-100.00,3,4,7,14,-7.14,0,0,0,0, ,2,1,3,33.33,0,0,1,1,0.00
11759,ARG,3,Martinez Franchi Jan ,OH,8,1,0,5.26,9,8,2,7,17,35.29,1,3,2,6,-33.33,0,2,13,15,-13.33,9,0,9,18,50.00,5,0,5,100.00,0,0,1,1,0.00
11759,ARG,5,Uriarte Nicolas ,S,0,0,0, ,0,0,0,0,0, ,0,0,0,0, ,0,0,0,0, ,0,0,0,0, ,0,0,0, ,0,0,0,0, 
11759,ARG,6,Poglajen Cristian ,OH,0,0,0, ,0,0,0,0,0, ,0,0,0,0, ,0,0,0,0, ,0,0,0,0, ,0,0,0, ,0,0,0,0, 
11759,ARG,7,Conte Facundo ,OH,0,0,0, ,0,0,0,0,0, ,0,0,0,0, ,0,0,0,0, ,0,0,0,0, ,0,0,0, ,0,0,0,0, 
11759,ARG,8,Loser Agustin ,MB,13,1,0,20.00,14,13,1,5,19,63.16,1,3,1,5,-40.00,0,3,8,11,-27.27,0,0,0,0, ,5,0,5,100.00,0,0,2,2,0.00
11759,ARG,11,SolÃ© Sebastian ,MB,0,0,0, ,0,0,0,0,0, ,0,0,0,0, ,0,0,0,0, ,0,0,0,0, ,0,0,0, ,0,0,0,0, 
11759,ARG,13,Palacios Ezequiel ,OH,0,0,0, ,0,0,0,0,0, ,0,0,0,0, ,0,0,0,0, ,0,0,0,0, ,0,0,0, ,0,0,0,0, 
11759,ARG,15,De Cecco Luciano ,S,0,0,0, ,0,0,0,0,0, ,0,0,0,0, ,0,0,0,0, ,0,0,0,0, ,0,0,0, ,0,0,0,0, 
11759,ARG,16,Palonsky Luciano ,OH,0,0,0, ,0,0,0,0,0, ,0,0,0,0, ,0,0,0,0, ,0,0,0,0, ,0,0,0, ,0,0,0,0, 
11759,ARG,17,Mendez Nicolas ,OH,9,0,0,20.00,9,9,2,2,13,53.85,0,2,0,2,-100.00,0,0,10,10,0.00,9,1,10,20,40.00,3,1,4,50.00,0,0,2,2,0.00
11759,ARG,18,Ramos Martin ,MB,5,4,1,14.29,10,5,0,6,11,45.45,4,4,0,8,0.00,1,2,6,9,-11.11,1,0,0,1,100.00,2,0,2,100.00,0,0,0,0, 
11759,ARG,19,Massimino Franco ,L,0,0,0, ,0,0,0,0,0, ,0,0,0,0, ,0,0,0,0, ,5,0,5,10,50.00,5,3,9,22.22,0,0,3,3,0.00
11759,AUS,1,Graham Beau ,MB,6,0,0,29.41,6,6,0,4,10,60.00,0,1,0,1,-100.00,0,0,6,6,0.00,0,0,1,1,0.00,1,1,2,0.00,0,0,0,0, 
11759,AUS,2,Dosanjh Arshdeep ,S,0,2,1,14.29,3,0,0,3,3,0.00,2,0,0,2,100.00,1,1,7,9,0.00,0,0,1,1,0.00,4,8,13,-30.77,11,1,46,58,17.24
11759,AUS,3,Macdonald Steven ,MB,0,0,0,-25.00,0,0,0,0,0, ,0,1,0,1,-100.00,0,0,3,3,0.00,0,0,0,0, ,0,0,0, ,0,0,0,0, 
11759,AUS,7,Weir James ,MB,3,0,0,-18.75,3,3,3,2,8,0.00,0,1,1,2,-50.00,0,2,4,6,-33.33,0,0,0,0, ,1,3,4,-50.00,0,0,2,2,0.00
11759,AUS,8,O'Dea Trent ,MB,4,3,0,7.14,7,4,1,7,12,25.00,3,4,0,7,-14.29,0,0,9,9,0.00,1,0,0,1,100.00,0,1,1,-100.00,0,0,1,1,0.00
11759,AUS,11,Perry Luke ,L,0,0,0, ,0,0,0,0,0, ,0,0,0,0, ,0,0,0,0, ,7,1,7,15,40.00,4,1,5,60.00,0,0,10,10,0.00
11759,AUS,15,Smith Luke ,OH,9,2,0,25.81,11,9,1,8,18,44.44,2,0,0,2,100.00,0,2,9,11,-18.18,10,4,17,31,19.35,2,4,6,-33.33,0,0,1,1,0.00
11759,AUS,21,Butler Nicholas ,S,0,0,0,0.00,0,0,0,0,0, ,0,0,0,0, ,0,0,1,1,0.00,0,0,0,0, ,0,0,0, ,0,0,0,0, 
11759,AUS,27,Senica Max ,OH,6,0,0,7.41,6,6,1,9,16,31.25,0,0,0,0, ,0,3,8,11,-27.27,6,0,6,12,50.00,0,1,1,-100.00,0,0,0,0, 
11759,AUS,28,Taylor Tim ,OH,0,0,0, ,0,0,0,0,0, ,0,0,0,0, ,0,0,0,0, ,0,0,0,0, ,0,0,0, ,0,0,0,0, 
11759,AUS,31,Aubrey Matthew ,O,0,0,0, ,0,0,0,0,0, ,0,0,0,0, ,0,0,0,0, ,0,0,0,0, ,0,0,0, ,0,0,0,0, 
11759,AUS,32,Azeez Oluwatobi Elliot ,OH,4,0,0,-21.43,4,4,5,2,11,-9.09,0,0,0,0, ,0,2,1,3,-66.67,0,0,0,0, ,0,0,0, ,0,0,0,0, 
11759,AUS,33,Flowerday Sam ,OH,0,0,0, ,0,0,0,0,0, ,0,0,0,0, ,0,0,0,0, ,0,0,0,0, ,0,0,0, ,0,0,0,0, 
11759,AUS,34,Greber Billy ,L,0,0,0, ,0,0,0,0,0, ,0,0,0,0, ,0,0,0,0, ,0,0,0,0, ,0,0,0, ,0,0,0,0, 
11760,GER,1,Fromm Christian ,OH,3,0,0,-6.25,3,3,3,6,12,0.00,0,0,0,0, ,0,1,3,4,-25.00,1,0,12,13,7.69,2,0,2,100.00,0,1,2,3,-33.33
11760,GER,3,Schott Ruben ,OH,3,0,0,-18.52,3,3,3,7,13,0.00,0,2,1,3,-66.67,0,3,8,11,-27.27,6,1,5,12,41.67,4,1,6,50.00,0,0,4,4,0.00
11760,GER,5,Reichert Moritz ,OH,0,0,0,-100.00,0,0,0,0,0, ,0,0,0,0, ,0,1,0,1,-100.00,0,1,0,1,-100.00,1,0,1,100.00,0,0,0,0, 
11760,GER,6,Kaliberda Denys ,OH,0,0,0, ,0,0,0,0,0, ,0,0,0,0, ,0,0,0,0, ,0,0,0,0, ,0,0,0, ,0,0,0,0, 
11760,GER,10,Zenger Julian ,L,0,0,0, ,0,0,0,0,0, ,0,0,0,0, ,0,0,0,0, ,4,2,11,17,11.76,7,2,9,55.56,0,0,1,1,0.00
11760,GER,13,Hirsch Simon ,O,0,0,0, ,0,0,0,0,0, ,0,0,0,0, ,0,0,0,0, ,0,0,0,0, ,0,0,0, ,0,0,0,0, 
11760,GER,15,BaxpÃ¶hler Noah ,MB,0,0,0, ,0,0,0,0,0, ,0,0,0,0, ,0,0,0,0, ,0,0,0,0, ,0,0,0, ,0,0,0,0, 
11760,GER,16,BurggrÃ¤f Eric ,S,0,0,0,-100.00,0,0,0,0,0, ,0,0,0,0, ,0,1,0,1,-100.00,0,0,0,0, ,0,1,1,-100.00,1,0,4,5,20.00
11760,GER,17,Zimmermann Jan ,S,0,0,0,-14.29,0,0,0,1,1,0.00,0,1,4,5,-20.00,0,1,7,8,-12.50,0,0,0,0, ,4,1,5,60.00,21,0,39,60,35.00
11760,GER,18,Krage Florian ,MB,5,1,0,0.00,6,5,1,1,7,57.14,1,5,3,9,-44.44,0,0,7,7,0.00,0,0,1,1,0.00,1,1,2,0.00,0,0,0,0, 
11760,GER,19,RÃ¶hrs Erik ,OH,4,0,2,-5.00,6,4,3,3,10,10.00,0,2,1,3,-66.67,2,2,3,7,0.00,0,2,10,12,-16.67,2,0,2,100.00,0,0,0,0, 
11760,GER,20,Weber Linus ,O,8,1,1,-12.50,10,8,7,10,25,4.00,1,2,2,5,-20.00,1,6,3,10,-50.00,0,0,0,0, ,2,1,3,33.33,0,0,1,1,0.00
11760,GER,21,Krick Tobias ,MB,1,1,1,-16.67,3,1,0,2,3,33.33,1,2,2,5,-20.00,1,4,5,10,-30.00,0,0,0,0, ,4,0,5,80.00,0,0,0,0, 
11760,GER,25,Maase Lukas ,O,0,0,0,0.00,0,0,0,2,2,0.00,0,0,0,0, ,0,0,0,0, ,0,0,0,0, ,0,1,1,-100.00,0,0,0,0, 
11760,USA,3,Sander Taylor ,OH,0,0,0, ,0,0,0,0,0, ,0,0,0,0, ,0,0,0,0, ,0,0,0,0, ,0,0,0, ,0,0,0,0, 
11760,USA,4,Jendryk II Jeffrey ,MB,0,0,0, ,0,0,0,0,0, ,0,0,0,0, ,0,0,0,0, ,0,0,0,0, ,0,0,0, ,0,0,0,0, 
11760,USA,5,Ensing Kyle ,O,7,1,1,5.71,9,7,1,6,14,42.86,1,3,4,8,-25.00,1,3,9,13,-15.38,0,0,0,0, ,6,1,9,55.56,0,0,1,1,0.00
11760,USA,6,Stahl Mitchell ,MB,5,1,0,4.17,6,5,0,2,7,71.43,1,0,5,6,16.67,0,5,6,11,-45.45,0,0,0,0, ,3,0,3,100.00,0,0,1,1,0.00
11760,USA,7,Shoji Kawika ,S,1,4,1,15.79,6,1,0,0,1,100.00,4,1,2,7,42.86,1,2,8,11,-9.09,0,0,0,0, ,7,0,7,100.00,20,0,33,53,37.74
11760,USA,8,Defalco Torey ,OH,0,0,0,0.00,0,0,0,0,0, ,0,0,0,0, ,0,0,2,2,0.00,0,0,0,0, ,0,0,0, ,0,0,0,0, 
11760,USA,12,Holt Maxwell ,MB,0,0,0, ,0,0,0,0,0, ,0,0,0,0, ,0,0,0,0, ,0,0,0,0, ,0,0,0, ,0,0,0,0, 
11760,USA,13,Patch Benjamin ,O,1,1,0,0.00,2,1,0,1,2,50.00,1,1,0,2,0.00,0,1,0,1,-100.00,0,0,0,0, ,1,0,1,100.00,0,0,0,0, 
11760,USA,15,Sander Brenden ,OH,9,2,1,2.56,12,9,4,10,23,21.74,2,2,2,6,0.00,1,5,4,10,-40.00,3,3,9,15,0.00,3,0,4,75.00,0,0,2,2,0.00
11760,USA,16,Tuaniga Joshua ,S,1,0,0,100.00,1,1,0,0,1,100.00,0,0,0,0, ,0,0,0,0, ,0,0,0,0, ,0,0,0, ,2,0,2,4,50.00
11760,USA,18,Muagututia Garrett ,OH,9,1,2,21.05,12,9,0,6,15,60.00,1,2,2,5,-20.00,2,2,14,18,0.00,2,1,9,12,8.33,3,2,5,20.00,0,0,1,1,0.00
11760,USA,20,Smith David ,MB,3,1,1,-3.85,5,3,1,4,8,25.00,1,2,4,7,-14.29,1,3,7,11,-18.18,1,0,0,1,100.00,4,0,4,100.00,0,0,2,2,0.00
11760,USA,21,Watten Dustin ,L,0,0,0, ,0,0,0,0,0, ,0,0,0,0, ,0,0,0,0, ,0,0,0,0, ,0,0,0, ,0,0,0,0, 
11760,USA,22,Shoji Erik ,L,0,0,0, ,0,0,0,0,0, ,0,0,0,0, ,0,0,0,0, ,5,0,7,12,41.67,6,1,7,71.43,0,0,5,5,0.00
11761,BUL,1,Karyagin Denis ,O,7,0,0,0.00,7,7,4,4,15,20.00,0,1,1,2,-50.00,0,2,5,7,-28.57,0,2,10,12,-16.67,2,0,2,100.00,0,0,2,2,0.00
11761,BUL,3,Kolev Nikolay ,MB,3,0,1,-16.67,4,3,0,1,4,75.00,0,4,0,4,-100.00,1,3,6,10,-20.00,0,0,1,1,0.00,0,0,0, ,0,0,0,0, 
11761,BUL,4,Atanasov Martin ,OH,0,0,0, ,0,0,0,0,0, ,0,0,0,0, ,0,0,0,0, ,0,0,0,0, ,0,0,0, ,0,0,0,0, 
11761,BUL,6,Stankov Vladimir ,S,0,0,0,-40.00,0,0,0,1,1,0.00,0,2,0,2,-100.00,0,0,2,2,0.00,0,0,0,0, ,1,1,2,0.00,3,0,19,22,13.64
11761,BUL,9,Seganov Georgi ,S,1,0,0,0.00,1,1,0,0,1,100.00,0,0,0,0, ,0,1,4,5,-20.00,0,0,0,0, ,0,0,0, ,11,0,22,33,33.33
11761,BUL,12,Petrov Georgi ,OH,2,2,0,0.00,4,2,3,0,5,-20.00,2,0,0,2,100.00,0,1,0,1,-100.00,1,4,8,13,-23.08,3,1,5,40.00,0,0,1,1,0.00
11761,BUL,14,Asparuhov Asparuh ,OH,8,0,0,31.58,8,8,1,3,12,58.33,0,1,0,1,-100.00,0,0,6,6,0.00,2,1,7,10,10.00,2,2,4,0.00,0,0,3,3,0.00
11761,BUL,15,Lyutskanov Gordan ,OH,0,0,0,-20.00,0,0,1,1,2,-50.00,0,0,0,0, ,0,0,3,3,0.00,2,0,2,4,50.00,0,0,0, ,0,0,0,0, 
11761,BUL,16,Ivanov Vladislav ,L,0,0,0, ,0,0,0,0,0, ,0,0,0,0, ,0,0,0,0, ,3,2,5,10,10.00,5,4,9,11.11,0,0,2,2,0.00
11761,BUL,19,Sokolov Tsvetan ,O,0,0,0, ,0,0,0,0,0, ,0,0,0,0, ,0,0,0,0, ,0,0,0,0, ,0,0,0, ,0,0,0,0, 
11761,BUL,22,Kartev Nikolay ,MB,1,1,0,-11.76,2,1,1,4,6,0.00,1,1,3,5,0.00,0,2,4,6,-33.33,1,0,0,1,100.00,1,0,1,100.00,0,0,0,0, 
11761,BUL,24,Ivanov Martin ,L,0,0,0, ,0,0,0,0,0, ,0,0,0,0, ,0,0,0,0, ,0,0,2,2,0.00,0,0,0, ,0,0,2,2,0.00
11761,BUL,25,Parapunov Radoslav ,O,7,1,0,4.55,8,7,4,3,14,21.43,1,1,1,3,0.00,0,2,3,5,-40.00,0,0,0,0, ,0,0,0, ,0,0,0,0, 
11761,BUL,26,Ivanov Svetoslav ,OH,2,0,0,0.00,2,2,1,3,6,16.67,0,0,0,0, ,0,1,5,6,-16.67,3,1,6,10,20.00,3,1,4,50.00,0,0,2,2,0.00
11761,BRA,1,Rezende Bruno Mossa ,S,0,0,0, ,0,0,0,0,0, ,0,0,0,0, ,0,0,0,0, ,0,0,0,0, ,0,0,0, ,1,0,3,4,25.00
11761,BRA,5,Borges Almeida Silva Mauricio ,OH,0,0,0, ,0,0,0,0,0, ,0,0,0,0, ,0,0,0,0, ,0,0,0,0, ,0,0,0, ,0,0,0,0, 
11761,BRA,6,Gil Kreling Fernando ,S,0,0,2,0.00,2,0,1,0,1,-100.00,0,1,0,1,-100.00,2,0,8,10,20.00,0,0,0,0, ,1,2,3,-33.33,19,0,26,45,42.22
11761,BRA,8,De Souza Wallace ,O,0,0,0, ,0,0,0,0,0, ,0,0,0,0, ,0,0,0,0, ,0,0,0,0, ,0,0,0, ,0,0,0,0, 
11761,BRA,9,Leal Hidalgo Yoandy ,OH,0,0,0, ,0,0,0,0,0, ,0,0,0,0, ,0,0,0,0, ,0,0,0,0, ,0,0,0, ,0,0,0,0, 
11761,BRA,11,Kavalkievicz Gabriel ,OH,2,0,0,25.00,2,2,1,0,3,33.33,0,0,0,0, ,0,0,1,1,0.00,0,0,1,1,0.00,0,0,0, ,0,0,0,0, 
11761,BRA,12,Santos Isac ,MB,5,0,0,-4.35,5,5,0,2,7,71.43,0,3,3,6,-50.00,0,3,7,10,-30.00,1,0,0,1,100.00,1,1,2,0.00,0,0,0,0, 
11761,BRA,13,De Souza Mauricio Luiz ,MB,0,0,0, ,0,0,0,0,0, ,0,0,0,0, ,0,0,0,0, ,0,0,0,0, ,0,0,0, ,0,0,0,0, 
11761,BRA,14,Correia De Souza Douglas ,OH,7,1,0,3.70,8,7,3,3,13,30.77,1,3,1,5,-40.00,0,1,8,9,-11.11,5,0,5,10,50.00,1,2,3,-33.33,0,0,3,3,0.00
11761,BRA,15,Nascimento Maique Reis ,L,0,0,0, ,0,0,0,0,0, ,0,0,0,0, ,0,0,0,0, ,4,0,9,13,30.77,7,1,9,66.67,0,0,1,1,0.00
11761,BRA,17,Hoss Thales ,L,0,0,0, ,0,0,0,0,0, ,0,0,0,0, ,0,0,0,0, ,0,0,0,0, ,0,0,0, ,0,0,0,0, 
11761,BRA,18,Souza Ricardo Lucarelli ,OH,10,0,5,27.03,15,10,1,1,12,75.00,0,1,1,2,-50.00,5,3,15,23,8.70,2,0,11,13,15.38,6,1,7,71.43,0,0,0,0, 
11761,BRA,21,Souza Alan ,O,9,0,1,20.83,10,9,0,3,12,75.00,0,2,0,2,-100.00,1,3,6,10,-20.00,0,0,0,0, ,2,2,4,0.00,0,0,2,2,0.00
11761,BRA,23,Resende Gualberto Flavio ,MB,5,3,2,22.22,10,5,0,4,9,55.56,3,3,1,7,0.00,2,1,8,11,9.09,0,1,0,1,-100.00,0,1,1,-100.00,0,0,0,0, 
11762,JPN,1,Shimizu Kunihiro ,O,3,1,1,10.53,5,3,2,6,11,9.09,1,1,3,5,0.00,1,0,2,3,33.33,0,0,0,0, ,1,0,2,50.00,0,0,1,1,0.00
11762,JPN,2,Onodera Taishi ,MB,2,1,0,-8.33,3,2,1,4,7,14.29,1,4,0,5,-60.00,0,0,12,12,0.00,2,0,1,3,66.67,2,2,4,0.00,0,0,2,2,0.00
11762,JPN,3,Fujii Naonobu ,S,1,0,0,-10.53,1,1,0,0,1,100.00,0,2,0,2,-100.00,0,1,15,16,-6.25,0,0,0,0, ,5,1,8,50.00,41,1,59,101,39.60
11762,JPN,5,Fukuzawa Tatsuya ,OH,0,0,0, ,0,0,0,0,0, ,0,0,0,0, ,0,0,0,0, ,0,0,0,0, ,0,0,0, ,0,0,0,0, 
11762,JPN,6,Yamauchi Akihiro ,MB,3,1,0,23.53,4,3,0,3,6,50.00,1,0,2,3,33.33,0,0,8,8,0.00,2,0,1,3,66.67,2,0,3,66.67,0,0,1,1,0.00
11762,JPN,12,Sekita Masahiro ,S,0,0,0, ,0,0,0,0,0, ,0,0,0,0, ,0,0,0,0, ,0,0,0,0, ,4,0,4,100.00,5,0,16,21,23.81
11762,JPN,14,Ishikawa Yuki ,OH,19,2,0,4.23,21,19,6,16,41,31.71,2,8,4,14,-42.86,0,4,12,16,-25.00,12,1,20,33,33.33,12,4,18,44.44,0,0,3,3,0.00
11762,JPN,15,Ri Haku ,MB,9,0,1,10.20,10,9,0,2,11,81.82,0,3,16,19,-15.79,1,2,16,19,-5.26,1,0,1,2,50.00,7,0,8,87.50,0,0,0,0, 
11762,JPN,16,Takahashi Kentaro ,MB,2,0,0,-25.00,2,2,0,1,3,66.67,0,2,1,3,-66.67,0,2,0,2,-100.00,0,0,0,0, ,0,0,1,0.00,0,0,0,0, 
11762,JPN,17,Takanashi Kenta ,OH,0,0,0,-100.00,0,0,1,0,1,-100.00,0,0,0,0, ,0,0,0,0, ,1,0,0,1,100.00,0,0,0, ,0,0,0,0, 
11762,JPN,19,Otsuka Tatsunori ,OH,15,1,1,17.54,17,15,3,16,34,35.29,1,1,8,10,0.00,1,3,9,13,-15.38,0,0,3,3,0.00,6,3,9,33.33,0,0,4,4,0.00
11762,JPN,20,Yamamoto Tomohiro ,L,0,0,0, ,0,0,0,0,0, ,0,0,0,0, ,0,0,0,0, ,5,1,11,17,23.53,15,6,22,40.91,0,0,8,8,0.00
11762,JPN,21,Takahashi Ran ,OH,16,0,3,18.18,19,16,4,12,32,37.50,0,3,1,4,-75.00,3,2,14,19,5.26,8,1,11,20,35.00,11,2,16,56.25,0,0,4,4,0.00
11762,JPN,24,Ogawa Tomohiro ,L,0,0,0, ,0,0,0,0,0, ,0,0,0,0, ,0,0,0,0, ,0,0,0,0, ,0,0,0, ,0,0,0,0, 
11762,ITA,1,Gardini Davide ,OH,0,0,0,0.00,0,0,0,3,3,0.00,0,0,0,0, ,0,0,1,1,0.00,0,1,1,2,-50.00,1,0,1,100.00,0,0,1,1,0.00
11762,ITA,7,Balaso Fabio ,L,0,0,0, ,0,0,0,0,0, ,0,0,0,0, ,0,0,0,0, ,7,2,14,23,21.74,18,2,24,66.67,0,0,7,7,0.00
11762,ITA,15,Sbertoli Riccardo ,S,0,0,0,-50.00,0,0,0,0,0, ,0,1,1,2,-50.00,0,0,0,0, ,0,0,0,0, ,0,0,0, ,3,0,10,13,23.08
11762,ITA,18,Michieletto Alessandro ,OH,7,1,0,40.00,8,7,1,3,11,54.55,1,0,0,1,100.00,0,1,2,3,-33.33,1,1,14,16,0.00,2,2,5,0.00,0,0,1,1,0.00
11762,ITA,20,Nelli Gabriele ,O,15,0,1,13.46,16,15,4,12,31,35.48,0,2,3,5,-40.00,1,3,12,16,-12.50,1,0,0,1,100.00,7,1,10,60.00,0,0,3,3,0.00
11762,ITA,21,Spirito Luca ,S,2,2,0,14.29,4,2,0,1,3,66.67,2,1,3,6,16.67,0,0,12,12,0.00,0,0,0,0, ,7,2,11,45.45,29,1,74,104,26.92
11762,ITA,23,Pinali Giulio ,O,0,0,0,-42.86,0,0,1,4,5,-20.00,0,4,1,5,-80.00,0,1,3,4,-25.00,0,0,0,0, ,0,1,1,-100.00,0,0,0,0, 
11762,ITA,24,Cavuto Oreste ,OH,0,0,0,-100.00,0,0,0,0,0, ,0,0,0,0, ,0,1,0,1,-100.00,0,0,0,0, ,0,0,0, ,0,0,0,0, 
11762,ITA,25,Vitelli Marco ,MB,5,2,0,-4.44,7,5,0,7,12,41.67,2,7,8,17,-29.41,0,2,14,16,-12.50,0,0,1,1,0.00,5,1,9,44.44,0,0,3,3,0.00
11762,ITA,26,Cortesia Lorenzo ,MB,2,3,0,-4.17,5,2,1,4,7,14.29,3,4,2,9,-11.11,0,1,7,8,-12.50,0,0,0,0, ,2,0,4,50.00,0,0,1,1,0.00
11762,ITA,28,Recine Francesco ,OH,16,0,0,16.98,16,16,2,16,34,41.18,0,4,3,7,-57.14,0,1,11,12,-8.33,5,0,19,24,20.83,4,1,7,42.86,0,0,1,1,0.00
11762,ITA,29,Bottolo Mattia ,OH,9,4,2,3.92,15,9,4,10,23,21.74,4,6,3,13,-15.38,2,3,10,15,-6.67,2,2,23,27,0.00,3,3,9,0.00,0,0,0,0, 
11762,ITA,30,Mosca Leandro Ausibio ,MB,3,0,0,-9.52,3,3,1,2,6,33.33,0,3,4,7,-42.86,0,1,7,8,-12.50,0,0,0,0, ,0,0,1,0.00,0,0,0,0, 
11762,ITA,31,Federici Filippo ,L,0,0,0, ,0,0,0,0,0, ,0,0,0,0, ,0,0,0,0, ,0,0,0,0, ,0,0,0, ,0,0,0,0, 
11763,POL,1,Nowakowski Piotr ,MB,0,0,0, ,0,0,0,0,0, ,0,0,0,0, ,0,0,0,0, ,0,0,0,0, ,0,0,0, ,0,0,0,0, 
11763,POL,2,Muzaj Maciej ,O,5,1,3,0.00,9,5,5,9,19,0.00,1,2,6,9,-11.11,3,2,7,12,8.33,0,0,0,0, ,4,0,4,100.00,0,0,1,1,0.00
11763,POL,6,Kurek Bartosz ,O,0,0,0, ,0,0,0,0,0, ,0,0,0,0, ,0,0,0,0, ,0,0,0,0, ,0,0,0, ,0,0,0,0, 
11763,POL,10,Wojtaszek Damian ,L,0,0,0, ,0,0,0,0,0, ,0,0,0,0, ,0,0,0,0, ,0,0,0,0, ,0,0,0, ,0,0,0,0, 
11763,POL,11,Drzyzga Fabian ,S,0,0,0, ,0,0,0,0,0, ,0,0,0,0, ,0,0,0,0, ,0,0,0,0, ,0,0,0, ,0,0,0,0, 
11763,POL,12,Lomacz Grzegorz ,S,1,2,0,4.76,3,1,0,0,1,100.00,2,1,2,5,20.00,0,1,14,15,-6.67,0,0,0,0, ,4,0,6,66.67,15,0,35,50,30.00
11763,POL,13,Kubiak Michal ,OH,0,0,0, ,0,0,0,0,0, ,0,0,0,0, ,0,0,0,0, ,0,0,0,0, ,0,0,0, ,0,0,0,0, 
11763,POL,14,Sliwka Aleksander ,OH,11,0,0,20.59,11,11,0,5,16,68.75,0,1,2,3,-33.33,0,3,12,15,-20.00,4,2,8,14,14.29,5,0,5,100.00,0,0,1,1,0.00
11763,POL,16,Semeniuk Kamil ,OH,0,0,0, ,0,0,0,0,0, ,0,0,0,0, ,0,0,0,0, ,0,0,0,0, ,0,0,0, ,0,0,0,0, 
11763,POL,17,Zatorski Pawel ,L,0,0,0, ,0,0,0,0,0, ,0,0,0,0, ,0,0,0,0, ,2,0,3,5,40.00,9,4,13,38.46,0,0,6,6,0.00
11763,POL,20,Bieniek Mateusz ,MB,11,2,3,21.62,16,11,2,2,15,60.00,2,1,6,9,11.11,3,5,5,13,-15.38,0,0,0,0, ,0,0,0, ,0,0,0,0, 
11763,POL,21,Fornal Tomasz ,OH,5,2,2,30.00,9,5,0,2,7,71.43,2,2,0,4,0.00,2,1,6,9,11.11,6,0,8,14,42.86,9,2,12,58.33,0,0,2,2,0.00
11763,POL,77,Klos Karol ,MB,2,2,0,0.00,4,2,1,1,4,25.00,2,1,1,4,25.00,0,2,7,9,-22.22,0,0,0,0, ,0,1,1,-100.00,0,0,0,0, 
11763,POL,99,Huber Norbert ,MB,0,0,0, ,0,0,0,0,0, ,0,0,0,0, ,0,0,0,0, ,0,0,0,0, ,0,0,0, ,0,0,0,0, 
11763,NED,2,Keemink Wessel ,S,0,0,0,-25.00,0,0,0,2,2,0.00,0,0,0,0, ,0,1,1,2,-50.00,0,0,0,0, ,1,2,3,-33.33,1,0,14,15,6.67
11763,NED,5,van der Ent Luuc ,MB,0,0,0, ,0,0,0,0,0, ,0,0,0,0, ,0,0,0,0, ,0,0,0,0, ,0,0,0, ,0,0,0,0, 
11763,NED,6,Dronkers Just ,L,0,0,0, ,0,0,0,0,0, ,0,0,0,0, ,0,0,0,0, ,0,0,0,0, ,0,0,0, ,0,0,0,0, 
11763,NED,8,Plak Fabian ,MB,1,1,0,-28.57,2,1,2,2,5,-20.00,1,2,0,3,-33.33,0,2,4,6,-33.33,0,0,0,0, ,1,0,1,100.00,0,0,0,0, 
11763,NED,10,van Zeist Maikel ,MB,0,1,1,0.00,2,0,0,1,1,0.00,1,1,1,3,0.00,1,1,1,3,0.00,0,0,0,0, ,1,0,1,100.00,0,0,1,1,0.00
11763,NED,12,Tuinstra Bennie Junior ,OH,3,0,0,-12.00,3,3,2,11,16,6.25,0,1,2,3,-33.33,0,3,3,6,-50.00,4,2,17,23,8.70,4,2,7,28.57,0,0,3,3,0.00
11763,NED,13,Ottevanger Steven ,L,0,0,0, ,0,0,0,0,0, ,0,0,0,0, ,0,0,0,0, ,3,3,10,16,0.00,9,4,14,35.71,0,0,5,5,0.00
11763,NED,14,Abdel-Aziz Nimir ,O,5,0,0,21.43,5,5,1,5,11,36.36,0,0,0,0, ,0,1,2,3,-33.33,0,0,0,0, ,1,0,1,100.00,0,0,0,0, 
11763,NED,15,van Solkema Gijs ,S,1,0,0,-12.50,1,1,0,0,1,100.00,0,2,0,2,-100.00,0,0,5,5,0.00,0,0,1,1,0.00,3,1,5,40.00,8,1,36,45,15.56
11763,NED,17,Parkinson Michael ,MB,0,0,0, ,0,0,0,0,0, ,0,0,0,0, ,0,0,0,0, ,0,0,0,0, ,0,0,0, ,0,0,0,0, 
11763,NED,18,Andringa Robbert ,L,5,0,0,-6.67,5,5,1,3,9,44.44,0,1,0,1,-100.00,0,4,1,5,-80.00,4,1,4,9,33.33,3,1,4,50.00,0,0,3,3,0.00
11763,NED,21,van Schie Stijn ,OH,2,0,0,-21.43,2,2,4,6,12,-16.67,0,0,0,0, ,0,1,1,2,-50.00,0,2,8,10,-20.00,3,0,3,100.00,0,0,0,0, 
11763,NED,22,Wiltenburg Twan ,MB,2,1,0,0.00,3,2,1,1,4,25.00,1,1,0,2,0.00,0,1,8,9,-11.11,0,0,0,0, ,3,0,3,100.00,0,0,2,2,0.00
11763,NED,25,van Tilburg Stijn ,OH,3,0,1,-19.23,4,3,4,7,14,-7.14,0,3,1,4,-75.00,1,2,5,8,-12.50,0,0,0,0, ,1,0,1,100.00,0,0,1,1,0.00
11764,IRI,2,Ebadipour Ghara H. Milad ,OH,7,1,0,-16.22,8,7,7,4,18,0.00,1,1,1,3,0.00,0,6,10,16,-37.50,12,3,12,27,33.33,8,4,13,30.77,0,0,3,3,0.00
11764,IRI,3,Abedini Reza ,MB,0,0,0,-33.33,0,0,0,0,0, ,0,0,1,1,0.00,0,1,1,2,-50.00,0,0,0,0, ,0,0,0, ,0,0,0,0, 
11764,IRI,4,Marouflakrani Mir Saeid ,S,2,0,1,0.00,3,2,0,0,2,100.00,0,1,3,4,-25.00,1,2,15,18,-5.56,0,0,1,1,0.00,7,0,7,100.00,34,2,47,83,38.55
11764,IRI,6,Mousavi Eraghi Seyed Mohammad ,MB,9,1,0,-12.20,10,9,3,4,16,37.50,1,5,5,11,-36.36,0,7,7,14,-50.00,2,0,1,3,66.67,3,0,3,100.00,0,0,1,1,0.00
11764,IRI,7,Fayazi D. Purya ,OH,0,0,0, ,0,0,0,0,0, ,0,0,0,0, ,0,0,0,0, ,0,0,0,0, ,0,0,0, ,0,0,0,0, 
11764,IRI,8,Hazratpourtalatappeh Mohammadreza ,L,0,0,0, ,0,0,0,0,0, ,0,0,0,0, ,0,0,0,0, ,0,0,0,0, ,0,0,0, ,0,0,0,0, 
11764,IRI,9,Gholami Masoud ,MB,5,0,0,-7.14,5,5,2,2,9,33.33,0,3,2,5,-60.00,0,2,12,14,-14.29,1,0,0,1,100.00,2,0,2,100.00,0,0,4,4,0.00
11764,IRI,11,Kazemi Saber ,O,23,2,2,26.67,27,23,3,12,38,52.63,2,2,1,5,0.00,2,6,9,17,-23.53,0,0,0,0, ,5,3,8,25.00,0,0,1,1,0.00
11764,IRI,12,Sharifi Morteza ,OH,0,0,0, ,0,0,0,0,0, ,0,0,0,0, ,0,0,0,0, ,0,0,0,0, ,0,0,0, ,0,0,0,0, 
11764,IRI,17,Salehi Meisam ,OH,12,3,0,2.38,15,12,6,3,21,28.57,3,3,1,7,0.00,0,5,9,14,-35.71,6,1,16,23,21.74,3,2,5,20.00,0,0,1,1,0.00
11764,IRI,18,Vadi Mohammad Taher ,S,0,0,0,0.00,0,0,0,0,0, ,0,0,0,0, ,0,0,1,1,0.00,0,0,0,0, ,0,0,0, ,1,0,3,4,25.00
11764,IRI,21,Salehi Arman ,L,0,0,0, ,0,0,0,0,0, ,0,0,0,0, ,0,0,0,0, ,9,2,13,24,29.17,11,5,16,37.50,0,0,7,7,0.00
11764,IRI,22,Esfandiar Amirhossein ,OH,2,0,2,22.22,4,2,0,0,2,100.00,0,0,0,0, ,2,2,3,7,0.00,0,0,2,2,0.00,1,0,1,100.00,0,0,0,0, 
11764,IRI,23,Saadat Bardia ,O,0,0,0,0.00,0,0,0,0,0, ,0,0,1,1,0.00,0,0,0,0, ,0,0,0,0, ,0,0,0, ,0,0,0,0, 
11764,GER,1,Fromm Christian ,OH,0,0,0, ,0,0,0,0,0, ,0,0,0,0, ,0,0,0,0, ,0,0,0,0, ,0,0,0, ,0,0,0,0, 
11764,GER,3,Schott Ruben ,OH,1,1,1,-14.29,3,1,0,3,4,25.00,1,2,0,3,-33.33,1,3,3,7,-28.57,2,1,2,5,20.00,2,2,4,0.00,0,0,1,1,0.00
11764,GER,5,Reichert Moritz ,OH,7,0,0,0.00,7,7,1,9,17,35.29,0,2,0,2,-100.00,0,4,17,21,-19.05,5,0,8,13,38.46,2,2,6,0.00,0,0,0,0, 
11764,GER,6,Kaliberda Denys ,OH,12,1,0,20.45,13,12,1,10,23,47.83,1,0,4,5,20.00,0,3,13,16,-18.75,3,0,17,20,15.00,6,3,9,33.33,0,0,3,3,0.00
11764,GER,10,Zenger Julian ,L,0,0,0, ,0,0,0,0,0, ,0,0,0,0, ,0,0,0,0, ,12,2,17,31,32.26,13,8,22,22.73,0,0,3,3,0.00
11764,GER,13,Hirsch Simon ,O,0,0,0, ,0,0,0,0,0, ,0,0,0,0, ,0,0,0,0, ,0,0,0,0, ,0,0,0, ,0,0,0,0, 
11764,GER,15,BaxpÃ¶hler Noah ,MB,1,0,0,16.67,1,1,0,2,3,33.33,0,0,1,1,0.00,0,0,2,2,0.00,0,0,0,0, ,0,0,0, ,0,0,0,0, 
11764,GER,16,BurggrÃ¤f Eric ,S,0,0,1,0.00,1,0,0,0,0, ,0,0,0,0, ,1,1,1,3,0.00,0,0,0,0, ,0,0,0, ,0,0,0,0, 
11764,GER,17,Zimmermann Jan ,S,1,2,1,-12.00,4,1,1,0,2,0.00,2,4,0,6,-33.33,1,2,14,17,-5.88,0,1,1,2,-50.00,1,3,4,-50.00,20,0,58,78,25.64
11764,GER,18,Krage Florian ,MB,9,3,1,18.18,13,9,0,1,10,90.00,3,6,0,9,-33.33,1,1,12,14,0.00,0,0,0,0, ,0,0,0, ,0,0,0,0, 
11764,GER,19,RÃ¶hrs Erik ,OH,0,0,0, ,0,0,0,0,0, ,0,0,0,0, ,0,0,0,0, ,0,0,0,0, ,0,0,0, ,0,0,0,0, 
11764,GER,20,Weber Linus ,O,11,2,2,2.13,15,11,6,8,25,20.00,2,0,1,3,66.67,2,8,9,19,-31.58,0,0,0,0, ,5,1,6,66.67,0,0,2,2,0.00
11764,GER,21,Krick Tobias ,MB,5,4,0,0.00,9,5,1,1,7,57.14,4,5,4,13,-7.69,0,3,4,7,-42.86,0,1,0,1,-100.00,2,1,3,33.33,0,0,0,0, 
11764,GER,25,Maase Lukas ,O,0,0,0,0.00,0,0,0,0,0, ,0,0,1,1,0.00,0,0,0,0, ,0,0,0,0, ,0,0,0, ,0,0,1,1,0.00
11765,SLO,1,Å tern TonÄek ,O,5,0,1,-29.41,6,5,8,4,17,-17.65,0,3,2,5,-60.00,1,5,6,12,-33.33,0,0,0,0, ,7,2,9,55.56,0,0,4,4,0.00
11765,SLO,2,Pajenk Alen ,MB,6,1,1,0.00,8,6,1,4,11,45.45,1,2,6,9,-11.11,1,5,10,16,-25.00,0,0,0,0, ,3,0,4,75.00,0,0,1,1,0.00
11765,SLO,4,Kozamernik Jan ,MB,2,2,0,-11.43,4,2,1,3,6,16.67,2,7,8,17,-29.41,0,0,12,12,0.00,0,0,0,0, ,4,2,7,28.57,0,1,3,4,-25.00
11765,SLO,5,Å ket Alen ,O,4,1,1,14.81,6,4,1,2,7,42.86,1,0,3,4,25.00,1,1,14,16,0.00,0,0,0,0, ,1,1,2,0.00,0,0,0,0, 
11765,SLO,6,Gasparini Mitja ,O,0,0,0, ,0,0,0,0,0, ,0,0,0,0, ,0,0,0,0, ,0,0,0,0, ,0,0,0, ,0,0,0,0, 
11765,SLO,9,Vincic Dejan ,S,0,0,0, ,0,0,0,0,0, ,0,0,0,0, ,0,0,0,0, ,0,0,0,0, ,0,0,0, ,0,0,0,0, 
11765,SLO,11,Å tern Å½iga ,OH,0,0,0, ,0,0,0,0,0, ,0,0,0,0, ,0,0,0,0, ,0,0,0,0, ,0,0,0, ,0,0,0,0, 
11765,SLO,12,Klobucar Jan ,L,0,0,0, ,0,0,0,0,0, ,0,0,0,0, ,0,0,0,0, ,1,0,0,1,100.00,0,0,0, ,0,0,0,0, 
11765,SLO,13,KovaÄiÄ Jani ,L,0,0,0, ,0,0,0,0,0, ,0,0,0,0, ,0,0,0,0, ,5,4,14,23,4.35,8,1,9,77.78,0,0,9,9,0.00
11765,SLO,15,VideÄnik Matic ,MB,0,0,0,0.00,0,0,0,0,0, ,0,0,2,2,0.00,0,0,0,0, ,0,0,0,0, ,0,0,0, ,1,0,3,4,25.00
11765,SLO,16,Ropret Gregor ,S,0,2,1,-8.00,3,0,0,1,1,0.00,2,1,5,8,12.50,1,4,11,16,-18.75,0,0,0,0, ,10,2,12,66.67,26,0,67,93,27.96
11765,SLO,17,Urnaut Tine ,OH,18,0,0,7.14,18,18,5,14,37,35.14,0,5,2,7,-71.43,0,4,8,12,-33.33,6,1,19,26,19.23,6,3,10,30.00,0,0,5,5,0.00
11765,SLO,18,Äebulj Klemen ,OH,27,3,2,30.88,32,27,2,11,40,62.50,3,3,3,9,0.00,2,6,11,19,-21.05,5,2,26,33,9.09,8,0,8,100.00,0,0,3,3,0.00
11765,SLO,19,MoÅ¾iÄ Rok ,OH,2,0,0,16.67,2,2,1,0,3,33.33,0,0,1,1,0.00,0,0,2,2,0.00,0,0,3,3,0.00,2,1,3,33.33,0,0,0,0, 
11765,RUS,1,Podlesnykh Yaroslav ,OH,0,0,0, ,0,0,0,0,0, ,0,0,0,0, ,0,0,0,0, ,0,0,0,0, ,0,0,0, ,0,0,0,0, 
11765,RUS,2,Vlasov Ilia ,MB,1,2,0,-18.18,3,1,1,5,7,0.00,2,5,2,9,-33.33,0,1,5,6,-16.67,0,0,0,0, ,2,0,3,66.67,0,0,0,0, 
11765,RUS,4,Volvich Artem ,MB,5,4,0,2.86,9,5,1,0,6,66.67,4,6,5,15,-13.33,0,1,13,14,-7.14,0,0,1,1,0.00,1,0,1,100.00,0,1,0,1,-100.00
11765,RUS,5,Semyshev Anton ,OH,0,0,0, ,0,0,0,0,0, ,0,0,0,0, ,0,0,0,0, ,0,0,0,0, ,0,0,0, ,0,0,0,0, 
11765,RUS,6,Baranov Evgeny ,L,0,0,0, ,0,0,0,0,0, ,0,0,0,0, ,0,0,0,0, ,7,2,13,22,22.73,7,1,8,75.00,0,0,3,3,0.00
11765,RUS,7,Volkov Dmitry ,OH,14,0,2,10.00,16,14,6,8,28,28.57,0,1,1,2,-50.00,2,4,14,20,-10.00,3,2,16,21,4.76,9,2,12,58.33,0,1,4,5,-20.00
11765,RUS,10,Bogdan Denis ,OH,2,1,1,25.00,4,2,0,3,5,40.00,1,0,0,1,100.00,1,1,4,6,0.00,4,1,6,11,27.27,2,0,2,100.00,0,0,2,2,0.00
11765,RUS,11,Pankov Pavel ,S,0,1,0,0.00,1,0,0,0,0, ,1,1,3,5,0.00,0,0,2,2,0.00,0,0,0,0, ,5,0,6,83.33,5,1,23,29,13.79
11765,RUS,15,Poletaev Victor ,O,6,0,0,-6.90,6,6,2,5,13,30.77,0,4,2,6,-66.67,0,2,8,10,-20.00,0,0,0,0, ,2,0,2,100.00,0,0,0,0, 
11765,RUS,17,Mikhaylov Maxim ,O,7,1,2,2.86,10,7,3,9,19,21.05,1,3,1,5,-40.00,2,3,6,11,-9.09,0,0,0,0, ,5,1,6,66.67,0,0,2,2,0.00
11765,RUS,18,Kliuka Egor ,OH,7,4,0,4.65,11,7,3,14,24,16.67,4,3,2,9,11.11,0,3,7,10,-30.00,4,1,20,25,12.00,2,2,4,0.00,0,0,4,4,0.00
11765,RUS,20,Kurkaev Ilyas ,MB,5,1,0,11.76,6,5,1,2,8,50.00,1,2,1,4,-25.00,0,1,4,5,-20.00,0,0,0,0, ,0,1,1,-100.00,0,0,0,0, 
11765,RUS,24,Kobzar Igor ,S,0,0,2,-11.54,2,0,0,0,0, ,0,5,3,8,-62.50,2,0,16,18,11.11,0,0,0,0, ,3,2,9,11.11,20,0,44,64,31.25
11765,RUS,27,Golubev Valentin ,L,0,0,0, ,0,0,0,0,0, ,0,0,0,0, ,0,0,0,0, ,0,0,0,0, ,0,0,0, ,0,0,0,0, 
11766,JPN,1,Shimizu Kunihiro ,O,5,0,0,41.67,5,5,0,3,8,62.50,0,0,1,1,0.00,0,0,3,3,0.00,0,0,0,0, ,1,1,3,0.00,0,0,0,0, 
11766,JPN,2,Onodera Taishi ,MB,0,0,0, ,0,0,0,0,0, ,0,0,0,0, ,0,0,0,0, ,0,0,0,0, ,0,0,0, ,0,0,0,0, 
11766,JPN,3,Fujii Naonobu ,S,0,0,0, ,0,0,0,0,0, ,0,0,0,0, ,0,0,0,0, ,0,0,0,0, ,0,0,0, ,0,0,0,0, 
11766,JPN,4,Otake Issei ,O,15,0,0,15.22,15,15,2,15,32,40.62,0,2,3,5,-40.00,0,4,5,9,-44.44,0,0,0,0, ,8,3,13,38.46,0,0,2,2,0.00
11766,JPN,5,Fukuzawa Tatsuya ,OH,12,0,0,-2.08,12,12,10,10,32,6.25,0,2,2,4,-50.00,0,1,11,12,-8.33,6,2,17,25,16.00,7,1,8,75.00,0,0,4,4,0.00
11766,JPN,6,Yamauchi Akihiro ,MB,9,2,0,2.86,11,9,1,3,13,61.54,2,8,1,11,-54.55,0,1,10,11,-9.09,0,0,2,2,0.00,1,0,1,100.00,0,0,1,1,0.00
11766,JPN,12,Sekita Masahiro ,S,0,0,1,-29.17,1,0,1,0,1,-100.00,0,3,1,4,-75.00,1,4,14,19,-15.79,0,0,2,2,0.00,14,5,20,45.00,37,1,78,116,31.03
11766,JPN,14,Ishikawa Yuki ,OH,0,0,0, ,0,0,0,0,0, ,0,0,0,0, ,0,0,0,0, ,0,0,0,0, ,0,0,0, ,0,0,0,0, 
11766,JPN,15,Ri Haku ,MB,2,0,0,-19.35,2,2,0,3,5,40.00,0,6,3,9,-66.67,0,2,15,17,-11.76,1,0,0,1,100.00,4,1,6,50.00,0,0,0,0, 
11766,JPN,16,Takahashi Kentaro ,MB,1,0,0,-12.50,1,1,1,3,5,0.00,0,0,0,0, ,0,1,2,3,-33.33,0,0,0,0, ,0,0,0, ,0,0,1,1,0.00
11766,JPN,19,Otsuka Tatsunori ,OH,10,4,0,10.34,14,10,6,24,40,10.00,4,0,0,4,100.00,0,2,12,14,-14.29,8,2,12,22,27.27,7,2,11,45.45,0,0,5,5,0.00
11766,JPN,20,Yamamoto Tomohiro ,L,0,0,0, ,0,0,0,0,0, ,0,0,0,0, ,0,0,0,0, ,1,0,0,1,100.00,0,0,0, ,0,0,0,0, 
11766,JPN,21,Takahashi Ran ,OH,0,0,0, ,0,0,0,0,0, ,0,0,0,0, ,0,0,0,0, ,0,0,0,0, ,0,0,0, ,0,0,0,0, 
11766,JPN,24,Ogawa Tomohiro ,L,0,0,0, ,0,0,0,0,0, ,0,0,0,0, ,0,0,0,0, ,9,2,26,37,18.92,12,7,20,25.00,0,0,8,8,0.00
11766,ARG,1,Sanchez Matias ,S,0,0,0,0.00,0,0,0,0,0, ,0,0,0,0, ,0,0,1,1,0.00,0,0,0,0, ,0,0,0, ,7,0,6,13,53.85
11766,ARG,2,Pereyra Federico ,O,18,2,2,14.29,22,18,6,12,36,33.33,2,3,6,11,-9.09,2,4,10,16,-12.50,0,0,0,0, ,5,0,5,100.00,0,0,2,2,0.00
11766,ARG,3,Martinez Franchi Jan ,OH,0,0,0, ,0,0,0,0,0, ,0,0,0,0, ,0,0,0,0, ,0,0,0,0, ,0,0,0, ,0,0,0,0, 
11766,ARG,5,Uriarte Nicolas ,S,0,0,0,-100.00,0,0,0,0,0, ,0,0,0,0, ,0,1,0,1,-100.00,0,0,0,0, ,0,0,0, ,0,0,0,0, 
11766,ARG,6,Poglajen Cristian ,OH,12,1,1,21.74,14,12,2,11,25,40.00,1,2,5,8,-12.50,1,0,12,13,7.69,11,1,11,23,43.48,10,1,12,75.00,0,0,8,8,0.00
11766,ARG,7,Conte Facundo ,OH,9,3,0,0.00,12,9,6,17,32,9.38,3,4,0,7,-14.29,0,2,15,17,-11.76,7,0,17,24,29.17,8,7,16,6.25,0,0,4,4,0.00
11766,ARG,8,Loser Agustin ,MB,9,1,2,13.16,12,9,0,3,12,75.00,1,5,2,8,-50.00,2,2,14,18,0.00,0,0,3,3,0.00,2,0,3,66.67,0,0,2,2,0.00
11766,ARG,11,SolÃ© Sebastian ,MB,11,1,0,9.26,12,11,1,5,17,58.82,1,4,13,18,-16.67,0,2,17,19,-10.53,2,0,1,3,66.67,6,2,8,50.00,0,0,0,0, 
11766,ARG,13,Palacios Ezequiel ,OH,0,0,0, ,0,0,0,0,0, ,0,0,0,0, ,0,0,0,0, ,0,0,0,0, ,0,0,0, ,0,0,0,0, 
11766,ARG,15,De Cecco Luciano ,S,1,1,1,-8.70,3,1,0,1,2,50.00,1,2,1,4,-25.00,1,3,13,17,-11.76,0,0,0,0, ,10,4,16,37.50,41,0,52,93,44.09
11766,ARG,16,Palonsky Luciano ,OH,1,0,0,-16.67,1,1,1,1,3,0.00,0,1,0,1,-100.00,0,0,2,2,0.00,0,0,0,0, ,0,0,0, ,0,0,0,0, 
11766,ARG,17,Mendez Nicolas ,OH,0,0,0, ,0,0,0,0,0, ,0,0,0,0, ,0,0,0,0, ,0,0,0,0, ,0,0,0, ,0,0,0,0, 
11766,ARG,18,Ramos Martin ,MB,0,0,0, ,0,0,0,0,0, ,0,0,0,0, ,0,0,0,0, ,0,0,0,0, ,0,0,0, ,0,0,0,0, 
11766,ARG,19,Massimino Franco ,L,0,0,0, ,0,0,0,0,0, ,0,0,0,0, ,0,0,0,0, ,9,0,11,20,45.00,13,5,20,40.00,0,0,1,1,0.00
11767,NED,2,Keemink Wessel ,S,0,0,0, ,0,0,0,0,0, ,0,0,0,0, ,0,0,0,0, ,0,0,0,0, ,0,0,0, ,2,0,4,6,33.33
11767,NED,5,van der Ent Luuc ,MB,3,0,0,-5.88,3,3,0,0,3,100.00,0,3,4,7,-42.86,0,1,6,7,-14.29,0,0,1,1,0.00,1,2,3,-33.33,0,0,0,0, 
11767,NED,6,Dronkers Just ,L,0,0,0, ,0,0,0,0,0, ,0,0,0,0, ,0,0,0,0, ,11,4,16,31,22.58,12,3,16,56.25,0,0,4,4,0.00
11767,NED,8,Plak Fabian ,MB,12,1,0,14.71,13,12,0,1,13,92.31,1,6,1,8,-62.50,0,2,11,13,-15.38,0,0,1,1,0.00,3,0,3,100.00,0,0,0,0, 
11767,NED,10,van Zeist Maikel ,MB,0,0,0, ,0,0,0,0,0, ,0,0,0,0, ,0,0,0,0, ,0,0,0,0, ,0,0,0, ,0,0,0,0, 
11767,NED,12,Tuinstra Bennie Junior ,OH,12,0,1,2.22,13,12,4,9,25,32.00,0,2,1,3,-66.67,1,6,10,17,-29.41,4,1,25,30,10.00,4,3,8,12.50,0,0,5,5,0.00
11767,NED,13,Ottevanger Steven ,L,0,0,0, ,0,0,0,0,0, ,0,0,0,0, ,0,0,0,0, ,0,0,0,0, ,0,0,0, ,0,0,0,0, 
11767,NED,14,Abdel-Aziz Nimir ,O,25,0,4,21.88,29,25,7,6,38,47.37,0,1,3,4,-25.00,4,7,11,22,-13.64,0,1,0,1,-100.00,4,2,7,28.57,0,0,3,3,0.00
11767,NED,17,Parkinson Michael ,MB,1,0,0,-12.50,1,1,0,1,2,50.00,0,1,1,2,-50.00,0,1,3,4,-25.00,0,0,0,0, ,1,0,1,100.00,0,0,0,0, 
11767,NED,18,Andringa Robbert ,L,11,2,4,12.24,17,11,4,9,24,29.17,2,2,2,6,0.00,4,5,10,19,-5.26,4,1,13,18,16.67,6,1,8,62.50,0,0,1,1,0.00
11767,NED,19,de Weijer Freek ,S,0,1,0,-25.00,1,0,0,1,1,0.00,1,4,2,7,-42.86,0,2,10,12,-16.67,0,0,2,2,0.00,4,6,10,-20.00,27,0,62,89,30.34
11767,NED,21,van Schie Stijn ,OH,0,0,0, ,0,0,0,0,0, ,0,0,0,0, ,0,0,0,0, ,0,0,0,0, ,0,0,0, ,0,0,0,0, 
11767,NED,22,Wiltenburg Twan ,MB,0,1,1,6.25,2,0,0,2,2,0.00,1,1,3,5,0.00,1,0,8,9,11.11,0,0,0,0, ,0,0,0, ,0,0,0,0, 
11767,NED,25,van Tilburg Stijn ,OH,2,0,0,25.00,2,2,1,0,3,33.33,0,0,0,0, ,0,0,1,1,0.00,0,0,0,0, ,0,1,1,-100.00,0,0,0,0, 
11767,BUL,1,Karyagin Denis ,O,14,0,1,35.14,15,14,1,9,24,54.17,0,1,2,3,-33.33,1,0,9,10,10.00,0,0,0,0, ,0,3,3,-100.00,0,0,1,1,0.00
11767,BUL,3,Kolev Nikolay ,MB,7,1,0,6.45,8,7,0,1,8,87.50,1,6,4,11,-45.45,0,0,12,12,0.00,0,0,0,0, ,2,0,3,66.67,0,0,1,1,0.00
11767,BUL,4,Atanasov Martin ,OH,0,0,0, ,0,0,0,0,0, ,0,0,0,0, ,0,0,0,0, ,0,0,0,0, ,0,0,0, ,0,0,0,0, 
11767,BUL,6,Stankov Vladimir ,S,0,0,0,-50.00,0,0,0,0,0, ,0,0,1,1,0.00,0,1,0,1,-100.00,0,0,0,0, ,1,0,2,50.00,3,0,5,8,37.50
11767,BUL,9,Seganov Georgi ,S,2,1,3,13.64,6,2,0,0,2,100.00,1,2,1,4,-25.00,3,1,12,16,12.50,0,0,0,0, ,7,0,7,100.00,26,2,45,73,32.88
11767,BUL,12,Petrov Georgi ,OH,0,0,0,-100.00,0,0,1,0,1,-100.00,0,2,0,2,-100.00,0,1,0,1,-100.00,1,1,0,2,0.00,0,0,0, ,0,0,0,0, 
11767,BUL,14,Asparuhov Asparuh ,OH,9,2,1,11.63,12,9,2,9,20,35.00,2,2,3,7,0.00,1,3,12,16,-12.50,7,5,21,33,6.06,7,4,11,27.27,0,0,4,4,0.00
11767,BUL,15,Lyutskanov Gordan ,OH,0,0,0,-25.00,0,0,0,0,0, ,0,0,0,0, ,0,1,3,4,-25.00,0,0,0,0, ,0,1,1,-100.00,0,0,0,0, 
11767,BUL,16,Ivanov Vladislav ,L,0,0,0, ,0,0,0,0,0, ,0,0,0,0, ,0,0,0,0, ,5,3,16,24,8.33,9,6,16,18.75,0,0,10,10,0.00
11767,BUL,19,Sokolov Tsvetan ,O,0,0,0, ,0,0,0,0,0, ,0,0,0,0, ,0,0,0,0, ,0,0,0,0, ,0,0,0, ,0,0,0,0, 
11767,BUL,22,Kartev Nikolay ,MB,6,1,0,-5.41,7,6,0,4,10,60.00,1,6,6,13,-38.46,0,3,11,14,-21.43,0,0,0,0, ,1,0,1,100.00,0,0,0,0, 
11767,BUL,24,Ivanov Martin ,L,0,0,0, ,0,0,0,0,0, ,0,0,0,0, ,0,0,0,0, ,0,0,0,0, ,0,0,0, ,0,0,0,0, 
11767,BUL,25,Parapunov Radoslav ,O,7,1,0,-6.67,8,7,2,7,16,31.25,1,4,2,7,-42.86,0,4,3,7,-57.14,0,0,0,0, ,2,2,4,0.00,0,0,1,1,0.00
11767,BUL,26,Ivanov Svetoslav ,OH,8,3,2,13.33,13,8,4,9,21,19.05,3,2,1,6,16.67,2,1,15,18,5.56,5,1,15,21,19.05,3,2,6,16.67,0,0,2,2,0.00
11768,AUS,1,Graham Beau ,MB,5,0,0,-4.55,5,5,5,3,13,0.00,0,1,2,3,-33.33,0,0,6,6,0.00,0,0,0,0, ,2,2,4,0.00,0,0,0,0, 
11768,AUS,2,Dosanjh Arshdeep ,S,3,1,0,-4.76,4,3,0,1,4,75.00,1,1,5,7,0.00,0,4,6,10,-40.00,0,0,0,0, ,2,1,4,25.00,13,1,47,61,19.67
11768,AUS,3,Macdonald Steven ,MB,0,0,0, ,0,0,0,0,0, ,0,0,0,0, ,0,0,0,0, ,0,0,0,0, ,0,0,0, ,0,0,0,0, 
11768,AUS,7,Weir James ,MB,0,0,0, ,0,0,0,0,0, ,0,0,0,0, ,0,0,0,0, ,0,0,0,0, ,0,0,0, ,0,0,0,0, 
11768,AUS,8,O'Dea Trent ,MB,4,2,0,10.00,6,4,2,2,8,25.00,2,2,1,5,0.00,0,0,7,7,0.00,0,0,0,0, ,0,2,3,-66.67,0,0,5,5,0.00
11768,AUS,11,Perry Luke ,L,0,0,0, ,0,0,0,0,0, ,0,0,0,0, ,0,0,0,0, ,2,0,11,13,15.38,10,1,13,69.23,0,0,9,9,0.00
11768,AUS,12,Mote Nehemiah ,MB,7,1,0,0.00,8,7,1,5,13,46.15,1,5,4,10,-40.00,0,2,10,12,-16.67,0,0,2,2,0.00,3,2,5,20.00,1,1,0,2,0.00
11768,AUS,15,Smith Luke ,OH,8,0,1,9.68,9,8,2,8,18,33.33,0,2,1,3,-66.67,1,2,7,10,-10.00,9,0,15,24,37.50,5,3,8,25.00,1,0,5,6,16.67
11768,AUS,21,Butler Nicholas ,S,0,0,0, ,0,0,0,0,0, ,0,0,0,0, ,0,0,0,0, ,0,0,0,0, ,0,0,0, ,0,0,0,0, 
11768,AUS,27,Senica Max ,OH,1,0,0,-22.22,1,1,3,2,6,-33.33,0,0,0,0, ,0,0,3,3,0.00,3,0,5,8,37.50,0,2,2,-100.00,1,0,0,1,100.00
11768,AUS,28,Taylor Tim ,OH,4,0,0,0.00,4,4,1,5,10,30.00,0,2,0,2,-100.00,0,1,5,6,-16.67,1,3,8,12,-16.67,4,0,4,100.00,0,0,1,1,0.00
11768,AUS,31,Aubrey Matthew ,O,0,0,0,-100.00,0,0,0,0,0, ,0,0,0,0, ,0,1,0,1,-100.00,0,0,0,0, ,0,0,0, ,0,0,0,0, 
11768,AUS,32,Azeez Oluwatobi Elliot ,OH,1,0,0,0.00,1,1,1,5,7,0.00,0,0,1,1,0.00,0,0,2,2,0.00,0,0,0,0, ,1,0,2,50.00,0,0,0,0, 
11768,AUS,34,Greber Billy ,L,0,0,0, ,0,0,0,0,0, ,0,0,0,0, ,0,0,0,0, ,0,0,0,0, ,0,0,0, ,0,0,0,0, 
11768,ITA,1,Gardini Davide ,OH,0,0,0, ,0,0,0,0,0, ,0,0,0,0, ,0,0,0,0, ,0,0,0,0, ,0,0,0, ,0,0,0,0, 
11768,ITA,7,Balaso Fabio ,L,0,0,0, ,0,0,0,0,0, ,0,0,0,0, ,0,0,0,0, ,7,0,7,14,50.00,13,3,16,62.50,0,0,4,4,0.00
11768,ITA,11,Galassi Gianluca ,MB,12,1,0,32.14,13,12,0,2,14,85.71,1,1,1,3,0.00,0,3,8,11,-27.27,0,1,0,1,-100.00,1,1,2,0.00,0,0,0,0, 
11768,ITA,15,Sbertoli Riccardo ,S,1,0,0,-29.41,1,1,0,0,1,100.00,0,4,2,6,-66.67,0,2,8,10,-20.00,0,0,0,0, ,2,0,2,100.00,25,0,45,70,35.71
11768,ITA,18,Michieletto Alessandro ,OH,9,2,2,15.79,13,9,4,7,20,25.00,2,0,2,4,50.00,2,3,9,14,-7.14,6,0,7,13,46.15,7,1,8,75.00,0,0,1,1,0.00
11768,ITA,21,Spirito Luca ,S,0,0,0, ,0,0,0,0,0, ,0,0,0,0, ,0,0,0,0, ,0,0,0,0, ,0,0,0, ,0,0,0,0, 
11768,ITA,23,Pinali Giulio ,O,11,1,1,18.42,13,11,1,6,18,55.56,1,3,2,6,-33.33,1,2,11,14,-7.14,0,0,0,0, ,4,4,10,0.00,0,0,0,0, 
11768,ITA,24,Cavuto Oreste ,OH,6,0,0,0.00,6,6,1,8,15,33.33,0,1,1,2,-50.00,0,4,7,11,-36.36,1,0,18,19,5.26,5,3,8,25.00,0,0,2,2,0.00
11768,ITA,25,Vitelli Marco ,MB,0,0,0,-50.00,0,0,0,0,0, ,0,0,0,0, ,0,1,1,2,-50.00,0,0,0,0, ,0,0,0, ,0,0,0,0, 
11768,ITA,26,Cortesia Lorenzo ,MB,0,0,0, ,0,0,0,0,0, ,0,0,0,0, ,0,0,0,0, ,0,0,0,0, ,0,0,0, ,0,0,0,0, 
11768,ITA,28,Recine Francesco ,OH,0,0,0, ,0,0,0,0,0, ,0,0,0,0, ,0,0,0,0, ,0,0,0,0, ,0,0,0, ,0,0,0,0, 
11768,ITA,29,Bottolo Mattia ,OH,0,0,0, ,0,0,0,0,0, ,0,0,0,0, ,0,0,0,0, ,0,0,0,0, ,0,0,0, ,0,0,0,0, 
11768,ITA,30,Mosca Leandro Ausibio ,MB,5,1,0,20.83,6,5,1,2,8,50.00,1,0,3,4,25.00,0,0,12,12,0.00,0,0,0,0, ,0,1,1,-100.00,0,0,0,0, 
11768,ITA,31,Federici Filippo ,L,0,0,0, ,0,0,0,0,0, ,0,0,0,0, ,0,0,0,0, ,0,0,0,0, ,0,0,0, ,0,0,0,0, 
11769,USA,1,Anderson Matthew ,O,7,2,0,16.00,9,7,3,5,15,26.67,2,1,1,4,25.00,0,1,5,6,-16.67,0,0,1,1,0.00,3,2,5,20.00,0,0,1,1,0.00
11769,USA,3,Sander Taylor ,OH,0,0,0, ,0,0,0,0,0, ,0,0,0,0, ,0,0,0,0, ,0,0,0,0, ,0,0,0, ,0,0,0,0, 
11769,USA,6,Stahl Mitchell ,MB,0,0,0, ,0,0,0,0,0, ,0,0,0,0, ,0,0,0,0, ,0,0,0,0, ,0,0,0, ,0,0,0,0, 
11769,USA,7,Shoji Kawika ,S,0,0,0, ,0,0,0,0,0, ,0,0,0,0, ,0,0,0,0, ,0,0,0,0, ,0,0,0, ,1,0,4,5,20.00
11769,USA,8,Defalco Torey ,OH,20,2,0,32.61,22,20,1,9,30,63.33,2,2,0,4,0.00,0,4,8,12,-33.33,7,1,12,20,30.00,4,3,7,14.29,0,0,5,5,0.00
11769,USA,12,Holt Maxwell ,MB,3,2,2,-3.23,7,3,2,4,9,11.11,2,4,1,7,-28.57,2,2,11,15,0.00,2,0,0,2,100.00,1,0,1,100.00,0,0,2,2,0.00
11769,USA,13,Patch Benjamin ,O,10,0,1,12.00,11,10,2,2,14,57.14,0,3,0,3,-100.00,1,3,4,8,-25.00,0,0,0,0, ,2,2,4,0.00,0,0,1,1,0.00
11769,USA,15,Sander Brenden ,OH,5,0,0,-13.04,5,5,4,6,15,6.67,0,1,0,1,-100.00,0,3,4,7,-42.86,5,3,7,15,13.33,0,3,3,-100.00,0,0,1,1,0.00
11769,USA,16,Tuaniga Joshua ,S,2,0,0,-24.00,2,2,1,1,4,25.00,0,3,1,4,-75.00,0,4,13,17,-23.53,0,0,0,0, ,4,1,5,60.00,25,0,63,88,28.41
11769,USA,18,Muagututia Garrett ,OH,4,1,0,4.35,5,4,1,7,12,25.00,1,1,0,2,0.00,0,2,7,9,-22.22,12,1,5,18,61.11,2,2,4,0.00,0,0,0,0, 
11769,USA,19,Averill Taylor ,MB,0,0,0, ,0,0,0,0,0, ,0,0,0,0, ,0,0,0,0, ,0,0,0,0, ,0,0,0, ,0,0,0,0, 
11769,USA,20,Smith David ,MB,4,1,4,9.68,9,4,1,4,9,33.33,1,3,1,5,-40.00,4,2,11,17,11.76,1,0,3,4,25.00,1,1,2,0.00,0,0,0,0, 
11769,USA,21,Watten Dustin ,L,0,0,0, ,0,0,0,0,0, ,0,0,0,0, ,0,0,0,0, ,0,0,0,0, ,0,0,0, ,0,0,0,0, 
11769,USA,22,Shoji Erik ,L,0,0,0, ,0,0,0,0,0, ,0,0,0,0, ,0,0,0,0, ,12,0,10,22,54.55,1,5,6,-66.67,0,0,3,3,0.00
11769,SRB,2,Kovacevic Uros ,OH,20,2,0,24.49,22,20,5,8,33,45.45,2,2,2,6,0.00,0,3,7,10,-30.00,8,2,18,28,21.43,1,5,6,-66.67,0,0,0,0, 
11769,SRB,3,Kapur Milorad ,L,0,0,0, ,0,0,0,0,0, ,0,0,0,0, ,0,0,0,0, ,0,0,0,0, ,1,3,4,-50.00,0,0,1,1,0.00
11769,SRB,6,Pekovic Nikola ,L,0,0,0, ,0,0,0,0,0, ,0,0,0,0, ,0,0,0,0, ,2,2,19,23,0.00,2,3,6,-16.67,0,0,4,4,0.00
11769,SRB,7,Krsmanovic Petar ,MB,7,2,0,5.71,9,7,1,2,10,60.00,2,5,1,8,-37.50,0,1,16,17,-5.88,0,0,0,0, ,1,2,3,-33.33,0,0,1,1,0.00
11769,SRB,8,Ivovic Marko ,OH,9,2,3,21.43,14,9,0,7,16,56.25,2,3,1,6,-16.67,3,2,15,20,5.00,9,2,3,14,50.00,6,4,11,18.18,0,0,2,2,0.00
11769,SRB,9,Jovovic Nikola ,S,0,1,0,0.00,1,0,0,0,0, ,1,1,0,2,0.00,0,0,16,16,0.00,0,0,2,2,0.00,4,3,7,14.29,19,0,60,79,24.05
11769,SRB,10,KujundÅ¾iÄ Miran ,OH,0,0,0, ,0,0,0,0,0, ,0,0,0,0, ,0,0,0,0, ,0,0,0,0, ,0,0,0, ,0,0,0,0, 
11769,SRB,12,Peric Pavle ,OH,0,0,0, ,0,0,0,0,0, ,0,0,0,0, ,0,0,0,0, ,0,0,0,0, ,0,0,0, ,0,0,0,0, 
11769,SRB,13,Simic Stevan ,MB,0,0,0, ,0,0,0,0,0, ,0,0,0,0, ,0,0,0,0, ,0,0,0,0, ,0,0,0, ,0,0,0,0, 
11769,SRB,14,Atanasijevic Aleksandar ,O,15,0,2,10.64,17,15,5,7,27,37.04,0,3,2,5,-60.00,2,4,9,15,-13.33,0,1,0,1,-100.00,4,6,10,-20.00,0,0,1,1,0.00
11769,SRB,16,Luburic Drazen ,O,0,0,0, ,0,0,0,0,0, ,0,0,0,0, ,0,0,0,0, ,0,0,0,0, ,0,0,0, ,0,0,0,0, 
11769,SRB,18,Podrascanin Marko ,MB,4,4,0,3.12,8,4,1,2,7,42.86,4,3,1,8,12.50,0,3,14,17,-17.65,0,0,1,1,0.00,1,1,2,0.00,0,0,0,0, 
11769,SRB,21,Todorovic Vuk ,S,0,0,0, ,0,0,0,0,0, ,0,0,0,0, ,0,0,0,0, ,0,0,0,0, ,0,0,0, ,0,0,0,0, 
11769,SRB,26,Kovac Davide ,OH,0,0,0, ,0,0,0,0,0, ,0,0,0,0, ,0,0,0,0, ,0,0,1,1,0.00,0,0,0, ,0,0,0,0, 
11770,CAN,1,Sanders Tyler ,S,1,3,0,0.00,4,1,0,1,2,50.00,3,3,2,8,0.00,0,1,12,13,-7.69,0,0,0,0, ,7,1,8,75.00,26,2,73,101,23.76
11770,CAN,2,Perrin John Gordon ,OH,12,2,1,7.69,15,12,6,12,30,20.00,2,1,4,7,14.29,1,4,10,15,-20.00,8,1,16,25,28.00,5,1,6,66.67,0,0,4,4,0.00
11770,CAN,3,Marshall Steven ,OH,0,0,0, ,0,0,0,0,0, ,0,0,0,0, ,0,0,0,0, ,14,1,14,29,44.83,14,2,18,66.67,0,0,3,3,0.00
11770,CAN,4,Hoag Nicholas ,OH,3,0,0,9.09,3,3,1,3,7,28.57,0,0,1,1,0.00,0,1,2,3,-33.33,0,0,1,1,0.00,1,1,2,0.00,0,0,0,0, 
11770,CAN,6,Pereira Jordan ,OH,0,0,0, ,0,0,0,0,0, ,0,0,0,0, ,0,0,0,0, ,0,0,0,0, ,0,0,0, ,0,0,0,0, 
11770,CAN,8,Blankenau Jay ,S,0,0,0, ,0,0,0,0,0, ,0,0,0,0, ,0,0,0,0, ,0,0,0,0, ,0,0,0, ,0,0,0,0, 
11770,CAN,10,Sclater Ryan Joseph ,O,11,0,0,-8.33,11,11,7,12,30,13.33,0,5,3,8,-62.50,0,3,7,10,-30.00,0,0,0,0, ,8,4,12,33.33,0,0,4,4,0.00
11770,CAN,11,Jansen Vandoorn Daniel ,MB,5,1,0,-16.67,6,5,3,1,9,22.22,1,4,5,10,-30.00,0,3,2,5,-60.00,1,0,1,2,50.00,2,1,3,33.33,0,0,0,0, 
11770,CAN,12,Van Berkel Lucas ,MB,2,3,0,-7.14,5,2,2,2,6,0.00,3,3,1,7,0.00,0,2,13,15,-13.33,0,0,0,0, ,3,0,3,100.00,0,0,0,0, 
11770,CAN,13,Vernon-Evans Sharone ,O,0,0,0, ,0,0,0,0,0, ,0,0,0,0, ,0,0,0,0, ,0,0,0,0, ,0,0,0, ,0,0,0,0, 
11770,CAN,14,Loeppky Eric ,OH,17,0,0,7.02,17,17,5,11,33,36.36,0,6,1,7,-85.71,0,2,15,17,-11.76,7,2,18,27,18.52,7,1,10,60.00,0,0,4,4,0.00
11770,CAN,20,Szwarc Arthur ,O,0,0,0, ,0,0,0,0,0, ,0,0,0,0, ,0,0,0,0, ,0,0,0,0, ,0,0,0, ,0,0,0,0, 
11770,CAN,21,Walsh Brett James ,S,0,0,0, ,0,0,0,0,0, ,0,0,0,0, ,0,0,0,0, ,0,0,0,0, ,0,0,0, ,1,0,5,6,16.67
11770,CAN,23,Demyanenko Danny ,MB,1,0,0,-13.33,1,1,1,1,3,0.00,0,1,3,4,-25.00,0,1,7,8,-12.50,0,0,0,0, ,0,0,0, ,0,0,0,0, 
11770,FRA,1,Chinenyeze BarthÃ©lÃ©my ,MB,3,2,0,-5.71,5,3,1,5,9,22.22,2,6,2,10,-40.00,0,0,16,16,0.00,0,0,0,0, ,2,1,3,33.33,1,0,4,5,20.00
11770,FRA,2,Grebennikov Jenia ,L,0,0,0, ,0,0,0,0,0, ,0,0,0,0, ,0,0,0,0, ,8,0,16,24,33.33,8,4,12,33.33,0,0,7,7,0.00
11770,FRA,4,Patry Jean ,O,13,0,0,21.95,13,13,2,9,24,45.83,0,0,4,4,0.00,0,2,11,13,-15.38,0,0,0,0, ,3,1,5,40.00,0,0,5,5,0.00
11770,FRA,6,Toniutti Benjamin ,S,0,0,0,-10.00,0,0,0,0,0, ,0,1,1,2,-50.00,0,0,8,8,0.00,0,0,0,0, ,4,1,7,42.86,9,1,31,41,19.51
11770,FRA,7,Tillie Kevin ,OH,13,4,0,26.53,17,13,2,15,30,36.67,4,1,4,9,33.33,0,1,9,10,-10.00,12,1,9,22,50.00,7,1,8,75.00,0,0,2,2,0.00
11770,FRA,8,Lyneel Julien ,OH,1,1,1,-6.67,3,1,3,3,7,-28.57,1,0,0,1,100.00,1,1,5,7,0.00,4,0,9,13,30.77,2,5,7,-42.86,0,0,1,1,0.00
11770,FRA,11,Brizard Antoine ,S,1,0,0,-23.08,1,1,0,0,1,100.00,0,1,1,2,-50.00,0,3,7,10,-30.00,0,0,0,0, ,7,2,11,45.45,9,1,36,46,17.39
11770,FRA,14,Le Goff Nicolas ,MB,0,0,0, ,0,0,0,0,0, ,0,0,0,0, ,0,0,0,0, ,0,0,0,0, ,0,0,0, ,0,0,0,0, 
11770,FRA,16,Bultor Daryl ,MB,4,2,2,6.06,8,4,2,2,8,25.00,2,2,2,6,0.00,2,2,15,19,0.00,0,0,0,0, ,2,1,3,33.33,0,0,0,0, 
11770,FRA,17,Clevenot Trevor ,OH,7,4,1,27.59,12,7,3,4,14,28.57,4,1,1,6,50.00,1,0,8,9,11.11,3,0,7,10,30.00,4,2,6,33.33,0,0,3,3,0.00
11770,FRA,19,Louati Yacine ,OH,0,0,0, ,0,0,0,0,0, ,0,0,0,0, ,0,0,0,0, ,0,0,0,0, ,0,0,0, ,0,0,0,0, 
11770,FRA,20,Diez Benjamin ,L,0,0,0, ,0,0,0,0,0, ,0,0,0,0, ,0,0,0,0, ,0,0,0,0, ,0,0,0, ,0,0,0,0, 
11770,FRA,21,Faure ThÃ©o ,O,4,1,0,-10.53,5,4,5,4,13,-7.69,1,1,2,4,0.00,0,1,1,2,-50.00,0,0,0,0, ,0,2,2,-100.00,0,0,0,0, 
11770,FRA,24,Gueye Mousse ,MB,0,0,0, ,0,0,0,0,0, ,0,0,0,0, ,0,0,0,0, ,0,0,0,0, ,0,0,0, ,0,0,0,0, 
11771,POL,1,Nowakowski Piotr ,MB,1,3,0,0.00,4,1,0,2,3,33.33,3,2,0,5,20.00,0,2,1,3,-66.67,0,0,0,0, ,0,0,0, ,0,0,0,0, 
11771,POL,2,Muzaj Maciej ,O,1,0,0,-20.00,1,1,1,1,3,0.00,0,0,0,0, ,0,1,1,2,-50.00,0,0,1,1,0.00,0,0,0, ,0,0,0,0, 
11771,POL,5,Kaczmarek Lukasz ,O,7,2,0,16.13,9,7,1,10,18,33.33,2,0,1,3,66.67,0,3,7,10,-30.00,1,0,1,2,50.00,0,1,1,-100.00,0,0,0,0, 
11771,POL,9,Leon Venero Wilfredo ,OH,0,0,0,-100.00,0,0,1,0,1,-100.00,0,1,0,1,-100.00,0,0,0,0, ,0,0,0,0, ,0,0,0, ,0,0,0,0, 
11771,POL,10,Wojtaszek Damian ,L,0,0,0, ,0,0,0,0,0, ,0,0,0,0, ,0,0,0,0, ,9,1,12,22,36.36,6,5,12,8.33,0,0,0,0, 
11771,POL,11,Drzyzga Fabian ,S,0,0,1,-25.00,1,0,0,1,1,0.00,0,1,1,2,-50.00,1,3,5,9,-22.22,0,0,0,0, ,1,1,2,0.00,14,0,68,82,17.07
11771,POL,12,Lomacz Grzegorz ,S,0,0,0, ,0,0,0,0,0, ,0,0,0,0, ,0,0,0,0, ,0,0,0,0, ,0,0,0, ,0,0,1,1,0.00
11771,POL,13,Kubiak Michal ,OH,7,0,0,0.00,7,7,1,6,14,42.86,0,4,0,4,-100.00,0,2,7,9,-22.22,7,1,11,19,31.58,4,4,8,0.00,0,0,2,2,0.00
11771,POL,14,Sliwka Aleksander ,OH,0,0,0, ,0,0,0,0,0, ,0,0,0,0, ,0,0,0,0, ,0,0,0,0, ,0,0,0, ,0,0,0,0, 
11771,POL,15,Kochanowski Jakub ,MB,4,1,0,3.85,5,4,1,6,11,27.27,1,3,0,4,-50.00,0,0,11,11,0.00,0,0,0,0, ,1,3,4,-50.00,0,0,0,0, 
11771,POL,16,Semeniuk Kamil ,OH,15,1,0,17.78,16,15,3,12,30,40.00,1,3,0,4,-50.00,0,2,9,11,-18.18,12,0,9,21,57.14,4,3,7,14.29,0,0,1,1,0.00
11771,POL,17,Zatorski Pawel ,L,0,0,0, ,0,0,0,0,0, ,0,0,0,0, ,0,0,0,0, ,0,0,0,0, ,0,0,0, ,0,0,0,0, 
11771,POL,20,Bieniek Mateusz ,MB,2,0,1,15.38,3,2,0,3,5,40.00,0,0,0,0, ,1,1,6,8,0.00,0,0,0,0, ,1,1,2,0.00,0,0,0,0, 
11771,POL,22,Bednorz Bartosz ,OH,0,0,0, ,0,0,0,0,0, ,0,0,0,0, ,0,0,0,0, ,0,0,0,0, ,0,0,0, ,0,0,0,0, 
11771,BRA,1,Rezende Bruno Mossa ,S,2,0,0,-5.26,2,2,0,0,2,100.00,0,3,3,6,-50.00,0,0,11,11,0.00,0,0,0,0, ,5,0,5,100.00,11,0,60,71,15.49
11771,BRA,5,Borges Almeida Silva Mauricio ,OH,0,0,0, ,0,0,0,0,0, ,0,0,0,0, ,0,0,0,0, ,0,1,1,2,-50.00,0,0,0, ,0,0,0,0, 
11771,BRA,6,Gil Kreling Fernando ,S,0,0,0, ,0,0,0,0,0, ,0,0,0,0, ,0,0,0,0, ,0,0,0,0, ,0,0,0, ,0,0,0,0, 
11771,BRA,8,De Souza Wallace ,O,17,1,0,22.73,18,17,4,6,27,48.15,1,2,0,3,-33.33,0,2,12,14,-14.29,0,0,1,1,0.00,3,2,5,20.00,0,0,2,2,0.00
11771,BRA,9,Leal Hidalgo Yoandy ,OH,10,0,1,3.92,11,10,5,14,29,17.24,0,2,2,4,-50.00,1,2,15,18,-5.56,3,1,16,20,10.00,3,3,6,0.00,0,0,1,1,0.00
11771,BRA,11,Kavalkievicz Gabriel ,OH,0,0,0,0.00,0,0,0,0,0, ,0,0,0,0, ,0,0,1,1,0.00,0,0,0,0, ,0,0,0, ,0,0,0,0, 
11771,BRA,12,Santos Isac ,MB,5,1,0,4.55,6,5,0,2,7,71.43,1,1,3,5,0.00,0,4,6,10,-40.00,1,0,0,1,100.00,0,0,0, ,0,0,0,0, 
11771,BRA,13,De Souza Mauricio Luiz ,MB,4,2,0,12.00,6,4,1,1,6,50.00,2,1,3,6,16.67,0,1,12,13,-7.69,0,0,1,1,0.00,0,1,1,-100.00,0,0,1,1,0.00
11771,BRA,14,Correia De Souza Douglas ,OH,0,0,0, ,0,0,0,0,0, ,0,0,0,0, ,0,0,0,0, ,0,0,0,0, ,0,0,0, ,0,0,0,0, 
11771,BRA,15,Nascimento Maique Reis ,L,0,0,0, ,0,0,0,0,0, ,0,0,0,0, ,0,0,0,0, ,0,0,0,0, ,0,0,0, ,0,0,0,0, 
11771,BRA,17,Hoss Thales ,L,0,0,0, ,0,0,0,0,0, ,0,0,0,0, ,0,0,0,0, ,5,0,7,12,41.67,4,3,7,14.29,0,0,4,4,0.00
11771,BRA,18,Souza Ricardo Lucarelli ,OH,14,1,1,32.35,16,14,1,7,22,59.09,1,1,0,2,0.00,1,3,6,10,-20.00,3,0,9,12,25.00,6,4,10,20.00,0,0,9,9,0.00
11771,BRA,21,Souza Alan ,O,0,0,0, ,0,0,0,0,0, ,0,0,0,0, ,0,0,0,0, ,0,0,0,0, ,1,0,1,100.00,0,0,2,2,0.00
11771,BRA,23,Resende Gualberto Flavio ,MB,0,0,0, ,0,0,0,0,0, ,0,0,0,0, ,0,0,0,0, ,0,0,0,0, ,0,0,0, ,0,0,0,0, 
11902,RUS,4,Pilipenko Daria ,L,0,0,0, ,0,0,0,0,0, ,0,0,0,0, ,0,0,0,0, ,0,0,0,0, ,0,0,0, ,0,0,0,0, 
11902,RUS,5,Fedorovtseva Arina ,OH,10,2,0,17.95,12,10,3,10,23,30.43,2,1,4,7,14.29,0,1,8,9,-11.11,4,6,7,17,-11.76,1,1,2,0.00,0,0,2,2,0.00
11902,RUS,6,Koroleva Irina ,MB,3,4,0,4.00,7,3,0,5,8,37.50,4,4,4,12,0.00,0,2,3,5,-40.00,0,0,0,0, ,2,0,2,100.00,0,0,0,0, 
11902,RUS,8,Goncharova Nataliya ,O,8,1,0,17.07,9,8,2,16,26,23.08,1,0,4,5,20.00,0,0,10,10,0.00,0,0,0,0, ,8,1,10,70.00,0,0,3,3,0.00
11902,RUS,10,Matveeva Polina ,S,0,0,0, ,0,0,0,0,0, ,0,0,0,0, ,0,0,0,0, ,0,0,0,0, ,0,0,0, ,0,0,0,0, 
11902,RUS,11,Brovkina Yulia ,MB,2,0,0,11.11,2,2,0,1,3,66.67,0,1,2,3,-33.33,0,0,3,3,0.00,0,0,0,0, ,1,0,1,100.00,0,0,1,1,0.00
11902,RUS,12,Lazareva Anna ,O,3,0,0,33.33,3,3,0,1,4,75.00,0,0,1,1,0.00,0,1,0,1,-100.00,0,0,0,0, ,2,0,2,100.00,0,0,0,0, 
11902,RUS,13,Startseva Evgeniya ,S,1,1,1,16.67,3,1,0,0,1,100.00,1,0,2,3,33.33,1,1,6,8,0.00,0,0,0,0, ,13,2,16,68.75,12,1,59,72,15.28
11902,RUS,14,Fetisova Irina ,MB,3,1,0,-3.70,4,3,1,1,5,40.00,1,2,8,11,-9.09,0,2,9,11,-18.18,0,0,0,0, ,3,0,4,75.00,0,0,1,1,0.00
11902,RUS,16,Voronkova Irina ,OH,14,2,2,21.15,18,14,4,6,24,41.67,2,1,5,8,12.50,2,2,16,20,0.00,3,0,12,15,20.00,5,2,9,33.33,0,0,3,3,0.00
11902,RUS,19,Podkopaeva Anna ,L,0,0,0, ,0,0,0,0,0, ,0,0,0,0, ,0,0,0,0, ,3,0,10,13,23.08,17,2,23,65.22,0,0,12,12,0.00
11902,RUS,20,Lazareva Ekaterina ,S,0,0,0,-100.00,0,0,1,0,1,-100.00,0,0,0,0, ,0,0,0,0, ,0,0,0,0, ,0,0,0, ,2,0,8,10,20.00
11902,RUS,24,Pipunyrova Ekaterina ,OH,0,0,0, ,0,0,0,0,0, ,0,0,0,0, ,0,0,0,0, ,0,0,0,0, ,2,0,2,100.00,0,0,0,0, 
11902,RUS,25,Smirnova Kseniia ,OH,4,0,0,-5.26,4,4,3,5,12,8.33,0,1,0,1,-100.00,0,1,5,6,-16.67,2,0,8,10,20.00,2,1,3,33.33,0,0,0,0, 
11902,KOR,1,Lee Soyoung ,OH,0,0,0,-23.53,0,0,2,6,8,-25.00,0,2,1,3,-66.67,0,0,6,6,0.00,1,1,9,11,0.00,4,0,5,80.00,0,0,1,1,0.00
11902,KOR,2,Lee Dahyeon ,MB,0,1,0,-33.33,1,0,1,3,4,-25.00,1,4,2,7,-42.86,0,0,1,1,0.00,0,1,0,1,-100.00,2,0,3,66.67,0,0,0,0, 
11902,KOR,3,Yeum Hye Seon ,S,0,0,1,0.00,1,0,0,0,0, ,0,1,0,1,-100.00,1,0,2,3,33.33,0,0,0,0, ,0,1,2,-50.00,1,1,26,28,0.00
11902,KOR,5,Han Dahye ,L,0,0,0, ,0,0,0,0,0, ,0,0,0,0, ,0,0,0,0, ,0,0,0,0, ,0,0,0, ,0,0,0,0, 
11902,KOR,7,An Hyejin ,S,0,0,1,-8.33,1,0,1,0,1,-100.00,0,0,1,1,0.00,1,1,8,10,0.00,0,0,0,0, ,4,0,4,100.00,6,1,57,64,7.81
11902,KOR,8,Park Eunjin ,MB,0,0,0,-33.33,0,0,0,1,1,0.00,0,1,0,1,-100.00,0,1,3,4,-25.00,0,0,0,0, ,4,0,4,100.00,0,0,0,0, 
11902,KOR,9,Oh Jiyoung ,L,0,0,0, ,0,0,0,0,0, ,0,0,0,0, ,0,0,0,0, ,6,0,10,16,37.50,11,2,15,60.00,0,1,4,5,-20.00
11902,KOR,10,Kim Yeon Koung ,OH,7,0,2,10.81,9,7,2,13,22,22.73,0,2,1,3,-66.67,2,1,9,12,8.33,3,1,9,13,15.38,5,3,9,22.22,0,0,2,2,0.00
11902,KOR,12,Han Songyi ,MB,1,1,1,0.00,3,1,0,0,1,100.00,1,2,1,4,-25.00,1,1,3,5,0.00,1,0,0,1,100.00,0,0,0, ,0,0,0,0, 
11902,KOR,13,Park Jeongah ,OH,5,2,0,26.92,7,5,0,12,17,29.41,2,0,3,5,40.00,0,0,4,4,0.00,3,0,11,14,21.43,10,1,13,69.23,0,0,1,1,0.00
11902,KOR,14,Yang Hyo Jin ,MB,2,1,0,0.00,3,2,0,3,5,40.00,1,3,8,12,-16.67,0,0,3,3,0.00,1,0,0,1,100.00,3,0,4,75.00,0,0,1,1,0.00
11902,KOR,15,Yuk Seoyoung ,OH,0,0,0,0.00,0,0,0,0,0, ,0,0,0,0, ,0,0,1,1,0.00,0,0,0,0, ,0,0,0, ,0,0,0,0, 
11902,KOR,16,Jeong Jiyun ,O,9,2,0,0.00,11,9,6,13,28,10.71,2,5,3,10,-30.00,0,0,8,8,0.00,0,0,0,0, ,3,2,7,14.29,0,0,1,1,0.00
11902,KOR,19,Pyo Seungju ,OH,1,0,1,-10.00,2,1,3,4,8,-25.00,0,0,0,0, ,1,0,1,2,50.00,1,0,5,6,16.67,2,1,5,20.00,0,0,0,0, 
11903,THA,2,Pannoy Piyanut ,L,0,0,0, ,0,0,0,0,0, ,0,0,0,0, ,0,0,0,0, ,4,0,7,11,36.36,7,1,10,60.00,0,0,8,8,0.00
11903,THA,3,ManaKij Sirima ,S,0,0,0, ,0,0,0,0,0, ,0,0,0,0, ,0,0,0,0, ,0,0,0,0, ,0,0,0, ,0,0,0,0, 
11903,THA,5,Thinkaow Pleumjit ,MB,12,1,2,14.29,15,12,1,10,23,47.83,1,5,4,10,-40.00,2,2,12,16,0.00,0,0,3,3,0.00,10,0,12,83.33,0,0,1,1,0.00
11903,THA,6,Sittirak Onuma ,OH,20,0,0,16.88,20,20,5,25,50,30.00,0,0,8,8,0.00,0,2,17,19,-10.53,2,1,9,12,8.33,11,2,15,60.00,0,0,4,4,0.00
11903,THA,9,Chuewulim Sutadta ,OH,13,0,1,34.21,14,13,1,7,21,57.14,0,0,1,1,0.00,1,0,15,16,6.25,5,3,15,23,8.70,10,2,14,57.14,0,0,2,2,0.00
11903,THA,10,Apinyapong Wilavan ,L,0,0,0, ,0,0,0,0,0, ,0,0,0,0, ,0,0,0,0, ,0,0,2,2,0.00,0,0,0, ,0,0,0,0, 
11903,THA,11,Hyapha Amporn ,MB,0,0,0,-15.38,0,0,2,2,4,-50.00,0,0,3,3,0.00,0,0,6,6,0.00,0,0,2,2,0.00,1,1,2,0.00,0,0,1,1,0.00
11903,THA,12,Chaisri Tapaphaipun ,L,0,0,0, ,0,0,0,0,0, ,0,0,0,0, ,0,0,0,0, ,0,0,0,0, ,8,0,9,88.89,0,0,4,4,0.00
11903,THA,13,Tomkom Nootsara ,S,2,1,0,0.00,3,2,0,0,2,100.00,1,2,3,6,-16.67,0,1,19,20,-5.00,0,0,0,0, ,14,4,18,55.56,12,2,105,119,8.40
11903,THA,14,Juangjan Pattiya ,OH,0,0,0, ,0,0,0,0,0, ,0,0,0,0, ,0,0,0,0, ,0,0,0,0, ,0,0,0, ,0,0,0,0, 
11903,THA,15,Kanthong Malika ,O,9,1,0,-1.85,10,9,5,18,32,12.50,1,4,4,9,-33.33,0,2,11,13,-15.38,6,0,12,18,33.33,7,3,12,33.33,0,0,5,5,0.00
11903,THA,19,Krause Karina ,MB,4,0,0,0.00,4,4,2,4,10,20.00,0,1,2,3,-33.33,0,1,7,8,-12.50,0,0,0,0, ,3,0,3,100.00,0,0,0,0, 
11903,THA,22,Nilapa Chatsuda ,OH,0,0,0, ,0,0,0,0,0, ,0,0,0,0, ,0,0,0,0, ,0,0,0,0, ,0,0,0, ,0,0,0,0, 
11903,THA,24,Nuanjam Watchareeya ,MB,0,0,0, ,0,0,0,0,0, ,0,0,0,0, ,0,0,0,0, ,0,0,0,0, ,0,0,0, ,0,0,0,0, 
11903,GER,1,Bock Linda ,L,0,0,0, ,0,0,0,0,0, ,0,0,0,0, ,0,0,0,0, ,0,0,0,0, ,0,0,0, ,0,0,0,0, 
11903,GER,2,KÃ¤stner Pia ,S,1,2,0,10.00,3,1,0,0,1,100.00,2,1,0,3,33.33,0,1,5,6,-16.67,0,0,0,0, ,4,0,5,80.00,6,0,39,45,13.33
11903,GER,4,Imoudu Denise ,S,0,0,1,-16.67,1,0,0,1,1,0.00,0,1,2,3,-33.33,1,2,5,8,-12.50,0,0,0,0, ,3,3,8,0.00,14,0,57,71,19.72
11903,GER,5,Poll Jana Franziska ,OH,2,0,0,33.33,2,2,0,1,3,66.67,0,0,0,0, ,0,0,3,3,0.00,0,0,2,2,0.00,0,1,1,-100.00,0,0,0,0, 
11903,GER,7,Vanjak Ivana ,OH,0,0,0, ,0,0,0,0,0, ,0,0,0,0, ,0,0,0,0, ,0,0,0,0, ,0,0,0, ,0,0,0,0, 
11903,GER,8,Drewniok Kimberly ,O,9,1,0,4.65,10,9,5,12,26,15.38,1,1,1,3,0.00,0,2,12,14,-14.29,0,0,0,0, ,8,3,15,33.33,0,0,4,4,0.00
11903,GER,9,Alsmeier Lina ,OH,13,3,2,18.64,18,13,5,17,35,22.86,3,0,1,4,75.00,2,2,16,20,0.00,13,3,21,37,27.03,4,1,5,60.00,0,0,2,2,0.00
11903,GER,10,Stigrot Lena ,OH,8,1,0,16.00,9,8,4,6,18,22.22,1,1,0,2,0.00,0,0,5,5,0.00,2,0,5,7,28.57,3,2,6,16.67,0,1,1,2,-50.00
11903,GER,12,Orthmann Hanna ,OH,8,1,0,3.57,9,8,4,9,21,19.05,1,0,1,2,50.00,0,4,1,5,-80.00,3,0,13,16,18.75,7,1,8,75.00,0,0,0,0, 
11903,GER,14,SchÃ¶lzel Marie ,MB,7,1,0,-2.56,8,7,0,8,15,46.67,1,8,4,13,-53.85,0,1,10,11,-9.09,0,0,1,1,0.00,2,2,4,0.00,0,0,0,0, 
11903,GER,17,Pogany Anna ,L,0,0,0, ,0,0,0,0,0, ,0,0,0,0, ,0,0,0,0, ,9,0,13,22,40.91,24,6,34,52.94,0,1,10,11,-9.09
11903,GER,20,Bock Josepha ,MB,0,0,0, ,0,0,0,0,0, ,0,0,0,0, ,0,0,0,0, ,0,0,0,0, ,0,0,0, ,0,0,0,0, 
11903,GER,21,Weitzel Camilla ,MB,6,1,1,-7.41,8,6,1,11,18,27.78,1,9,13,23,-34.78,1,2,10,13,-7.69,0,0,5,5,0.00,3,1,4,50.00,0,0,3,3,0.00
11904,JPN,1,Kurogo Ai ,OH,11,2,2,9.62,15,11,7,12,30,13.33,2,2,5,9,0.00,2,1,10,13,7.69,0,0,1,1,0.00,10,6,17,23.53,0,0,4,4,0.00
11904,JPN,2,Koga Sarina ,OH,18,0,0,21.43,18,18,5,17,40,32.50,0,0,4,4,0.00,0,1,11,12,-8.33,11,2,13,26,34.62,14,3,17,64.71,0,0,4,4,0.00
11904,JPN,3,Shimamura Haruyo ,MB,6,2,0,6.45,8,6,2,7,15,26.67,2,3,5,10,-10.00,0,1,5,6,-16.67,0,0,1,1,0.00,6,0,7,85.71,0,0,0,0, 
11904,JPN,5,Araki Erika ,MB,5,4,1,14.89,10,5,0,9,14,35.71,4,3,9,16,6.25,1,0,16,17,5.88,0,0,1,1,0.00,1,1,3,0.00,0,0,2,2,0.00
11904,JPN,7,Ishii Yuki ,OH,3,0,0,27.27,3,3,0,3,6,50.00,0,0,0,0, ,0,0,5,5,0.00,3,1,4,8,25.00,1,0,1,100.00,0,0,1,1,0.00
11904,JPN,8,Ishikawa Mayu ,OH,9,1,2,10.34,12,9,3,22,34,17.65,1,2,2,5,-20.00,2,1,16,19,5.26,9,2,12,23,30.43,13,1,15,80.00,0,0,3,3,0.00
11904,JPN,9,Tashiro Kanami ,S,0,0,0,0.00,0,0,0,0,0, ,0,0,0,0, ,0,0,3,3,0.00,0,0,0,0, ,2,1,3,33.33,0,0,11,11,0.00
11904,JPN,10,Akutagawa Aika ,MB,0,0,0, ,0,0,0,0,0, ,0,0,0,0, ,0,0,0,0, ,0,0,0,0, ,0,0,0, ,0,0,0,0, 
11904,JPN,11,Nabeya Yurie ,OH,0,0,0,0.00,0,0,0,0,0, ,0,0,0,0, ,0,0,5,5,0.00,0,0,0,0, ,1,0,1,100.00,0,0,0,0, 
11904,JPN,13,Okumura Mai ,MB,0,0,0, ,0,0,0,0,0, ,0,0,0,0, ,0,0,0,0, ,0,0,0,0, ,0,0,0, ,0,0,0,0, 
11904,JPN,14,Kobata Mako ,L,0,0,0, ,0,0,0,0,0, ,0,0,0,0, ,0,0,0,0, ,2,0,6,8,25.00,19,3,24,66.67,0,0,18,18,0.00
11904,JPN,15,Inoue Kotoe ,L,0,0,0, ,0,0,0,0,0, ,0,0,0,0, ,0,0,0,0, ,0,0,0,0, ,0,0,0, ,0,0,0,0, 
11904,JPN,19,Yamada Nichika ,MB,0,0,0, ,0,0,0,0,0, ,0,0,0,0, ,0,0,0,0, ,0,0,0,0, ,0,0,0, ,0,0,0,0, 
11904,JPN,24,Momii Aki ,S,0,2,0,-26.09,2,0,1,2,3,-33.33,2,5,2,9,-33.33,0,2,9,11,-18.18,0,0,0,0, ,12,1,15,73.33,18,0,77,95,18.95
11904,TUR,2,Akoz Simge Sebnem ,L,0,0,0, ,0,0,0,0,0, ,0,0,0,0, ,0,0,0,0, ,4,2,10,16,12.50,19,2,24,70.83,0,0,9,9,0.00
11904,TUR,3,Ãzbay Cansu ,S,1,1,0,-18.18,2,1,0,1,2,50.00,1,2,5,8,-12.50,0,4,8,12,-33.33,0,0,1,1,0.00,7,0,8,87.50,36,2,75,113,30.09
11904,TUR,4,Senoglu Tugba ,OH,2,0,1,-17.65,3,2,4,2,8,-25.00,0,2,2,4,-50.00,1,0,4,5,20.00,4,0,7,11,36.36,5,0,5,100.00,0,0,0,0, 
11904,TUR,5,Ercan Seyma ,OH,0,0,1,-9.09,1,0,0,3,3,0.00,0,0,1,1,0.00,1,2,4,7,-14.29,6,1,3,10,50.00,3,1,5,40.00,0,0,1,1,0.00
11904,TUR,6,Caliskan Kubra ,MB,0,0,0, ,0,0,0,0,0, ,0,0,0,0, ,0,0,0,0, ,0,0,0,0, ,0,0,0, ,0,0,0,0, 
11904,TUR,7,Baladin Hande ,OH,15,1,1,28.89,17,15,3,10,28,42.86,1,1,0,2,0.00,1,0,14,15,6.67,9,1,16,26,30.77,7,6,14,7.14,0,0,4,4,0.00
11904,TUR,9,Ismailoglu Meliha ,OH,3,0,0,-14.29,3,3,3,8,14,0.00,0,2,1,3,-66.67,0,1,3,4,-25.00,5,1,15,21,19.05,3,2,9,11.11,0,0,1,1,0.00
11904,TUR,12,Unal Buse ,S,0,0,0,0.00,0,0,0,0,0, ,0,0,0,0, ,0,0,1,1,0.00,0,0,0,0, ,0,0,0, ,0,0,1,1,0.00
11904,TUR,13,Boz Meryem ,O,9,0,0,-2.38,9,9,4,15,28,17.86,0,3,5,8,-37.50,0,3,3,6,-50.00,0,0,0,0, ,5,0,5,100.00,0,0,0,0, 
11904,TUR,14,Erdem DÃ¼ndar Eda ,MB,12,1,0,10.42,13,12,0,8,20,60.00,1,7,11,19,-31.58,0,1,8,9,-11.11,0,0,0,0, ,2,1,3,33.33,0,0,3,3,0.00
11904,TUR,16,Sahin Saliha ,OH,0,0,0, ,0,0,0,0,0, ,0,0,0,0, ,0,0,0,0, ,0,0,0,0, ,0,0,0, ,0,0,0,0, 
11904,TUR,18,Gunes Zehra ,MB,9,3,1,8.93,13,9,2,7,18,38.89,3,5,15,23,-8.70,1,1,13,15,0.00,0,0,0,0, ,2,3,6,-16.67,0,0,1,1,0.00
11904,TUR,20,Cebecioglu Derya ,OH,0,0,0, ,0,0,0,0,0, ,0,0,0,0, ,0,0,0,0, ,0,0,0,0, ,0,0,0, ,0,0,0,0, 
11904,TUR,99,Karakurt Ebrar ,OH,1,0,1,-19.05,2,1,3,8,12,-16.67,0,1,0,1,-100.00,1,2,5,8,-12.50,0,0,0,0, ,5,1,7,57.14,0,0,0,0, 
11905,USA,1,Hancock Micha ,S,0,0,0, ,0,0,0,0,0, ,0,0,0,0, ,0,0,0,0, ,0,0,0,0, ,0,0,0, ,0,0,0,0, 
11905,USA,2,Poulter Jordyn ,S,1,0,1,-5.00,2,1,0,0,1,100.00,0,2,4,6,-33.33,1,1,11,13,0.00,1,1,0,2,0.00,8,2,10,60.00,19,1,69,89,20.22
11905,USA,4,Wong-Orantes Justine ,L,0,0,0, ,0,0,0,0,0, ,0,0,0,0, ,0,0,0,0, ,13,1,5,19,63.16,11,0,12,91.67,0,0,11,11,0.00
11905,USA,8,Tapp Hannah ,MB,0,0,0, ,0,0,0,0,0, ,0,0,0,0, ,0,0,0,0, ,0,0,0,0, ,0,0,0, ,0,0,0,0, 
11905,USA,10,Larson Jordan ,OH,10,0,0,-2.17,10,10,4,7,21,28.57,0,2,2,4,-50.00,0,5,16,21,-23.81,5,1,12,18,22.22,13,1,14,85.71,0,0,3,3,0.00
11905,USA,11,Drews Andrea ,O,0,0,0, ,0,0,0,0,0, ,0,0,0,0, ,0,0,0,0, ,0,0,0,0, ,0,0,0, ,0,0,0,0, 
11905,USA,12,Thompson Jordan ,O,18,3,0,23.21,21,18,3,16,37,40.54,3,2,5,10,10.00,0,3,6,9,-33.33,0,0,0,0, ,7,3,10,40.00,0,0,3,3,0.00
11905,USA,13,Wilhite Sarah ,OH,0,0,0, ,0,0,0,0,0, ,0,0,0,0, ,0,0,0,0, ,0,0,0,0, ,0,0,0, ,0,0,0,0, 
11905,USA,14,Bartsch-Hackley Michelle ,OH,0,0,0, ,0,0,0,0,0, ,0,0,0,0, ,0,0,0,0, ,0,0,0,0, ,0,0,0, ,0,0,0,0, 
11905,USA,15,Hill Kimberly ,OH,0,0,0,-14.29,0,0,0,0,0, ,0,0,0,0, ,0,1,6,7,-14.29,0,0,0,0, ,0,0,0, ,0,0,0,0, 
11905,USA,16,Akinradewo Foluke ,MB,8,1,0,26.09,9,8,0,4,12,66.67,1,1,2,4,0.00,0,2,5,7,-28.57,0,0,0,0, ,4,1,5,60.00,0,0,1,1,0.00
11905,USA,22,Washington Haleigh ,MB,0,0,0, ,0,0,0,0,0, ,0,0,0,0, ,0,0,0,0, ,0,0,0,0, ,0,0,0, ,0,0,0,0, 
11905,USA,23,Robinson Kelsey ,OH,12,1,1,19.15,14,12,2,16,30,33.33,1,2,3,6,-16.67,1,1,9,11,0.00,3,1,7,11,18.18,16,3,19,68.42,0,0,1,1,0.00
11905,USA,24,Ogbogu Chiaka ,MB,4,2,0,9.52,6,4,0,3,7,57.14,2,2,4,8,0.00,0,2,4,6,-33.33,0,0,0,0, ,1,0,1,100.00,0,1,0,1,-100.00
11905,BEL,2,Van Sas Elise ,S,0,0,0, ,0,0,0,0,0, ,0,0,0,0, ,0,0,0,0, ,0,0,0,0, ,0,0,0, ,1,0,2,3,33.33
11905,BEL,4,Lemmens Nathalie ,MB,4,2,0,26.09,6,4,0,5,9,44.44,2,0,7,9,22.22,0,0,5,5,0.00,0,0,0,0, ,1,0,1,100.00,0,0,0,0, 
11905,BEL,5,Guilliams Jodie ,OH,0,0,0,0.00,0,0,0,6,6,0.00,0,0,0,0, ,0,0,2,2,0.00,2,0,10,12,16.67,2,0,2,100.00,0,0,0,0, 
11905,BEL,6,Gilson Helena ,OH,4,0,0,-18.18,4,4,6,21,31,-6.45,0,5,3,8,-62.50,0,1,4,5,-20.00,0,1,6,7,-14.29,6,0,7,85.71,0,0,2,2,0.00
11905,BEL,7,Van Gestel Celine ,OH,4,0,2,11.54,6,4,1,8,13,23.08,0,2,1,3,-66.67,2,0,8,10,20.00,1,0,12,13,7.69,8,5,13,23.08,0,0,3,3,0.00
11905,BEL,9,Demeyer Nel ,L,0,0,0,-50.00,0,0,0,0,0, ,0,0,0,0, ,0,1,1,2,-50.00,1,0,0,1,100.00,1,1,2,0.00,0,0,0,0, 
11905,BEL,10,Sobolska Dominika ,MB,1,0,0,-21.43,1,1,1,5,7,0.00,0,2,2,4,-50.00,0,1,2,3,-33.33,0,0,0,0, ,0,0,1,0.00,0,0,0,0, 
11905,BEL,11,De Tant Amber ,L,0,0,0, ,0,0,0,0,0, ,0,0,0,0, ,0,0,0,0, ,0,0,1,1,0.00,0,0,0, ,0,0,0,0, 
11905,BEL,14,De Valkeneer Lise ,OH,3,2,0,4.17,5,3,3,8,14,0.00,2,1,2,5,20.00,0,0,5,5,0.00,0,0,1,1,0.00,1,4,6,-50.00,0,0,1,1,0.00
11905,BEL,15,Van De Vyver Jutta ,S,0,0,0, ,0,0,0,0,0, ,0,0,0,0, ,0,0,0,0, ,0,0,0,0, ,0,0,0, ,0,0,0,0, 
11905,BEL,17,Van De Vyver Ilka ,S,0,0,0,-17.65,0,0,1,2,3,-33.33,0,1,1,2,-50.00,0,1,11,12,-8.33,0,0,0,0, ,8,2,12,50.00,7,0,66,73,9.59
11905,BEL,18,Rampelberg Britt ,L,0,0,0, ,0,0,0,0,0, ,0,0,0,0, ,0,0,0,0, ,6,1,17,24,20.83,8,5,15,20.00,0,0,13,13,0.00
11905,BEL,19,Van Avermaet Silke ,MB,5,1,1,8.70,7,5,2,3,10,30.00,1,3,1,5,-40.00,1,0,7,8,12.50,0,0,0,0, ,5,0,5,100.00,0,0,0,0, 
11905,BEL,21,Stragier Manon ,OH,0,0,1,-33.33,1,0,1,0,1,-100.00,0,1,1,2,-50.00,1,1,1,3,0.00,0,0,0,0, ,0,0,0, ,0,0,0,0, 
11906,CHN,1,Yuan Xinyue ,MB,11,2,1,21.43,14,11,1,7,19,52.63,2,2,3,7,0.00,1,2,13,16,-6.25,0,0,0,0, ,3,1,4,50.00,0,0,4,4,0.00
11906,CHN,2,Zhu Ting ,OH,10,0,0,32.00,10,10,1,7,18,50.00,0,1,1,2,-50.00,0,0,5,5,0.00,0,0,2,2,0.00,9,2,11,63.64,0,0,8,8,0.00
11906,CHN,4,Yang Hanyu ,MB,0,0,0, ,0,0,0,0,0, ,0,0,0,0, ,0,0,0,0, ,0,0,0,0, ,0,0,0, ,0,0,0,0, 
11906,CHN,6,Gong Xiangyu ,O,15,1,1,12.90,17,15,6,16,37,24.32,1,3,1,5,-40.00,1,0,19,20,5.00,5,0,8,13,38.46,12,4,17,47.06,0,0,2,2,0.00
11906,CHN,7,Wang Yuanyuan ,MB,0,0,0, ,0,0,0,0,0, ,0,0,0,0, ,0,0,0,0, ,0,0,0,0, ,0,0,0, ,0,0,0,0, 
11906,CHN,8,Li Yao ,OH,0,0,0,0.00,0,0,0,1,1,0.00,0,0,0,0, ,0,0,0,0, ,0,0,0,0, ,0,0,0, ,0,0,0,0, 
11906,CHN,9,Zhang Changning ,OH,7,0,0,31.58,7,7,1,5,13,46.15,0,0,1,1,0.00,0,0,5,5,0.00,8,1,5,14,50.00,5,4,10,10.00,0,0,1,1,0.00
11906,CHN,10,Liu Xiaotong ,OH,0,0,0, ,0,0,0,0,0, ,0,0,0,0, ,0,0,0,0, ,0,0,0,0, ,0,0,0, ,0,0,0,0, 
11906,CHN,11,Yao Di ,S,0,0,0, ,0,0,0,0,0, ,0,0,0,0, ,0,0,0,0, ,0,0,0,0, ,1,0,1,100.00,0,0,9,9,0.00
11906,CHN,12,Li Yingying ,OH,17,0,2,21.57,19,17,5,15,37,32.43,0,2,1,3,-66.67,2,1,8,11,9.09,9,1,13,23,34.78,6,0,7,85.71,0,0,0,0, 
11906,CHN,15,Lin Li ,L,0,0,0, ,0,0,0,0,0, ,0,0,0,0, ,0,0,0,0, ,0,0,0,0, ,0,0,0, ,0,0,0,0, 
11906,CHN,16,Ding Xia ,S,0,1,0,-16.67,1,0,1,0,1,-100.00,1,0,0,1,100.00,0,2,8,10,-20.00,0,0,0,0, ,12,2,15,66.67,12,0,87,99,12.12
11906,CHN,17,Yan Ni ,MB,3,4,0,15.62,7,3,1,6,10,20.00,4,1,2,7,42.86,0,0,15,15,0.00,0,0,0,0, ,8,0,8,100.00,0,0,3,3,0.00
11906,CHN,18,Wang Mengjie ,L,0,0,0, ,0,0,0,0,0, ,0,0,0,0, ,0,0,0,0, ,3,0,5,8,37.50,8,3,11,45.45,1,0,7,8,12.50
11906,NED,2,Savelkoel Fleur ,OH,0,0,0, ,0,0,0,0,0, ,0,0,0,0, ,0,0,0,0, ,0,0,0,0, ,0,0,0, ,0,0,0,0, 
11906,NED,4,Plak Celeste ,OH,9,1,0,22.58,10,9,1,12,22,36.36,1,1,0,2,0.00,0,1,6,7,-14.29,0,0,0,0, ,3,3,6,0.00,0,0,2,2,0.00
11906,NED,7,Lohuis Juliet ,MB,1,1,0,-13.64,2,1,3,6,10,-20.00,1,2,1,4,-25.00,0,0,8,8,0.00,0,0,0,0, ,0,0,0, ,0,0,0,0, 
11906,NED,8,Korevaar Demi ,MB,0,0,0, ,0,0,0,0,0, ,0,0,0,0, ,0,0,0,0, ,0,0,0,0, ,0,0,0, ,0,0,0,0, 
11906,NED,9,Schoot Myrthe ,L,0,0,0, ,0,0,0,0,0, ,0,0,0,0, ,0,0,0,0, ,6,1,5,12,41.67,12,8,22,18.18,0,0,10,10,0.00
11906,NED,10,van Aalen Sarah ,S,0,0,0, ,0,0,0,0,0, ,0,0,0,0, ,0,0,0,0, ,0,0,0,0, ,0,0,0, ,1,0,0,1,100.00
11906,NED,11,Buijs Anne ,OH,8,1,0,4.26,9,8,4,23,35,11.43,1,3,0,4,-50.00,0,0,8,8,0.00,12,2,12,26,38.46,3,2,5,20.00,0,0,0,0, 
11906,NED,12,Bongaerts Britt ,S,1,0,1,-5.00,2,1,0,0,1,100.00,0,3,0,3,-100.00,1,0,15,16,6.25,0,0,0,0, ,3,3,6,0.00,6,1,105,112,4.46
11906,NED,18,Jasper Marrit ,OH,0,0,0,0.00,0,0,0,0,0, ,0,0,0,0, ,0,0,2,2,0.00,1,0,6,7,14.29,2,1,4,25.00,0,0,0,0, 
11906,NED,19,Daalderop Nika ,OH,11,0,0,13.73,11,11,4,24,39,17.95,0,0,2,2,0.00,0,0,10,10,0.00,11,1,20,32,31.25,5,4,9,11.11,0,0,1,1,0.00
11906,NED,21,Meijers Annick ,OH,0,0,0,0.00,0,0,0,2,2,0.00,0,0,0,0, ,0,0,2,2,0.00,0,0,0,0, ,1,0,1,100.00,0,0,0,0, 
11906,NED,23,Timmerman Eline ,MB,6,3,0,19.23,9,6,0,7,13,46.15,3,3,1,7,0.00,0,1,5,6,-16.67,0,0,0,0, ,2,2,4,0.00,0,0,0,0, 
11906,NED,25,Reesink Florien ,L,0,0,0, ,0,0,0,0,0, ,0,0,0,0, ,0,0,0,0, ,0,0,0,0, ,0,0,0, ,0,0,0,0, 
11906,NED,27,Scholten Iris ,O,2,1,1,28.57,4,2,0,6,8,25.00,1,0,2,3,33.33,1,0,2,3,33.33,0,0,0,0, ,0,0,0, ,0,0,0,0, 
11907,CAN,1,Bujan Cassandra ,L,0,0,0, ,0,0,0,0,0, ,0,0,0,0, ,0,0,0,0, ,3,0,8,11,27.27,13,5,19,42.11,0,0,9,9,0.00
11907,CAN,3,Van Ryk Kiera ,OH,17,1,3,10.77,21,17,5,17,39,30.77,1,3,5,9,-22.22,3,6,8,17,-17.65,0,0,0,0, ,9,3,14,42.86,0,0,2,2,0.00
11907,CAN,5,Smith Danielle ,S,0,0,0, ,0,0,0,0,0, ,0,0,0,0, ,0,0,0,0, ,0,0,0,0, ,0,0,0, ,0,0,0,0, 
11907,CAN,6,White Jazmine  Ruth ,MB,0,0,0, ,0,0,0,0,0, ,0,0,0,0, ,0,0,0,0, ,0,0,0,0, ,0,0,0, ,0,0,0,0, 
11907,CAN,8,Ogoms Alicia ,MB,0,0,0, ,0,0,0,0,0, ,0,0,0,0, ,0,0,0,0, ,0,0,0,0, ,0,0,0, ,0,0,0,0, 
11907,CAN,9,Gray Alexa ,OH,0,0,0, ,0,0,0,0,0, ,0,0,0,0, ,0,0,0,0, ,1,2,3,6,-16.67,0,0,0, ,0,0,0,0, 
11907,CAN,11,Mitrovic Andrea ,OH,13,0,2,12.28,15,13,2,18,33,33.33,0,3,2,5,-60.00,2,3,14,19,-5.26,4,1,21,26,11.54,5,1,7,57.14,0,0,1,1,0.00
11907,CAN,12,Cross Jennifer ,MB,1,4,1,11.11,6,1,0,6,7,14.29,4,2,3,9,22.22,1,0,19,20,5.00,0,1,3,4,-25.00,10,2,13,61.54,0,0,1,1,0.00
11907,CAN,13,King Brie ,S,1,2,0,-6.67,3,1,0,2,3,33.33,2,2,0,4,0.00,0,2,6,8,-25.00,0,1,0,1,-100.00,12,6,20,30.00,24,0,86,110,21.82
11907,CAN,14,Howe Hilary ,OH,15,1,1,22.22,17,15,5,11,31,32.26,1,1,1,3,0.00,1,1,9,11,0.00,2,1,26,29,3.45,6,3,11,27.27,0,0,1,1,0.00
11907,CAN,15,Joseph Shainah ,O,0,0,0, ,0,0,0,0,0, ,0,0,0,0, ,0,0,0,0, ,0,0,0,0, ,0,0,0, ,0,0,0,0, 
11907,CAN,16,Livingston Caroline ,OH,0,0,0,0.00,0,0,0,0,0, ,0,0,0,0, ,0,0,2,2,0.00,2,0,1,3,66.67,0,0,0, ,0,0,0,0, 
11907,CAN,19,Maglio Emily ,MB,12,4,1,11.76,17,12,1,5,18,61.11,4,6,4,14,-14.29,1,4,14,19,-15.79,0,0,0,0, ,7,3,10,40.00,0,0,3,3,0.00
11907,CAN,22,Snape Kennedy Brooklyn ,L,0,0,0, ,0,0,0,0,0, ,0,0,0,0, ,0,0,0,0, ,0,0,0,0, ,0,0,0, ,0,0,0,0, 
11907,SRB,2,Lazovic Katarina ,OH,0,0,0, ,0,0,0,0,0, ,0,0,0,0, ,0,0,0,0, ,0,0,0,0, ,1,0,1,100.00,0,0,0,0, 
11907,SRB,3,Caric Sara ,O,12,2,1,11.11,15,12,6,14,32,18.75,2,2,3,7,0.00,1,1,13,15,0.00,0,0,0,0, ,9,3,12,50.00,0,0,3,3,0.00
11907,SRB,6,Uzelac Aleksandra ,OH,0,0,0,-33.33,0,0,1,1,2,-50.00,0,0,0,0, ,0,0,1,1,0.00,0,0,5,5,0.00,1,1,2,0.00,0,0,0,0, 
11907,SRB,7,Jaksic Ana ,S,1,0,0,-20.00,1,1,0,0,1,100.00,0,3,1,4,-75.00,0,1,9,10,-10.00,0,0,0,0, ,7,3,11,36.36,9,0,54,63,14.29
11907,SRB,21,Kocic Jovana ,MB,6,1,0,2.94,7,6,1,4,11,45.45,1,5,5,11,-36.36,0,0,12,12,0.00,0,0,0,0, ,3,0,5,60.00,0,0,1,1,0.00
11907,SRB,22,Lozo Sara ,O,12,1,3,22.92,16,12,5,13,30,23.33,1,0,3,4,25.00,3,0,11,14,21.43,8,3,22,33,15.15,11,5,16,37.50,0,0,5,5,0.00
11907,SRB,23,Djordjevic Mila ,S,0,3,0,-6.67,3,0,0,3,3,0.00,3,3,2,8,0.00,0,1,3,4,-25.00,0,0,0,0, ,2,3,5,-20.00,3,0,39,42,7.14
11907,SRB,24,Medic Sofija ,MB,1,1,0,-30.00,2,1,2,3,6,-16.67,1,5,2,8,-50.00,0,1,5,6,-16.67,0,0,1,1,0.00,5,0,5,100.00,0,0,0,0, 
11907,SRB,25,Markovic Bozica ,MB,0,0,0,0.00,0,0,0,0,0, ,0,0,0,0, ,0,0,1,1,0.00,0,0,0,0, ,1,0,1,100.00,0,0,0,0, 
11907,SRB,26,Savic Vanja ,O,1,0,0,-25.00,1,1,0,4,5,20.00,0,2,2,4,-50.00,0,2,1,3,-66.67,0,0,0,0, ,1,0,1,100.00,0,0,0,0, 
11907,SRB,28,Delic Jelena ,MB,0,0,1,16.67,1,0,0,0,0, ,0,0,0,0, ,1,0,5,6,16.67,0,0,0,0, ,0,1,1,-100.00,0,0,1,1,0.00
11907,SRB,32,Gocanin Bojana ,L,0,0,0, ,0,0,0,0,0, ,0,0,0,0, ,0,0,0,0, ,10,5,12,27,18.52,14,3,18,61.11,0,0,4,4,0.00
11907,SRB,33,Cvetkovic Jovana ,OH,0,0,0, ,0,0,0,0,0, ,0,0,0,0, ,0,0,0,0, ,0,0,3,3,0.00,0,1,1,-100.00,0,0,1,1,0.00
11907,SRB,34,Mirosavljevic Jovana ,OH,15,1,1,13.21,17,15,8,13,36,19.44,1,2,0,3,-33.33,1,0,13,14,7.14,8,0,3,11,72.73,9,5,15,26.67,0,0,4,4,0.00
11908,DOM,1,Vargas Valdez Annerys Victoria ,MB,5,1,2,-17.86,8,5,1,3,9,44.44,1,8,0,9,-77.78,2,4,4,10,-20.00,0,0,0,0, ,1,0,1,100.00,0,0,1,1,0.00
11908,DOM,3,Eve Mejia Lisvel Elisa ,U,0,0,0,0.00,0,0,0,0,0, ,0,0,0,0, ,0,0,4,4,0.00,1,1,3,5,0.00,0,0,0, ,0,0,0,0, 
11908,DOM,5,Castillo Brenda ,L,0,0,0, ,0,0,0,0,0, ,0,0,0,0, ,0,0,0,0, ,11,0,15,26,42.31,22,3,25,76.00,0,0,9,9,0.00
11908,DOM,6,Dominguez Martinez Camil Inmaculada ,S,0,0,0,-14.29,0,0,0,0,0, ,0,1,0,1,-100.00,0,0,6,6,0.00,0,0,0,0, ,3,1,4,50.00,3,1,35,39,5.13
11908,DOM,7,Marte Frica Niverka Dharlenis ,S,2,1,0,11.11,3,2,0,5,7,28.57,1,0,1,2,50.00,0,1,8,9,-11.11,0,0,0,0, ,4,1,5,60.00,8,2,84,94,6.38
11908,DOM,11,Rodriguez Marifranchi ,MB,0,0,0, ,0,0,0,0,0, ,0,0,0,0, ,0,0,0,0, ,0,0,0,0, ,0,0,0, ,0,0,0,0, 
11908,DOM,14,Rivera Brens Prisilla ,OH,9,1,2,15.79,12,9,3,10,22,27.27,1,1,0,2,0.00,2,2,10,14,0.00,7,0,18,25,28.00,2,3,5,-20.00,0,0,1,1,0.00
11908,DOM,16,PeÃ±a Isabel Yonkaira Paola ,OH,9,0,0,8.33,9,9,2,14,25,28.00,0,2,0,2,-100.00,0,2,7,9,-22.22,2,0,12,14,14.29,5,1,6,66.67,0,0,0,0, 
11908,DOM,17,Mambru Casilla Gina Altagracia ,O,0,0,1,0.00,1,0,0,0,0, ,0,1,0,1,-100.00,1,0,1,2,50.00,0,0,0,0, ,0,0,0, ,0,0,0,0, 
11908,DOM,18,De La Cruz De PeÃ±a Bethania ,OH,15,1,3,16.42,19,15,5,26,46,21.74,1,1,0,2,0.00,3,2,14,19,5.26,1,0,2,3,33.33,10,2,13,61.54,0,0,0,0, 
11908,DOM,20,Martinez Brayelin Elizabeth ,OH,8,1,0,21.88,9,8,2,15,25,24.00,1,0,0,1,100.00,0,0,6,6,0.00,1,1,2,4,0.00,3,1,4,50.00,0,1,0,1,-100.00
11908,DOM,21,Martinez Jineiry ,MB,5,3,2,10.53,10,5,1,8,14,28.57,3,4,0,7,-14.29,2,1,14,17,5.88,0,0,1,1,0.00,1,1,2,0.00,0,0,0,0, 
11908,DOM,23,Gonzalez Lopez Gaila Ceneida ,O,0,0,0, ,0,0,0,0,0, ,0,0,0,0, ,0,0,0,0, ,0,0,0,0, ,0,0,0, ,0,0,0,0, 
11908,DOM,25,Martinez Caro Larysmer ,OH,0,0,0, ,0,0,0,0,0, ,0,0,0,0, ,0,0,0,0, ,0,0,0,0, ,0,0,0, ,0,0,0,0, 
11908,ITA,2,Bosio Francesca ,S,0,0,2,-12.00,2,0,0,0,0, ,0,5,1,6,-83.33,2,0,17,19,10.53,0,1,0,1,-100.00,3,2,5,20.00,19,0,117,136,13.97
11908,ITA,4,Bonifacio Sara ,MB,3,0,0,0.00,3,3,0,2,5,60.00,0,1,1,2,-50.00,0,2,2,4,-50.00,0,0,0,0, ,1,1,2,0.00,0,0,0,0, 
11908,ITA,15,Nwakalor Sylvia Chinelo ,O,0,0,0, ,0,0,0,0,0, ,0,0,0,0, ,0,0,0,0, ,0,0,0,0, ,0,0,0, ,0,0,0,0, 
11908,ITA,19,Mingardi Camilla ,OH,25,1,0,16.46,26,25,6,29,60,31.67,1,3,1,5,-40.00,0,4,10,14,-28.57,0,0,0,0, ,11,3,14,57.14,0,0,0,0, 
11908,ITA,21,Lubian Marina ,MB,2,1,0,-10.53,3,2,2,4,8,0.00,1,1,1,3,0.00,0,2,6,8,-25.00,0,0,1,1,0.00,2,0,2,100.00,0,0,1,1,0.00
11908,ITA,22,Morello Rachele ,S,0,0,0, ,0,0,0,0,0, ,0,0,0,0, ,0,0,0,0, ,0,0,0,0, ,0,0,0, ,1,0,6,7,14.29
11908,ITA,23,De Bortoli Chiara ,L,0,0,0, ,0,0,0,0,0, ,0,0,0,0, ,0,0,0,0, ,3,1,1,5,40.00,2,0,2,100.00,0,0,1,1,0.00
11908,ITA,24,Mazzaro Alessia ,MB,10,4,0,25.64,14,10,1,5,16,56.25,4,3,3,10,10.00,0,0,13,13,0.00,0,0,0,0, ,4,2,6,33.33,0,0,1,1,0.00
11908,ITA,25,Piva Rebecca ,OH,0,0,0,-30.00,0,0,2,6,8,-25.00,0,0,0,0, ,0,1,1,2,-50.00,1,0,6,7,14.29,2,1,3,33.33,0,0,0,0, 
11908,ITA,27,Furlan Eleonora ,MB,0,0,0, ,0,0,0,0,0, ,0,0,0,0, ,0,0,0,0, ,0,0,0,0, ,0,0,0, ,0,0,0,0, 
11908,ITA,28,Melli Giulia ,OH,11,2,0,10.87,13,11,6,13,30,16.67,2,1,0,3,33.33,0,1,12,13,-7.69,9,3,8,20,30.00,10,3,13,53.85,0,0,1,1,0.00
11908,ITA,29,D'Odorico Sofia ,OH,2,0,0,-9.68,2,2,3,13,18,-5.56,0,0,0,0, ,0,2,11,13,-15.38,6,2,4,12,33.33,3,3,6,0.00,0,0,0,0, 
11908,ITA,31,Fersino Eleonora ,L,0,0,0, ,0,0,0,0,0, ,0,0,0,0, ,0,0,0,0, ,17,3,12,32,43.75,18,3,25,60.00,0,0,6,6,0.00
11908,ITA,32,Omoruyi Oghosasere Loveth ,OH,3,0,0,9.09,3,3,2,2,7,14.29,0,0,0,0, ,0,0,4,4,0.00,3,0,3,6,50.00,0,0,0, ,0,0,0,0, 
11909,POL,1,Nowicka Julia ,S,0,0,0,0.00,0,0,0,0,0, ,0,0,0,0, ,0,0,3,3,0.00,0,0,0,0, ,3,1,5,40.00,0,0,4,4,0.00
11909,POL,3,Alagierska Klaudia ,MB,4,0,0,-17.39,4,4,1,2,7,42.86,0,5,1,6,-83.33,0,2,8,10,-20.00,0,0,0,0, ,2,1,4,25.00,0,0,4,4,0.00
11909,POL,8,Stenzel Maria ,L,0,0,0, ,0,0,0,0,0, ,0,0,0,0, ,0,0,0,0, ,10,0,7,17,58.82,10,1,11,81.82,0,0,9,9,0.00
11909,POL,9,Stysiak Magdalena ,O,9,3,2,-2.00,14,9,9,15,33,0.00,3,1,0,4,50.00,2,5,6,13,-23.08,3,0,12,15,20.00,2,1,3,33.33,0,0,1,1,0.00
11909,POL,10,Efimienko-Mlotkowska Zuzanna ,MB,2,0,1,-5.26,3,2,0,5,7,28.57,0,2,3,5,-40.00,1,2,4,7,-14.29,0,0,0,0, ,1,1,2,0.00,0,0,0,0, 
11909,POL,11,Lukasik Martyna ,O,0,0,0, ,0,0,0,0,0, ,0,0,0,0, ,0,0,0,0, ,0,0,0,0, ,0,0,0, ,0,0,0,0, 
11909,POL,13,Jagla Monika ,L,0,0,0, ,0,0,0,0,0, ,0,0,0,0, ,0,0,0,0, ,0,0,0,0, ,6,0,7,85.71,0,0,3,3,0.00
11909,POL,17,Smarzek Malwina ,O,13,0,0,9.43,13,13,4,22,39,23.08,0,3,1,4,-75.00,0,1,9,10,-10.00,0,0,3,3,0.00,7,1,10,60.00,0,0,3,3,0.00
11909,POL,19,Fedusio Monika ,OH,0,0,0, ,0,0,0,0,0, ,0,0,0,0, ,0,0,0,0, ,0,0,0,0, ,0,0,0, ,0,0,0,0, 
11909,POL,20,Czyrnianska Martyna ,OH,3,4,0,3.23,7,3,4,9,16,-6.25,4,1,3,8,37.50,0,1,6,7,-14.29,6,1,17,24,20.83,4,3,7,14.29,0,0,0,0, 
11909,POL,26,Wenerska Katarzyna ,S,1,0,1,-12.50,2,1,0,0,1,100.00,0,0,0,0, ,1,4,10,15,-20.00,0,0,0,0, ,9,3,12,50.00,11,0,73,84,13.10
11909,POL,30,Rozanski Olivia ,OH,0,0,0,-50.00,0,0,1,1,2,-50.00,0,0,0,0, ,0,0,0,0, ,0,0,0,0, ,0,0,0, ,0,0,0,0, 
11909,POL,78,Gryka Aleksandra ,MB,0,0,0, ,0,0,0,0,0, ,0,0,0,0, ,0,0,0,0, ,0,0,0,0, ,0,0,0, ,0,0,0,0, 
11909,POL,88,Gorecka Zuzanna ,OH,1,0,0,-25.00,1,1,2,0,3,-33.33,0,0,0,0, ,0,0,1,1,0.00,0,0,6,6,0.00,2,0,2,100.00,0,0,1,1,0.00
11909,BRA,2,De Oliveira Saad Gattaz Caroline ,MB,4,3,0,-3.33,7,4,1,4,9,33.33,3,5,3,11,-18.18,0,2,8,10,-20.00,0,0,1,1,0.00,3,0,3,100.00,0,0,1,1,0.00
11909,BRA,5,Da Silva Adenizia ,MB,0,0,0,-40.00,0,0,0,1,1,0.00,0,2,0,2,-100.00,0,0,2,2,0.00,0,0,0,0, ,0,0,0, ,0,0,0,0, 
11909,BRA,6,Alexandre Costa Nunes Nyeme Victoria ,L,0,0,0, ,0,0,0,0,0, ,0,0,0,0, ,0,0,0,0, ,0,0,0,0, ,0,0,0, ,0,0,0,0, 
11909,BRA,7,Montibeller Rosamaria ,OH,3,0,0,75.00,3,3,0,0,3,100.00,0,0,1,1,0.00,0,0,0,0, ,0,0,0,0, ,0,0,0, ,0,0,0,0, 
11909,BRA,8,Silva Carneiro Macris Fernanda ,S,0,0,1,5.56,1,0,0,0,0, ,0,0,2,2,0.00,1,0,15,16,6.25,0,0,0,0, ,4,1,5,60.00,10,1,53,64,14.06
11909,BRA,9,Ratzke Roberta Silva ,S,0,0,0,-20.00,0,0,0,0,0, ,0,0,0,0, ,0,1,4,5,-20.00,0,0,0,0, ,3,0,3,100.00,2,0,15,17,11.76
11909,BRA,10,Braga Guimaraes Gabriela ,OH,12,3,0,18.18,15,12,3,10,25,36.00,3,3,1,7,0.00,0,1,11,12,-8.33,5,2,9,16,18.75,7,2,9,55.56,0,0,0,0, 
11909,BRA,11,Caixeta Tandara ,OH,11,3,0,9.52,14,11,8,9,28,10.71,3,1,2,6,33.33,0,1,7,8,-12.50,0,0,0,0, ,5,1,7,57.14,0,0,2,2,0.00
11909,BRA,13,Castro De Paula Blassioli Sheilla ,O,1,0,0,0.00,1,1,0,4,5,20.00,0,0,1,1,0.00,0,1,0,1,-100.00,0,0,0,0, ,0,0,0, ,0,0,0,0, 
11909,BRA,15,Da Silva Ana Carolina ,MB,2,2,0,-11.11,4,2,1,3,6,16.67,2,4,0,6,-33.33,0,1,5,6,-16.67,0,0,0,0, ,0,1,1,-100.00,0,0,1,1,0.00
11909,BRA,16,Rodrigues Fernanda ,OH,4,2,0,-2.56,6,4,3,10,17,5.88,2,2,6,10,0.00,0,2,10,12,-16.67,8,1,15,24,29.17,8,4,13,30.77,0,0,5,5,0.00
11909,BRA,17,Menezes Oliveira de Souza Ana Cristina ,OH,0,0,0,0.00,0,0,0,0,0, ,0,0,0,0, ,0,0,2,2,0.00,0,0,0,0, ,0,0,0, ,0,0,0,0, 
11909,BRA,18,Brait Camila ,L,0,0,0, ,0,0,0,0,0, ,0,0,0,0, ,0,0,0,0, ,4,1,5,10,30.00,15,1,21,66.67,0,0,3,3,0.00
11909,BRA,28,Araujo De Souza Mayany Cristina ,MB,0,0,0, ,0,0,0,0,0, ,0,0,0,0, ,0,0,0,0, ,0,0,0,0, ,0,0,0, ,0,0,0,0, 
11910,TUR,2,Akoz Simge Sebnem ,L,0,0,0, ,0,0,0,0,0, ,0,0,0,0, ,0,0,0,0, ,7,0,1,8,87.50,10,1,11,81.82,0,0,5,5,0.00
11910,TUR,3,Ãzbay Cansu ,S,2,1,0,8.33,3,2,0,3,5,40.00,1,1,1,3,0.00,0,1,3,4,-25.00,0,0,0,0, ,8,2,10,60.00,12,1,73,86,12.79
11910,TUR,4,Senoglu Tugba ,OH,0,0,0, ,0,0,0,0,0, ,0,0,0,0, ,0,0,0,0, ,0,0,0,0, ,0,0,0, ,0,0,0,0, 
11910,TUR,5,Ercan Seyma ,OH,0,0,0, ,0,0,0,0,0, ,0,0,0,0, ,0,0,0,0, ,0,0,0,0, ,0,0,0, ,0,0,0,0, 
11910,TUR,7,Baladin Hande ,OH,16,0,1,14.29,17,16,5,12,33,33.33,0,3,0,3,-100.00,1,2,10,13,-7.69,8,1,10,19,36.84,6,0,7,85.71,0,0,1,1,0.00
11910,TUR,9,Ismailoglu Meliha ,OH,8,0,0,14.29,8,8,2,5,15,40.00,0,1,1,2,-50.00,0,1,10,11,-9.09,7,1,11,19,31.58,13,1,14,85.71,0,0,1,1,0.00
11910,TUR,12,Unal Buse ,S,0,0,0, ,0,0,0,0,0, ,0,0,0,0, ,0,0,0,0, ,0,0,0,0, ,0,0,0, ,0,0,0,0, 
11910,TUR,13,Boz Meryem ,O,0,0,1,0.00,1,0,0,0,0, ,0,0,0,0, ,1,1,2,4,0.00,0,0,0,0, ,0,0,0, ,0,0,0,0, 
11910,TUR,14,Erdem DÃ¼ndar Eda ,MB,8,1,0,10.34,9,8,3,3,14,35.71,1,1,3,5,0.00,0,2,8,10,-20.00,0,0,0,0, ,4,2,6,33.33,0,0,2,2,0.00
11910,TUR,18,Gunes Zehra ,MB,4,1,1,0.00,6,4,3,1,8,12.50,1,1,5,7,0.00,1,2,11,14,-7.14,0,1,0,1,-100.00,0,1,1,-100.00,0,0,5,5,0.00
11910,TUR,19,Kalac Asli ,MB,0,0,0, ,0,0,0,0,0, ,0,0,0,0, ,0,0,0,0, ,0,0,0,0, ,0,0,0, ,0,0,0,0, 
11910,TUR,20,Cebecioglu Derya ,OH,0,0,0, ,0,0,0,0,0, ,0,0,0,0, ,0,0,0,0, ,0,0,0,0, ,0,0,0, ,0,0,0,0, 
11910,TUR,22,Aydin Ä°lkin ,OH,0,0,0, ,0,0,0,0,0, ,0,0,0,0, ,0,0,0,0, ,0,0,0,0, ,0,0,0, ,0,0,0,0, 
11910,TUR,99,Karakurt Ebrar ,OH,13,1,2,11.76,16,13,7,10,30,20.00,1,1,1,3,0.00,2,2,14,18,0.00,1,0,0,1,100.00,8,0,8,100.00,0,0,1,1,0.00
11910,BEL,2,Van Sas Elise ,S,0,0,0, ,0,0,0,0,0, ,0,0,0,0, ,0,0,0,0, ,0,0,0,0, ,0,0,0, ,0,0,0,0, 
11910,BEL,3,Herbots Britt ,OH,11,0,0,3.57,11,11,4,25,40,17.50,0,1,1,2,-50.00,0,4,10,14,-28.57,7,1,7,15,40.00,4,2,7,28.57,0,0,1,1,0.00
11910,BEL,4,Lemmens Nathalie ,MB,0,0,0, ,0,0,0,0,0, ,0,0,0,0, ,0,0,0,0, ,0,0,0,0, ,0,0,0, ,0,0,0,0, 
11910,BEL,5,Guilliams Jodie ,OH,1,1,0,-20.83,2,1,2,10,13,-7.69,1,3,0,4,-50.00,0,2,5,7,-28.57,3,2,6,11,9.09,4,3,7,14.29,0,0,0,0, 
11910,BEL,6,Gilson Helena ,OH,0,0,0,-33.33,0,0,1,3,4,-25.00,0,1,0,1,-100.00,0,0,1,1,0.00,0,0,0,0, ,0,1,1,-100.00,0,0,0,0, 
11910,BEL,7,Van Gestel Celine ,OH,3,0,0,-6.90,3,3,2,14,19,5.26,0,2,0,2,-100.00,0,1,7,8,-12.50,0,0,4,4,0.00,1,3,4,-50.00,0,0,3,3,0.00
11910,BEL,9,Demeyer Nel ,L,0,0,0, ,0,0,0,0,0, ,0,0,0,0, ,0,0,0,0, ,0,0,0,0, ,0,0,0, ,0,0,0,0, 
11910,BEL,10,Sobolska Dominika ,MB,0,4,0,33.33,4,0,0,3,3,0.00,4,1,0,5,60.00,0,0,1,1,0.00,0,0,1,1,0.00,1,0,1,100.00,0,0,2,2,0.00
11910,BEL,11,De Tant Amber ,L,0,0,0, ,0,0,0,0,0, ,0,0,0,0, ,0,0,0,0, ,0,0,0,0, ,0,0,0, ,0,0,0,0, 
11910,BEL,13,Janssens Marlies ,MB,2,1,1,12.50,4,2,0,3,5,40.00,1,1,2,4,0.00,1,1,5,7,0.00,0,0,0,0, ,1,0,1,100.00,0,0,0,0, 
11910,BEL,17,Van De Vyver Ilka ,S,0,0,2,0.00,2,0,0,3,3,0.00,0,1,0,1,-100.00,2,1,10,13,7.69,0,0,0,0, ,3,3,6,0.00,2,0,77,79,2.53
11910,BEL,18,Rampelberg Britt ,L,0,0,0, ,0,0,0,0,0, ,0,0,0,0, ,0,0,0,0, ,13,2,17,32,34.38,11,12,23,-4.35,0,0,3,3,0.00
11910,BEL,19,Van Avermaet Silke ,MB,2,0,0,7.69,2,2,0,4,6,33.33,0,1,1,2,-50.00,0,0,5,5,0.00,0,0,0,0, ,0,0,0, ,0,0,0,0, 
11910,BEL,21,Stragier Manon ,OH,0,0,0,0.00,0,0,0,0,0, ,0,0,0,0, ,0,0,1,1,0.00,0,0,0,0, ,0,0,0, ,0,0,0,0, 
11911,USA,1,Hancock Micha ,S,0,2,0,-5.88,2,0,0,1,1,0.00,2,0,3,5,40.00,0,3,8,11,-27.27,0,0,0,0, ,10,6,16,25.00,17,1,51,69,23.19
11911,USA,2,Poulter Jordyn ,S,0,0,1,14.29,1,0,0,0,0, ,0,0,0,0, ,1,0,6,7,14.29,0,0,0,0, ,3,0,3,100.00,8,0,20,28,28.57
11911,USA,4,Wong-Orantes Justine ,L,0,0,0, ,0,0,0,0,0, ,0,0,0,0, ,0,0,0,0, ,5,2,0,7,42.86,14,0,14,100.00,1,0,12,13,7.69
11911,USA,6,Dixon Tetori ,MB,0,0,0, ,0,0,0,0,0, ,0,0,0,0, ,0,0,0,0, ,0,0,0,0, ,0,0,0, ,0,0,0,0, 
11911,USA,10,Larson Jordan ,OH,0,0,0, ,0,0,0,0,0, ,0,0,0,0, ,0,0,0,0, ,0,0,0,0, ,0,0,0, ,0,0,0,0, 
11911,USA,11,Drews Andrea ,O,9,0,1,9.76,10,9,2,15,26,26.92,0,3,7,10,-30.00,1,1,3,5,0.00,0,0,0,0, ,5,1,8,50.00,0,0,2,2,0.00
11911,USA,12,Thompson Jordan ,O,7,0,0,40.00,7,7,0,4,11,63.64,0,0,3,3,0.00,0,1,0,1,-100.00,0,0,0,0, ,0,0,0, ,0,0,1,1,0.00
11911,USA,13,Wilhite Sarah ,OH,0,0,0, ,0,0,0,0,0, ,0,0,0,0, ,0,0,0,0, ,0,0,0,0, ,0,0,0, ,0,0,0,0, 
11911,USA,14,Bartsch-Hackley Michelle ,OH,12,1,1,20.41,14,12,0,15,27,44.44,1,3,3,7,-28.57,1,1,13,15,0.00,14,1,14,29,44.83,10,2,13,61.54,0,0,4,4,0.00
11911,USA,15,Hill Kimberly ,OH,0,0,0,-25.00,0,0,0,0,0, ,0,0,0,0, ,0,1,3,4,-25.00,0,0,0,0, ,0,0,0, ,0,0,1,1,0.00
11911,USA,16,Akinradewo Foluke ,MB,0,0,0, ,0,0,0,0,0, ,0,0,0,0, ,0,0,0,0, ,0,0,0,0, ,0,0,0, ,0,0,0,0, 
11911,USA,22,Washington Haleigh ,MB,7,1,0,14.29,8,7,0,6,13,53.85,1,4,4,9,-33.33,0,0,6,6,0.00,0,0,0,0, ,0,2,2,-100.00,0,0,0,0, 
11911,USA,23,Robinson Kelsey ,OH,11,1,2,11.54,14,11,3,14,28,28.57,1,2,5,8,-12.50,2,3,11,16,-6.25,14,1,13,28,46.43,15,1,16,87.50,0,1,0,1,-100.00
11911,USA,24,Ogbogu Chiaka ,MB,3,4,0,2.94,7,3,1,5,9,22.22,4,3,11,18,5.56,0,2,5,7,-28.57,0,0,0,0, ,2,0,3,66.67,0,0,0,0, 
11911,JPN,1,Kurogo Ai ,OH,12,0,3,13.46,15,12,4,14,30,26.67,0,2,3,5,-40.00,3,2,12,17,5.88,0,0,2,2,0.00,14,5,19,47.37,0,0,1,1,0.00
11911,JPN,3,Shimamura Haruyo ,MB,5,0,1,0.00,6,5,0,7,12,41.67,0,6,5,11,-54.55,1,0,5,6,16.67,1,0,1,2,50.00,4,0,5,80.00,0,0,2,2,0.00
11911,JPN,5,Araki Erika ,MB,0,0,0, ,0,0,0,0,0, ,0,0,0,0, ,0,0,0,0, ,0,0,0,0, ,0,0,0, ,0,0,0,0, 
11911,JPN,7,Ishii Yuki ,OH,11,1,0,10.91,12,11,5,23,39,15.38,1,1,2,4,0.00,0,0,12,12,0.00,12,4,15,31,25.81,8,3,12,41.67,0,0,6,6,0.00
11911,JPN,8,Ishikawa Mayu ,OH,2,0,0,-15.38,2,2,2,5,9,0.00,0,1,0,1,-100.00,0,1,2,3,-33.33,2,1,1,4,25.00,1,0,1,100.00,0,0,2,2,0.00
11911,JPN,9,Tashiro Kanami ,S,1,0,0,-15.38,1,1,0,2,3,33.33,0,3,0,3,-100.00,0,0,7,7,0.00,0,0,0,0, ,14,2,18,66.67,10,1,76,87,10.34
11911,JPN,10,Akutagawa Aika ,MB,0,0,0,-33.33,0,0,0,1,1,0.00,0,0,0,0, ,0,1,1,2,-50.00,0,0,0,0, ,0,0,0, ,0,0,0,0, 
11911,JPN,11,Nabeya Yurie ,OH,2,0,0,12.50,2,2,1,2,5,20.00,0,0,0,0, ,0,0,3,3,0.00,1,0,1,2,50.00,0,1,2,-50.00,0,0,1,1,0.00
11911,JPN,13,Okumura Mai ,MB,0,0,0,-12.50,0,0,0,6,6,0.00,0,3,5,8,-37.50,0,0,10,10,0.00,0,0,2,2,0.00,8,1,9,77.78,0,0,1,1,0.00
11911,JPN,14,Kobata Mako ,L,0,0,0, ,0,0,0,0,0, ,0,0,0,0, ,0,0,0,0, ,0,0,0,0, ,0,0,0, ,0,0,0,0, 
11911,JPN,15,Inoue Kotoe ,L,0,0,0, ,0,0,0,0,0, ,0,0,0,0, ,0,0,0,0, ,1,0,5,6,16.67,10,5,16,31.25,0,0,14,14,0.00
11911,JPN,19,Yamada Nichika ,MB,0,0,0, ,0,0,0,0,0, ,0,0,0,0, ,0,0,0,0, ,0,0,0,0, ,0,0,0, ,0,0,0,0, 
11911,JPN,20,Seki Nanami ,S,0,0,0,0.00,0,0,0,0,0, ,0,0,0,0, ,0,0,2,2,0.00,0,0,0,0, ,2,1,3,33.33,1,0,9,10,10.00
11911,JPN,21,Hayashi Kotona ,OH,8,0,0,9.38,8,8,3,12,23,21.74,0,1,1,2,-50.00,0,1,6,7,-14.29,2,0,9,11,18.18,10,3,13,53.85,0,0,3,3,0.00
11912,ITA,2,Bosio Francesca ,S,0,0,1,-7.41,1,0,0,0,0, ,0,3,4,7,-42.86,1,0,19,20,5.00,0,0,0,0, ,7,5,12,16.67,9,0,120,129,6.98
11912,ITA,4,Bonifacio Sara ,MB,5,1,2,0.00,8,5,0,12,17,29.41,1,7,1,9,-66.67,2,1,17,20,5.00,0,0,0,0, ,3,3,6,0.00,0,0,2,2,0.00
11912,ITA,12,Guerra Anastasia ,OH,0,0,0, ,0,0,0,0,0, ,0,0,0,0, ,0,0,0,0, ,0,0,0,0, ,0,0,0, ,1,0,0,1,100.00
11912,ITA,15,Nwakalor Sylvia Chinelo ,O,25,1,1,18.18,27,25,8,25,58,29.31,1,1,1,3,0.00,1,4,11,16,-18.75,0,0,0,0, ,15,6,21,42.86,0,0,1,1,0.00
11912,ITA,19,Mingardi Camilla ,OH,0,0,0,-16.67,0,0,0,4,4,0.00,0,0,0,0, ,0,1,1,2,-50.00,0,0,1,1,0.00,2,0,2,100.00,0,0,0,0, 
11912,ITA,21,Lubian Marina ,MB,0,0,0,-25.00,0,0,1,1,2,-50.00,0,0,1,1,0.00,0,0,1,1,0.00,0,0,0,0, ,0,0,0, ,0,0,0,0, 
11912,ITA,22,Morello Rachele ,S,0,0,0, ,0,0,0,0,0, ,0,0,0,0, ,0,0,0,0, ,0,0,0,0, ,0,0,0, ,0,0,8,8,0.00
11912,ITA,23,De Bortoli Chiara ,L,0,0,0, ,0,0,0,0,0, ,0,0,0,0, ,0,0,0,0, ,6,2,15,23,17.39,22,5,27,62.96,0,0,24,24,0.00
11912,ITA,24,Mazzaro Alessia ,MB,6,4,1,14.71,11,6,1,4,11,45.45,4,4,1,9,0.00,1,1,12,14,0.00,0,0,0,0, ,0,2,2,-100.00,0,0,0,0, 
11912,ITA,25,Piva Rebecca ,OH,8,2,0,2.86,10,8,5,6,19,15.79,2,1,0,3,33.33,0,3,10,13,-23.08,6,1,17,24,20.83,7,4,11,27.27,0,0,1,1,0.00
11912,ITA,27,Furlan Eleonora ,MB,0,0,0, ,0,0,0,0,0, ,0,0,0,0, ,0,0,0,0, ,0,0,0,0, ,0,0,0, ,0,0,0,0, 
11912,ITA,28,Melli Giulia ,OH,19,2,0,27.69,21,19,2,26,47,36.17,2,1,0,3,33.33,0,0,15,15,0.00,8,3,24,35,14.29,6,7,14,-7.14,0,0,3,3,0.00
11912,ITA,31,Fersino Eleonora ,L,0,0,0, ,0,0,0,0,0, ,0,0,0,0, ,0,0,0,0, ,1,0,5,6,16.67,0,0,0, ,0,0,0,0, 
11912,ITA,32,Omoruyi Oghosasere Loveth ,OH,3,0,1,-5.26,4,3,3,7,13,0.00,0,1,0,1,-100.00,1,1,3,5,0.00,2,0,4,6,33.33,3,2,5,20.00,0,0,0,0, 
11912,NED,2,Savelkoel Fleur ,OH,0,0,0, ,0,0,0,0,0, ,0,0,0,0, ,0,0,0,0, ,0,0,0,0, ,0,0,0, ,0,0,0,0, 
11912,NED,4,Plak Celeste ,OH,12,0,0,22.22,12,12,3,3,18,50.00,0,2,1,3,-66.67,0,1,5,6,-16.67,0,0,0,0, ,2,1,4,25.00,0,0,0,0, 
11912,NED,7,Lohuis Juliet ,MB,11,1,3,10.91,15,11,1,8,20,50.00,1,5,3,9,-44.44,3,3,20,26,0.00,0,0,0,0, ,4,1,6,50.00,0,0,2,2,0.00
11912,NED,8,Korevaar Demi ,MB,0,0,0,0.00,0,0,0,0,0, ,0,0,0,0, ,0,0,1,1,0.00,0,0,0,0, ,0,0,0, ,0,0,0,0, 
11912,NED,9,Schoot Myrthe ,L,0,0,0, ,0,0,0,0,0, ,0,0,0,0, ,0,0,0,0, ,9,0,6,15,60.00,18,5,24,54.17,0,0,11,11,0.00
11912,NED,10,van Aalen Sarah ,S,0,0,0, ,0,0,0,0,0, ,0,0,0,0, ,0,0,0,0, ,0,0,0,0, ,0,0,0, ,0,0,0,0, 
11912,NED,11,Buijs Anne ,OH,14,1,0,10.71,15,14,4,25,43,23.26,1,2,1,4,-25.00,0,3,6,9,-33.33,12,2,19,33,30.30,1,2,3,-33.33,0,0,2,2,0.00
11912,NED,12,Bongaerts Britt ,S,4,3,0,6.90,7,4,1,3,8,37.50,3,3,4,10,0.00,0,1,10,11,-9.09,0,0,0,0, ,6,5,11,9.09,22,1,118,141,14.89
11912,NED,18,Jasper Marrit ,OH,0,0,1,11.11,1,0,0,0,0, ,0,0,0,0, ,1,0,8,9,11.11,2,1,0,3,33.33,2,1,3,33.33,0,0,0,0, 
11912,NED,19,Daalderop Nika ,OH,16,2,2,14.08,20,16,1,26,43,34.88,2,6,2,10,-40.00,2,3,13,18,-5.56,18,3,22,43,34.88,13,3,16,62.50,0,0,0,0, 
11912,NED,21,Meijers Annick ,OH,0,0,0, ,0,0,0,0,0, ,0,0,0,0, ,0,0,0,0, ,0,0,0,0, ,0,0,0, ,0,0,0,0, 
11912,NED,23,Timmerman Eline ,MB,7,0,0,-11.11,7,7,3,6,16,25.00,0,4,1,5,-80.00,0,4,11,15,-26.67,1,0,0,1,100.00,1,0,2,50.00,0,0,4,4,0.00
11912,NED,25,Reesink Florien ,L,0,0,0, ,0,0,0,0,0, ,0,0,0,0, ,0,0,0,0, ,0,0,0,0, ,0,0,0, ,0,0,0,0, 
11912,NED,27,Scholten Iris ,O,5,2,0,11.11,7,5,2,11,18,16.67,2,1,0,3,33.33,0,0,15,15,0.00,0,0,0,0, ,6,1,7,71.43,0,0,1,1,0.00
11913,DOM,1,Vargas Valdez Annerys Victoria ,MB,0,0,0, ,0,0,0,0,0, ,0,0,0,0, ,0,0,0,0, ,0,0,0,0, ,0,0,0, ,0,0,0,0, 
11913,DOM,3,Eve Mejia Lisvel Elisa ,U,0,0,0,0.00,0,0,0,0,0, ,0,0,0,0, ,0,0,4,4,0.00,0,0,2,2,0.00,0,1,1,-100.00,0,0,1,1,0.00
11913,DOM,5,Castillo Brenda ,L,0,0,0, ,0,0,0,0,0, ,0,0,0,0, ,0,0,0,0, ,7,0,12,19,36.84,15,4,21,52.38,1,0,23,24,4.17
11913,DOM,6,Dominguez Martinez Camil Inmaculada ,S,1,0,1,0.00,2,1,1,1,3,0.00,0,0,2,2,0.00,1,1,7,9,0.00,0,0,0,0, ,3,3,6,0.00,13,1,77,91,13.19
11913,DOM,7,Marte Frica Niverka Dharlenis ,S,0,0,0, ,0,0,0,0,0, ,0,0,0,0, ,0,0,0,0, ,0,0,0,0, ,0,0,0, ,0,0,0,0, 
11913,DOM,11,Rodriguez Marifranchi ,MB,3,0,0,-4.76,3,3,0,5,8,37.50,0,1,0,1,-100.00,0,3,9,12,-25.00,1,0,1,2,50.00,1,0,1,100.00,0,0,0,0, 
11913,DOM,12,Perez Flores Yokaty ,S,0,0,0, ,0,0,0,0,0, ,0,0,0,0, ,0,0,0,0, ,0,0,0,0, ,1,0,1,100.00,0,0,10,10,0.00
11913,DOM,14,Rivera Brens Prisilla ,OH,17,1,2,17.65,20,17,6,11,34,32.35,1,2,1,4,-25.00,2,3,8,13,-7.69,4,2,17,23,8.70,9,1,14,57.14,0,0,1,1,0.00
11913,DOM,16,PeÃ±a Isabel Yonkaira Paola ,OH,16,1,0,13.79,17,16,7,15,38,23.68,1,0,1,2,50.00,0,2,16,18,-11.11,9,1,33,43,18.60,10,3,14,50.00,0,0,0,0, 
11913,DOM,17,Mambru Casilla Gina Altagracia ,O,10,0,0,2.27,10,10,5,12,27,18.52,0,4,0,4,-100.00,0,0,13,13,0.00,0,0,0,0, ,7,2,10,50.00,0,0,3,3,0.00
11913,DOM,18,De La Cruz De PeÃ±a Bethania ,OH,2,0,0,16.67,2,2,0,2,4,50.00,0,0,0,0, ,0,1,1,2,-50.00,0,0,0,0, ,2,0,2,100.00,0,0,0,0, 
11913,DOM,20,Martinez Brayelin Elizabeth ,OH,0,0,0,-50.00,0,0,1,1,2,-50.00,0,0,0,0, ,0,0,0,0, ,0,0,0,0, ,0,0,0, ,0,0,0,0, 
11913,DOM,21,Martinez Jineiry ,MB,12,1,0,15.00,13,12,2,8,22,45.45,1,3,3,7,-28.57,0,2,9,11,-18.18,0,0,0,0, ,6,2,8,50.00,0,0,2,2,0.00
11913,DOM,25,Martinez Caro Larysmer ,OH,0,0,0, ,0,0,0,0,0, ,0,0,0,0, ,0,0,0,0, ,0,0,0,0, ,0,0,0, ,0,0,0,0, 
11913,CHN,1,Yuan Xinyue ,MB,6,4,1,-1.67,11,6,1,9,16,31.25,4,11,4,19,-36.84,1,0,24,25,4.00,0,0,0,0, ,2,0,2,100.00,0,0,1,1,0.00
11913,CHN,2,Zhu Ting ,OH,14,2,0,19.23,16,14,1,14,29,44.83,2,5,2,9,-33.33,0,0,14,14,0.00,3,0,6,9,33.33,7,1,9,66.67,0,0,2,2,0.00
11913,CHN,4,Yang Hanyu ,MB,0,0,0,-40.00,0,0,0,1,1,0.00,0,2,1,3,-66.67,0,0,1,1,0.00,0,0,0,0, ,0,1,1,-100.00,0,0,0,0, 
11913,CHN,6,Gong Xiangyu ,O,9,1,0,2.13,10,9,6,13,28,10.71,1,1,4,6,0.00,0,2,11,13,-15.38,4,1,6,11,27.27,9,4,15,33.33,0,0,1,1,0.00
11913,CHN,7,Wang Yuanyuan ,MB,0,0,0, ,0,0,0,0,0, ,0,0,0,0, ,0,0,0,0, ,0,0,0,0, ,0,0,0, ,0,0,0,0, 
11913,CHN,8,Li Yao ,OH,0,0,0, ,0,0,0,0,0, ,0,0,0,0, ,0,0,0,0, ,0,0,0,0, ,0,0,0, ,0,0,0,0, 
11913,CHN,9,Zhang Changning ,OH,11,1,2,37.50,14,11,2,7,20,45.00,1,0,3,4,25.00,2,0,6,8,25.00,5,0,6,11,45.45,9,1,10,80.00,0,0,3,3,0.00
11913,CHN,11,Yao Di ,S,0,1,0,-10.00,1,0,0,1,1,0.00,1,2,1,4,-25.00,0,0,5,5,0.00,0,0,0,0, ,8,0,11,72.73,10,0,36,46,21.74
11913,CHN,12,Li Yingying ,OH,12,1,0,57.14,13,12,0,1,13,92.31,1,0,0,1,100.00,0,1,6,7,-14.29,5,0,6,11,45.45,4,1,5,60.00,0,0,1,1,0.00
11913,CHN,15,Lin Li ,L,0,0,0, ,0,0,0,0,0, ,0,0,0,0, ,0,0,0,0, ,2,0,4,6,33.33,1,0,1,100.00,0,0,0,0, 
11913,CHN,16,Ding Xia ,S,2,1,0,0.00,3,2,0,0,2,100.00,1,3,2,6,-33.33,0,0,6,6,0.00,0,0,0,0, ,5,0,6,83.33,22,1,23,46,45.65
11913,CHN,17,Yan Ni ,MB,2,6,0,0.00,8,2,1,5,8,12.50,6,6,7,19,0.00,0,1,13,14,-7.14,1,0,1,2,50.00,1,0,1,100.00,1,0,5,6,16.67
11913,CHN,18,Wang Mengjie ,L,0,0,0, ,0,0,0,0,0, ,0,0,0,0, ,0,0,0,0, ,6,2,12,20,20.00,4,3,7,14.29,0,0,7,7,0.00
11913,CHN,19,Liu Yanhan ,OH,0,0,0, ,0,0,0,0,0, ,0,0,0,0, ,0,0,0,0, ,0,0,0,0, ,0,0,0, ,0,0,0,0, 
11914,RUS,4,Pilipenko Daria ,L,0,0,0, ,0,0,0,0,0, ,0,0,0,0, ,0,0,0,0, ,0,0,0,0, ,0,0,0, ,0,0,0,0, 
11914,RUS,5,Fedorovtseva Arina ,OH,13,1,2,41.94,16,13,0,6,19,68.42,1,1,0,2,0.00,2,2,6,10,0.00,4,0,11,15,26.67,6,0,8,75.00,0,0,1,1,0.00
11914,RUS,6,Koroleva Irina ,MB,6,1,2,17.24,9,6,1,2,9,55.56,1,3,7,11,-18.18,2,0,7,9,22.22,0,0,0,0, ,1,0,3,33.33,0,0,2,2,0.00
11914,RUS,8,Goncharova Nataliya ,O,5,1,1,20.83,7,5,1,6,12,33.33,1,0,0,1,100.00,1,1,9,11,0.00,0,0,0,0, ,5,2,9,33.33,0,0,0,0, 
11914,RUS,10,Matveeva Polina ,S,0,1,0,50.00,1,0,0,0,0, ,1,0,0,1,100.00,0,0,1,1,0.00,0,0,0,0, ,2,0,3,66.67,1,0,8,9,11.11
11914,RUS,11,Brovkina Yulia ,MB,0,0,0, ,0,0,0,0,0, ,0,0,0,0, ,0,0,0,0, ,0,0,0,0, ,0,0,0, ,0,0,0,0, 
11914,RUS,12,Lazareva Anna ,O,4,0,0,25.00,4,4,0,4,8,50.00,0,1,1,2,-50.00,0,0,2,2,0.00,0,0,0,0, ,2,0,2,100.00,0,0,0,0, 
11914,RUS,13,Startseva Evgeniya ,S,1,1,0,-6.67,2,1,1,0,2,0.00,1,1,1,3,0.00,0,1,9,10,-10.00,0,0,0,0, ,7,1,8,75.00,8,0,38,46,17.39
11914,RUS,14,Fetisova Irina ,MB,4,1,1,22.22,6,4,0,0,4,100.00,1,2,1,4,-25.00,1,0,9,10,10.00,0,0,2,2,0.00,3,0,4,75.00,0,0,2,2,0.00
11914,RUS,15,Kosheleva Tatyana ,OH,7,0,2,36.00,9,7,0,8,15,46.67,0,0,1,1,0.00,2,0,7,9,22.22,2,2,5,9,0.00,4,0,4,100.00,0,0,2,2,0.00
11914,RUS,16,Voronkova Irina ,OH,0,0,0, ,0,0,0,0,0, ,0,0,0,0, ,0,0,0,0, ,0,0,0,0, ,0,0,0, ,0,0,0,0, 
11914,RUS,19,Podkopaeva Anna ,L,0,0,0, ,0,0,0,0,0, ,0,0,0,0, ,0,0,0,0, ,0,0,5,5,0.00,10,3,13,53.85,0,0,4,4,0.00
11914,RUS,24,Pipunyrova Ekaterina ,OH,0,0,0,-50.00,0,0,0,0,0, ,0,0,0,0, ,0,1,1,2,-50.00,0,0,1,1,0.00,0,0,0, ,0,0,1,1,0.00
11914,RUS,25,Smirnova Kseniia ,OH,0,0,2,-13.33,2,0,1,2,3,-33.33,0,2,1,3,-66.67,2,1,6,9,11.11,1,0,1,2,50.00,1,0,1,100.00,0,0,0,0, 
11914,CAN,1,Bujan Cassandra ,L,0,0,0, ,0,0,0,0,0, ,0,0,0,0, ,0,0,0,0, ,0,2,3,5,-40.00,4,0,5,80.00,0,1,4,5,-20.00
11914,CAN,5,Smith Danielle ,S,0,0,0,-50.00,0,0,0,2,2,0.00,0,2,0,2,-100.00,0,1,1,2,-50.00,0,0,0,0, ,4,0,4,100.00,7,0,28,35,20.00
11914,CAN,6,White Jazmine  Ruth ,MB,1,0,0,-12.50,1,1,0,2,3,33.33,0,3,6,9,-33.33,0,0,4,4,0.00,0,0,0,0, ,0,0,0, ,0,0,1,1,0.00
11914,CAN,7,Van Buskirk Layne ,MB,3,1,0,0.00,4,3,0,4,7,42.86,1,3,6,10,-20.00,0,1,4,5,-20.00,0,0,1,1,0.00,1,1,2,0.00,0,0,0,0, 
11914,CAN,8,Ogoms Alicia ,MB,4,2,0,20.00,6,4,1,1,6,50.00,2,1,0,3,33.33,0,1,5,6,-16.67,0,0,0,0, ,1,1,2,0.00,0,0,0,0, 
11914,CAN,9,Gray Alexa ,OH,0,0,0, ,0,0,0,0,0, ,0,0,0,0, ,0,0,0,0, ,0,0,2,2,0.00,0,0,0, ,0,0,0,0, 
11914,CAN,11,Mitrovic Andrea ,OH,3,0,0,8.33,3,3,2,3,8,12.50,0,0,1,1,0.00,0,0,3,3,0.00,0,3,7,10,-30.00,2,0,2,100.00,0,0,0,0, 
11914,CAN,12,Cross Jennifer ,MB,0,0,0, ,0,0,0,0,0, ,0,0,0,0, ,0,0,0,0, ,0,0,0,0, ,0,0,0, ,0,0,0,0, 
11914,CAN,14,Howe Hilary ,OH,4,0,0,9.09,4,4,2,4,10,20.00,0,0,0,0, ,0,1,0,1,-100.00,1,1,10,12,0.00,1,1,3,0.00,0,0,0,0, 
11914,CAN,15,Joseph Shainah ,O,8,0,2,16.13,10,8,2,7,17,35.29,0,2,2,4,-50.00,2,1,7,10,10.00,0,0,0,0, ,4,1,6,50.00,0,1,1,2,-50.00
11914,CAN,16,Livingston Caroline ,OH,6,0,0,-17.24,6,6,4,7,17,11.76,0,4,0,4,-100.00,0,3,5,8,-37.50,5,2,14,21,14.29,2,3,8,-12.50,0,0,0,0, 
11914,CAN,18,Robitaille Kim ,S,0,0,0,0.00,0,0,0,1,1,0.00,0,0,0,0, ,0,0,2,2,0.00,0,0,2,2,0.00,1,1,2,0.00,7,1,16,24,25.00
11914,CAN,22,Snape Kennedy Brooklyn ,L,0,0,0, ,0,0,0,0,0, ,0,0,0,0, ,0,0,0,0, ,2,1,8,11,9.09,2,1,5,20.00,0,0,2,2,0.00
11914,CAN,23,Austin Parker Jane ,OH,0,0,0,-40.00,0,0,2,1,3,-66.67,0,0,1,1,0.00,0,0,1,1,0.00,0,1,2,3,-33.33,1,0,1,100.00,0,0,0,0, 
11915,KOR,1,Lee Soyoung ,OH,6,0,0,35.71,6,6,0,5,11,54.55,0,0,0,0, ,0,1,2,3,-33.33,1,0,6,7,14.29,3,0,4,75.00,0,0,2,2,0.00
11915,KOR,2,Lee Dahyeon ,MB,4,3,0,-5.13,7,4,2,7,13,15.38,3,5,8,16,-12.50,0,2,8,10,-20.00,0,0,1,1,0.00,3,1,4,50.00,0,0,0,0, 
11915,KOR,5,Han Dahye ,L,0,0,0, ,0,0,0,0,0, ,0,0,0,0, ,0,0,0,0, ,0,0,0,0, ,0,0,0, ,0,0,0,0, 
11915,KOR,6,Kim Dain ,S,1,1,0,0.00,2,1,0,1,2,50.00,1,1,6,8,0.00,0,1,6,7,-14.29,0,1,0,1,-100.00,5,0,5,100.00,6,1,61,68,7.35
11915,KOR,7,An Hyejin ,S,0,1,0,-7.69,1,0,0,1,1,0.00,1,2,2,5,-20.00,0,0,7,7,0.00,0,0,0,0, ,5,0,5,100.00,5,0,40,45,11.11
11915,KOR,8,Park Eunjin ,MB,2,0,3,0.00,5,2,0,3,5,40.00,0,4,5,9,-44.44,3,1,15,19,10.53,0,1,0,1,-100.00,1,0,2,50.00,0,0,2,2,0.00
11915,KOR,9,Oh Jiyoung ,L,0,0,0, ,0,0,0,0,0, ,0,0,0,0, ,0,0,0,0, ,3,3,12,18,0.00,26,5,33,63.64,0,0,6,6,0.00
11915,KOR,10,Kim Yeon Koung ,OH,27,0,0,27.03,27,27,5,18,50,44.00,0,1,3,4,-25.00,0,1,19,20,-5.00,4,2,13,19,10.53,24,1,26,88.46,0,0,5,5,0.00
11915,KOR,12,Han Songyi ,MB,0,0,0, ,0,0,0,0,0, ,0,0,0,0, ,0,0,0,0, ,0,0,0,0, ,0,0,0, ,0,0,0,0, 
11915,KOR,13,Park Jeongah ,OH,8,3,1,22.50,12,8,0,14,22,36.36,3,0,4,7,42.86,1,3,7,11,-18.18,4,4,13,21,0.00,3,1,5,40.00,0,0,3,3,0.00
11915,KOR,14,Yang Hyo Jin ,MB,0,0,0, ,0,0,0,0,0, ,0,0,0,0, ,0,0,0,0, ,0,0,0,0, ,0,0,0, ,0,0,0,0, 
11915,KOR,15,Yuk Seoyoung ,OH,0,0,0, ,0,0,0,0,0, ,0,0,0,0, ,0,0,0,0, ,0,0,0,0, ,0,0,0, ,0,0,0,0, 
11915,KOR,16,Jeong Jiyun ,O,11,2,1,5.66,14,11,7,9,27,14.81,2,2,2,6,0.00,1,2,17,20,-5.00,0,0,0,0, ,7,3,12,33.33,0,0,3,3,0.00
11915,KOR,19,Pyo Seungju ,OH,0,0,0, ,0,0,0,0,0, ,0,0,0,0, ,0,0,0,0, ,0,0,0,0, ,0,0,0, ,0,0,0,0, 
11915,SRB,6,Uzelac Aleksandra ,OH,3,0,1,-4.55,4,3,2,7,12,8.33,0,2,1,3,-66.67,1,1,5,7,0.00,1,1,2,4,0.00,8,0,9,88.89,0,0,0,0, 
11915,SRB,7,Jaksic Ana ,S,0,0,0,-22.22,0,0,0,2,2,0.00,0,1,2,3,-33.33,0,1,3,4,-25.00,0,1,0,1,-100.00,1,1,3,0.00,3,0,30,33,9.09
11915,SRB,21,Kocic Jovana ,MB,4,1,2,-5.88,7,4,1,2,7,42.86,1,8,5,14,-50.00,2,0,11,13,15.38,0,0,0,0, ,3,1,7,28.57,0,0,2,2,0.00
11915,SRB,22,Lozo Sara ,O,7,1,0,2.04,8,7,4,25,36,8.33,1,1,1,3,0.00,0,2,8,10,-20.00,9,1,29,39,20.51,11,5,18,33.33,0,0,4,4,0.00
11915,SRB,23,Djordjevic Mila ,S,1,0,1,-20.00,2,1,1,0,2,0.00,0,4,2,6,-66.67,1,0,6,7,14.29,0,0,0,0, ,5,1,6,66.67,7,0,77,84,8.33
11915,SRB,24,Medic Sofija ,MB,2,1,1,-5.26,4,2,1,1,4,25.00,1,3,4,8,-25.00,1,1,5,7,0.00,0,0,0,0, ,0,0,0, ,0,0,0,0, 
11915,SRB,25,Markovic Bozica ,MB,3,0,0,-16.67,3,3,3,0,6,0.00,0,2,2,4,-50.00,0,0,2,2,0.00,0,0,0,0, ,0,0,0, ,0,0,0,0, 
11915,SRB,26,Savic Vanja ,O,7,0,3,10.53,10,7,4,14,25,12.00,0,2,1,3,-66.67,3,0,7,10,30.00,0,0,0,0, ,10,2,12,66.67,0,0,0,0, 
11915,SRB,27,Bukilic Vanja ,O,0,0,0, ,0,0,0,0,0, ,0,0,0,0, ,0,0,0,0, ,0,0,0,0, ,0,0,0, ,0,0,0,0, 
11915,SRB,28,Delic Jelena ,MB,0,0,0, ,0,0,0,0,0, ,0,0,0,0, ,0,0,0,0, ,0,0,0,0, ,0,0,0, ,0,0,0,0, 
11915,SRB,31,Djurdjevic Sanja ,L,0,0,0, ,0,0,0,0,0, ,0,0,0,0, ,0,0,0,0, ,4,1,18,23,13.04,15,3,22,54.55,0,0,8,8,0.00
11915,SRB,32,Gocanin Bojana ,L,0,0,0, ,0,0,0,0,0, ,0,0,0,0, ,0,0,0,0, ,0,0,0,0, ,0,0,0, ,0,0,0,0, 
11915,SRB,33,Cvetkovic Jovana ,OH,0,0,0,-100.00,0,0,0,0,0, ,0,0,0,0, ,0,1,0,1,-100.00,1,0,2,3,33.33,0,0,0, ,0,0,1,1,0.00
11915,SRB,34,Mirosavljevic Jovana ,OH,8,5,3,6.45,16,8,8,24,40,0.00,5,3,0,8,25.00,3,1,10,14,14.29,7,1,8,16,37.50,10,2,13,61.54,0,0,2,2,0.00
11916,THA,2,Pannoy Piyanut ,L,0,0,0, ,0,0,0,0,0, ,0,0,0,0, ,0,0,0,0, ,4,0,10,14,28.57,9,1,11,72.73,0,0,5,5,0.00
11916,THA,3,ManaKij Sirima ,S,0,0,0, ,0,0,0,0,0, ,0,0,0,0, ,0,0,0,0, ,0,0,0,0, ,0,2,2,-100.00,1,0,4,5,20.00
11916,THA,5,Thinkaow Pleumjit ,MB,6,0,0,6.06,6,6,1,8,15,33.33,0,2,7,9,-22.22,0,1,8,9,-11.11,0,0,0,0, ,1,1,3,0.00,0,1,4,5,-20.00
11916,THA,6,Sittirak Onuma ,OH,10,0,0,4.44,10,10,5,14,29,17.24,0,2,2,4,-50.00,0,1,11,12,-8.33,1,1,1,3,0.00,7,2,11,45.45,0,1,1,2,-50.00
11916,THA,9,Chuewulim Sutadta ,OH,3,0,0,15.00,3,3,0,10,13,23.08,0,0,2,2,0.00,0,0,5,5,0.00,4,0,12,16,25.00,3,3,6,0.00,0,0,2,2,0.00
11916,THA,10,Apinyapong Wilavan ,L,2,0,0,-9.09,2,2,1,10,13,7.69,0,3,1,4,-75.00,0,0,5,5,0.00,3,0,8,11,27.27,7,0,10,70.00,0,0,3,3,0.00
11916,THA,11,Hyapha Amporn ,MB,0,0,0, ,0,0,0,0,0, ,0,0,0,0, ,0,0,0,0, ,0,0,0,0, ,0,0,0, ,0,0,0,0, 
11916,THA,12,Chaisri Tapaphaipun ,L,0,0,0, ,0,0,0,0,0, ,0,0,0,0, ,0,0,0,0, ,0,0,0,0, ,4,1,7,42.86,0,0,0,0, 
11916,THA,13,Tomkom Nootsara ,S,1,0,1,-6.25,2,1,0,2,3,33.33,0,2,2,4,-50.00,1,1,7,9,0.00,0,1,0,1,-100.00,7,1,11,54.55,24,0,49,73,32.88
11916,THA,14,Juangjan Pattiya ,OH,0,0,0,-66.67,0,0,1,1,2,-50.00,0,0,0,0, ,0,1,0,1,-100.00,0,0,0,0, ,0,0,0, ,0,0,0,0, 
11916,THA,15,Kanthong Malika ,O,6,0,1,2.78,7,6,3,11,20,15.00,0,2,4,6,-33.33,1,1,8,10,0.00,5,1,7,13,30.77,5,2,8,37.50,0,0,5,5,0.00
11916,THA,19,Krause Karina ,MB,9,0,0,14.29,9,9,0,2,11,81.82,0,4,5,9,-44.44,0,1,7,8,-12.50,0,0,0,0, ,5,0,5,100.00,0,0,4,4,0.00
11916,THA,22,Nilapa Chatsuda ,OH,2,0,0,20.00,2,2,0,1,3,66.67,0,1,0,1,-100.00,0,0,1,1,0.00,0,0,3,3,0.00,0,1,1,-100.00,0,0,0,0, 
11916,THA,24,Nuanjam Watchareeya ,MB,0,0,0, ,0,0,0,0,0, ,0,0,0,0, ,0,0,0,0, ,0,0,0,0, ,0,0,0, ,0,0,0,0, 
11916,POL,1,Nowicka Julia ,S,0,0,0, ,0,0,0,0,0, ,0,0,0,0, ,0,0,0,0, ,0,0,0,0, ,1,0,1,100.00,6,0,10,16,37.50
11916,POL,3,Alagierska Klaudia ,MB,4,1,0,-4.35,5,4,0,3,7,57.14,1,4,3,8,-37.50,0,2,6,8,-25.00,0,0,0,0, ,2,4,6,-33.33,0,0,1,1,0.00
11916,POL,8,Stenzel Maria ,L,0,0,0, ,0,0,0,0,0, ,0,0,0,0, ,0,0,0,0, ,2,0,19,21,9.52,14,1,15,86.67,0,0,18,18,0.00
11916,POL,9,Stysiak Magdalena ,O,14,1,1,21.28,16,14,2,11,27,44.44,1,2,2,5,-20.00,1,2,12,15,-6.67,0,0,0,0, ,10,1,13,69.23,0,0,1,1,0.00
11916,POL,10,Efimienko-Mlotkowska Zuzanna ,MB,2,1,0,-4.17,3,2,0,4,6,33.33,1,3,8,12,-16.67,0,1,5,6,-16.67,0,0,0,0, ,3,0,4,75.00,0,0,0,0, 
11916,POL,11,Lukasik Martyna ,O,12,1,0,13.33,13,12,1,12,25,44.00,1,3,1,5,-40.00,0,3,12,15,-20.00,3,2,13,18,5.56,8,1,11,63.64,0,0,0,0, 
11916,POL,13,Jagla Monika ,L,0,0,0, ,0,0,0,0,0, ,0,0,0,0, ,0,0,0,0, ,0,0,0,0, ,0,0,0, ,0,0,0,0, 
11916,POL,17,Smarzek Malwina ,O,0,0,0, ,0,0,0,0,0, ,0,0,0,0, ,0,0,0,0, ,0,0,0,0, ,0,0,0, ,0,0,0,0, 
11916,POL,19,Fedusio Monika ,OH,0,0,0, ,0,0,0,0,0, ,0,0,0,0, ,0,0,0,0, ,0,0,0,0, ,0,0,0, ,0,0,0,0, 
11916,POL,20,Czyrnianska Martyna ,OH,1,1,0,25.00,2,1,1,1,3,0.00,1,0,0,1,100.00,0,0,0,0, ,0,0,0,0, ,2,1,3,33.33,0,0,0,0, 
11916,POL,26,Wenerska Katarzyna ,S,1,0,0,-11.11,1,1,0,1,2,50.00,0,2,2,4,-50.00,0,1,11,12,-8.33,0,0,0,0, ,7,4,13,23.08,24,1,44,69,33.33
11916,POL,30,Rozanski Olivia ,OH,0,0,0, ,0,0,0,0,0, ,0,0,0,0, ,0,0,0,0, ,0,0,0,0, ,0,0,0, ,0,0,0,0, 
11916,POL,78,Gryka Aleksandra ,MB,3,0,1,12.50,4,3,0,3,6,50.00,0,1,4,5,-20.00,1,1,3,5,0.00,0,0,1,1,0.00,0,0,0, ,0,0,0,0, 
11916,POL,88,Gorecka Zuzanna ,OH,15,2,1,29.79,18,15,0,15,30,50.00,2,2,1,5,0.00,1,2,9,12,-8.33,5,0,9,14,35.71,11,1,13,76.92,0,0,1,1,0.00
11917,GER,1,Bock Linda ,L,0,0,0,0.00,0,0,0,0,0, ,0,0,0,0, ,0,0,1,1,0.00,0,0,0,0, ,0,0,0, ,0,0,0,0, 
11917,GER,2,KÃ¤stner Pia ,S,0,0,0,0.00,0,0,0,0,0, ,0,0,0,0, ,0,0,8,8,0.00,0,0,0,0, ,2,0,2,100.00,0,0,8,8,0.00
11917,GER,4,Imoudu Denise ,S,3,2,0,-8.00,5,3,0,3,6,50.00,2,4,1,7,-28.57,0,3,9,12,-25.00,0,0,0,0, ,8,1,10,70.00,27,2,72,101,24.75
11917,GER,5,Poll Jana Franziska ,OH,0,0,0,0.00,0,0,0,0,0, ,0,0,0,0, ,0,0,3,3,0.00,0,0,0,0, ,1,0,1,100.00,0,0,0,0, 
11917,GER,8,Drewniok Kimberly ,O,13,1,3,14.81,17,13,5,16,34,23.53,1,4,2,7,-42.86,3,0,10,13,23.08,0,0,0,0, ,9,3,13,46.15,0,0,1,1,0.00
11917,GER,9,Alsmeier Lina ,OH,9,0,0,2.70,9,9,4,7,20,25.00,0,1,0,1,-100.00,0,3,13,16,-18.75,15,1,21,37,37.84,6,3,9,33.33,0,0,2,2,0.00
11917,GER,10,Stigrot Lena ,OH,2,0,0,16.67,2,2,1,2,5,20.00,0,0,1,1,0.00,0,0,0,0, ,0,0,0,0, ,0,0,0, ,0,0,0,0, 
11917,GER,12,Orthmann Hanna ,OH,16,3,2,12.90,21,16,7,22,45,20.00,3,3,1,7,0.00,2,3,5,10,-10.00,11,0,21,32,34.38,6,0,7,85.71,0,0,1,1,0.00
11917,GER,14,SchÃ¶lzel Marie ,MB,8,1,0,18.75,9,8,2,6,16,37.50,1,1,5,7,0.00,0,0,9,9,0.00,0,0,0,0, ,2,2,5,0.00,0,0,1,1,0.00
11917,GER,17,Pogany Anna ,L,0,0,0, ,0,0,0,0,0, ,0,0,0,0, ,0,0,0,0, ,10,0,10,20,50.00,12,7,20,25.00,0,0,13,13,0.00
11917,GER,20,Bock Josepha ,MB,0,0,0, ,0,0,0,0,0, ,0,0,0,0, ,0,0,0,0, ,0,0,0,0, ,0,0,0, ,0,0,0,0, 
11917,GER,21,Weitzel Camilla ,MB,7,1,0,-10.53,8,7,2,3,12,41.67,1,6,5,12,-41.67,0,4,10,14,-28.57,0,0,1,1,0.00,0,0,0, ,0,0,2,2,0.00
11917,BRA,3,Rodrigues Lins Dos Santos Danielle ,S,0,0,0,-20.00,0,0,0,0,0, ,0,0,0,0, ,0,1,4,5,-20.00,0,0,0,0, ,0,0,0, ,0,1,13,14,-7.14
11917,BRA,5,Da Silva Adenizia ,MB,0,0,0, ,0,0,0,0,0, ,0,0,0,0, ,0,0,0,0, ,0,0,0,0, ,0,0,0, ,0,0,0,0, 
11917,BRA,6,Alexandre Costa Nunes Nyeme Victoria ,L,0,0,0, ,0,0,0,0,0, ,0,0,0,0, ,0,0,0,0, ,0,0,0,0, ,0,0,0, ,0,0,0,0, 
11917,BRA,7,Montibeller Rosamaria ,OH,1,0,0,20.00,1,1,0,4,5,20.00,0,0,0,0, ,0,0,0,0, ,0,0,0,0, ,0,0,0, ,0,0,0,0, 
11917,BRA,8,Silva Carneiro Macris Fernanda ,S,1,1,0,7.69,2,1,0,0,1,100.00,1,0,0,1,100.00,0,1,10,11,-9.09,0,0,0,0, ,6,6,14,0.00,20,0,69,89,22.47
11917,BRA,10,Braga Guimaraes Gabriela ,OH,19,2,0,18.18,21,19,5,10,34,41.18,2,5,2,9,-33.33,0,1,11,12,-8.33,7,2,17,26,19.23,8,3,12,41.67,0,0,0,0, 
11917,BRA,11,Caixeta Tandara ,OH,12,1,1,12.96,14,12,5,14,31,22.58,1,2,1,4,-25.00,1,0,18,19,5.26,0,0,0,0, ,6,1,13,38.46,0,1,0,1,-100.00
11917,BRA,15,Da Silva Ana Carolina ,MB,7,1,0,-2.50,8,7,1,4,12,50.00,1,6,3,10,-50.00,0,2,16,18,-11.11,0,0,0,0, ,2,0,2,100.00,0,0,0,0, 
11917,BRA,16,Rodrigues Fernanda ,OH,8,5,0,12.73,13,8,2,10,20,30.00,5,4,5,14,7.14,0,0,21,21,0.00,8,2,14,24,25.00,15,1,18,77.78,0,0,8,8,0.00
11917,BRA,17,Menezes Oliveira de Souza Ana Cristina ,OH,0,0,0, ,0,0,0,0,0, ,0,0,0,0, ,0,0,0,0, ,0,0,0,0, ,0,0,0, ,0,0,0,0, 
11917,BRA,18,Brait Camila ,L,0,0,0, ,0,0,0,0,0, ,0,0,0,0, ,0,0,0,0, ,8,1,13,22,31.82,16,5,21,52.38,0,0,8,8,0.00
11917,BRA,20,Correa Ana Beatriz ,MB,10,2,0,10.00,12,10,1,5,16,56.25,2,6,7,15,-26.67,0,1,8,9,-11.11,0,0,1,1,0.00,2,0,2,100.00,0,0,2,2,0.00
11917,BRA,24,Geraldo Teixeira Lorenne ,O,0,0,0,0.00,0,0,0,0,0, ,0,0,0,0, ,0,0,1,1,0.00,0,0,0,0, ,0,0,0, ,0,0,0,0, 
11917,BRA,28,Araujo De Souza Mayany Cristina ,MB,0,0,0, ,0,0,0,0,0, ,0,0,0,0, ,0,0,0,0, ,0,0,0,0, ,0,0,0, ,0,0,0,0, 
11918,BEL,2,Van Sas Elise ,S,0,0,0, ,0,0,0,0,0, ,0,0,0,0, ,0,0,0,0, ,0,0,0,0, ,0,0,0, ,0,0,0,0, 
11918,BEL,3,Herbots Britt ,OH,23,3,0,13.64,26,23,9,36,68,20.59,3,3,2,8,0.00,0,2,10,12,-16.67,7,0,17,24,29.17,8,1,10,70.00,0,0,6,6,0.00
11918,BEL,4,Lemmens Nathalie ,MB,1,1,0,-12.50,2,1,1,3,5,0.00,1,2,10,13,-7.69,0,2,4,6,-33.33,0,0,0,0, ,1,0,1,100.00,0,0,0,0, 
11918,BEL,5,Guilliams Jodie ,OH,0,0,0,0.00,0,0,0,0,0, ,0,0,0,0, ,0,0,1,1,0.00,0,0,5,5,0.00,0,0,0, ,0,0,0,0, 
11918,BEL,6,Gilson Helena ,OH,0,0,0, ,0,0,0,0,0, ,0,0,0,0, ,0,0,0,0, ,0,0,0,0, ,0,0,0, ,0,0,0,0, 
11918,BEL,7,Van Gestel Celine ,OH,11,0,0,-3.03,11,11,4,19,34,20.59,0,7,7,14,-50.00,0,2,16,18,-11.11,8,1,38,47,14.89,8,1,10,70.00,0,0,2,2,0.00
11918,BEL,9,Demeyer Nel ,L,0,0,0, ,0,0,0,0,0, ,0,0,0,0, ,0,0,0,0, ,5,1,4,10,40.00,22,7,33,45.45,0,1,16,17,-5.88
11918,BEL,10,Sobolska Dominika ,MB,2,1,0,28.57,3,2,0,1,3,66.67,1,1,0,2,0.00,0,0,2,2,0.00,0,0,0,0, ,0,1,1,-100.00,0,0,0,0, 
11918,BEL,13,Janssens Marlies ,MB,11,8,3,32.00,22,11,1,6,18,55.56,8,1,5,14,50.00,3,4,11,18,-5.56,0,0,1,1,0.00,3,0,3,100.00,0,0,1,1,0.00
11918,BEL,14,De Valkeneer Lise ,OH,0,0,0,0.00,0,0,0,0,0, ,0,0,0,0, ,0,0,1,1,0.00,0,0,1,1,0.00,0,0,0, ,0,0,0,0, 
11918,BEL,15,Van De Vyver Jutta ,S,0,0,0,0.00,0,0,0,0,0, ,0,0,0,0, ,0,0,1,1,0.00,0,0,0,0, ,0,0,0, ,2,1,7,10,10.00
11918,BEL,17,Van De Vyver Ilka ,S,0,0,0,-35.71,0,0,0,1,1,0.00,0,8,5,13,-61.54,0,2,12,14,-14.29,0,0,1,1,0.00,12,2,18,55.56,25,1,85,111,21.62
11918,BEL,19,Van Avermaet Silke ,MB,6,1,0,2.44,7,6,1,11,18,27.78,1,3,4,8,-25.00,0,2,13,15,-13.33,0,0,0,0, ,5,3,10,20.00,0,0,0,0, 
11918,BEL,21,Stragier Manon ,OH,0,0,0,-50.00,0,0,0,0,0, ,0,0,0,0, ,0,1,1,2,-50.00,0,0,0,0, ,1,1,2,0.00,0,0,0,0, 
11918,JPN,1,Kurogo Ai ,OH,9,0,0,-5.26,9,9,8,15,32,3.12,0,3,1,4,-75.00,0,1,20,21,-4.76,0,0,0,0, ,20,3,24,70.83,0,0,7,7,0.00
11918,JPN,2,Koga Sarina ,OH,21,0,0,19.12,21,21,6,25,52,28.85,0,1,3,4,-25.00,0,1,11,12,-8.33,6,1,22,29,17.24,16,3,22,59.09,0,0,0,0, 
11918,JPN,3,Shimamura Haruyo ,MB,0,0,0, ,0,0,0,0,0, ,0,0,0,0, ,0,0,0,0, ,0,0,0,0, ,0,0,0, ,0,0,0,0, 
11918,JPN,5,Araki Erika ,MB,6,2,1,-2.04,9,6,1,7,14,35.71,2,8,9,19,-31.58,1,1,14,16,0.00,0,0,1,1,0.00,4,0,4,100.00,0,0,0,0, 
11918,JPN,7,Ishii Yuki ,OH,0,0,0, ,0,0,0,0,0, ,0,0,0,0, ,0,0,0,0, ,0,0,0,0, ,0,0,0, ,0,0,0,0, 
11918,JPN,8,Ishikawa Mayu ,OH,11,0,1,7.02,12,11,7,19,37,10.81,0,0,1,1,0.00,1,1,17,19,0.00,12,1,21,34,32.35,16,4,22,54.55,0,0,0,0, 
11918,JPN,9,Tashiro Kanami ,S,1,0,0,25.00,1,1,0,0,1,100.00,0,0,0,0, ,0,0,3,3,0.00,0,0,0,0, ,0,1,1,-100.00,6,0,16,22,27.27
11918,JPN,11,Nabeya Yurie ,OH,0,0,0,-50.00,0,0,0,0,0, ,0,0,0,0, ,0,1,1,2,-50.00,0,0,0,0, ,0,0,0, ,0,0,0,0, 
11918,JPN,13,Okumura Mai ,MB,0,0,0, ,0,0,0,0,0, ,0,0,0,0, ,0,0,0,0, ,0,0,0,0, ,0,0,0, ,0,0,0,0, 
11918,JPN,14,Kobata Mako ,L,0,0,0, ,0,0,0,0,0, ,0,0,0,0, ,0,0,0,0, ,4,0,6,10,40.00,15,1,18,77.78,0,0,17,17,0.00
11918,JPN,15,Inoue Kotoe ,L,0,0,0, ,0,0,0,0,0, ,0,0,0,0, ,0,0,0,0, ,0,0,0,0, ,0,0,0, ,0,0,0,0, 
11918,JPN,19,Yamada Nichika ,MB,12,0,0,14.29,12,12,0,7,19,63.16,0,5,7,12,-41.67,0,1,10,11,-9.09,0,0,0,0, ,4,2,7,28.57,0,0,1,1,0.00
11918,JPN,21,Hayashi Kotona ,OH,0,0,0, ,0,0,0,0,0, ,0,0,0,0, ,0,0,0,0, ,0,1,0,1,-100.00,0,0,0, ,0,0,0,0, 
11918,JPN,24,Momii Aki ,S,0,1,0,-22.73,1,0,0,1,1,0.00,1,4,3,8,-37.50,0,2,11,13,-15.38,0,0,0,0, ,9,4,16,31.25,33,1,70,104,30.77
11919,RUS,4,Pilipenko Daria ,L,0,0,0, ,0,0,0,0,0, ,0,0,0,0, ,0,0,0,0, ,0,0,1,1,0.00,3,1,5,40.00,0,0,0,0, 
11919,RUS,5,Fedorovtseva Arina ,OH,8,1,3,41.67,12,8,2,3,13,46.15,1,0,0,1,100.00,3,0,7,10,30.00,2,0,6,8,25.00,1,0,1,100.00,0,0,2,2,0.00
11919,RUS,6,Koroleva Irina ,MB,3,4,4,25.00,11,3,2,4,9,11.11,4,1,4,9,33.33,4,0,10,14,28.57,1,0,0,1,100.00,3,0,3,100.00,0,0,0,0, 
11919,RUS,8,Goncharova Nataliya ,O,7,1,0,35.29,8,7,0,2,9,77.78,1,2,0,3,-33.33,0,0,5,5,0.00,0,0,0,0, ,2,0,2,100.00,0,0,1,1,0.00
11919,RUS,11,Brovkina Yulia ,MB,0,0,0, ,0,0,0,0,0, ,0,0,0,0, ,0,0,0,0, ,0,0,0,0, ,0,0,0, ,0,0,0,0, 
11919,RUS,12,Lazareva Anna ,O,5,0,0,-8.00,5,5,4,9,18,5.56,0,2,2,4,-50.00,0,1,2,3,-33.33,0,0,0,0, ,3,2,5,20.00,0,0,0,0, 
11919,RUS,13,Startseva Evgeniya ,S,1,1,0,14.29,2,1,0,0,1,100.00,1,1,1,3,0.00,0,0,3,3,0.00,0,0,1,1,0.00,3,2,6,16.67,3,0,22,25,12.00
11919,RUS,14,Fetisova Irina ,MB,4,0,1,9.52,5,4,1,1,6,50.00,0,1,2,3,-33.33,1,1,10,12,0.00,0,0,0,0, ,0,0,0, ,0,0,2,2,0.00
11919,RUS,15,Kosheleva Tatyana ,OH,2,0,1,0.00,3,2,2,1,5,0.00,0,1,1,2,-50.00,1,0,5,6,16.67,1,0,1,2,50.00,4,0,4,100.00,0,0,0,0, 
11919,RUS,16,Voronkova Irina ,OH,8,1,0,30.43,9,8,1,3,12,58.33,1,0,2,3,33.33,0,1,7,8,-12.50,2,0,3,5,40.00,6,0,7,85.71,0,0,0,0, 
11919,RUS,19,Podkopaeva Anna ,L,0,0,0, ,0,0,0,0,0, ,0,0,0,0, ,0,0,0,0, ,3,1,7,11,18.18,10,3,15,46.67,0,0,4,4,0.00
11919,RUS,20,Lazareva Ekaterina ,S,1,0,1,0.00,2,1,0,2,3,33.33,0,2,2,4,-50.00,1,0,4,5,20.00,0,0,0,0, ,1,1,2,0.00,6,0,39,45,13.33
11919,RUS,24,Pipunyrova Ekaterina ,OH,0,0,1,50.00,1,0,0,0,0, ,0,0,0,0, ,1,0,1,2,50.00,0,0,0,0, ,0,0,0, ,0,0,0,0, 
11919,RUS,25,Smirnova Kseniia ,OH,4,0,0,7.14,4,4,3,1,8,12.50,0,0,0,0, ,0,0,6,6,0.00,3,2,12,17,5.88,3,1,4,50.00,0,0,0,0, 
11919,SRB,6,Uzelac Aleksandra ,OH,4,0,0,12.50,4,4,2,4,10,20.00,0,0,1,1,0.00,0,0,5,5,0.00,0,2,2,4,-50.00,0,2,3,-66.67,0,0,1,1,0.00
11919,SRB,7,Jaksic Ana ,S,1,1,1,0.00,3,1,0,1,2,50.00,1,3,2,6,-33.33,1,0,5,6,16.67,0,0,0,0, ,3,2,6,16.67,5,0,53,58,8.62
11919,SRB,21,Kocic Jovana ,MB,0,2,0,-18.75,2,0,3,2,5,-60.00,2,2,1,5,0.00,0,0,6,6,0.00,0,0,0,0, ,0,0,0, ,0,0,1,1,0.00
11919,SRB,22,Lozo Sara ,O,7,1,1,8.82,9,7,5,9,21,9.52,1,1,1,3,0.00,1,0,9,10,10.00,2,2,15,19,0.00,6,4,10,20.00,0,0,5,5,0.00
11919,SRB,23,Djordjevic Mila ,S,0,0,0, ,0,0,0,0,0, ,0,0,0,0, ,0,0,0,0, ,0,0,0,0, ,1,0,1,100.00,1,0,2,3,33.33
11919,SRB,24,Medic Sofija ,MB,2,1,1,22.22,4,2,0,0,2,100.00,1,1,0,2,0.00,1,1,3,5,0.00,0,0,0,0, ,2,0,2,100.00,0,0,0,0, 
11919,SRB,25,Markovic Bozica ,MB,0,0,0,-37.50,0,0,0,2,2,0.00,0,2,1,3,-66.67,0,1,2,3,-33.33,0,0,1,1,0.00,2,0,2,100.00,0,0,0,0, 
11919,SRB,26,Savic Vanja ,O,7,0,0,3.70,7,7,3,8,18,22.22,0,3,0,3,-100.00,0,0,6,6,0.00,0,0,0,0, ,1,2,5,-20.00,0,0,0,0, 
11919,SRB,27,Bukilic Vanja ,O,1,0,0,50.00,1,1,0,0,1,100.00,0,0,1,1,0.00,0,0,0,0, ,0,0,0,0, ,0,0,0, ,0,0,1,1,0.00
11919,SRB,28,Delic Jelena ,MB,0,2,0,0.00,2,0,0,1,1,0.00,2,1,0,3,33.33,0,1,1,2,-50.00,0,0,0,0, ,0,0,0, ,0,0,1,1,0.00
11919,SRB,31,Djurdjevic Sanja ,L,0,0,0, ,0,0,0,0,0, ,0,0,0,0, ,0,0,0,0, ,4,2,12,18,11.11,5,2,7,42.86,0,0,3,3,0.00
11919,SRB,32,Gocanin Bojana ,L,0,0,0, ,0,0,0,0,0, ,0,0,0,0, ,0,0,0,0, ,3,3,11,17,0.00,2,1,4,25.00,0,0,4,4,0.00
11919,SRB,33,Cvetkovic Jovana ,OH,0,0,0, ,0,0,0,0,0, ,0,0,0,0, ,0,0,0,0, ,0,0,0,0, ,0,0,0, ,0,0,0,0, 
11919,SRB,34,Mirosavljevic Jovana ,OH,5,1,0,-6.90,6,5,5,7,17,0.00,1,3,2,6,-33.33,0,0,6,6,0.00,3,2,7,12,8.33,5,2,7,42.86,0,0,2,2,0.00
11920,NED,1,Knip Kirsten ,L,0,0,0, ,0,0,0,0,0, ,0,0,0,0, ,0,0,0,0, ,0,0,0,0, ,3,1,5,40.00,0,0,3,3,0.00
11920,NED,2,Savelkoel Fleur ,OH,0,0,0, ,0,0,0,0,0, ,0,0,0,0, ,0,0,0,0, ,0,0,0,0, ,0,0,0, ,0,0,0,0, 
11920,NED,4,Plak Celeste ,OH,11,0,0,5.66,11,11,4,15,30,23.33,0,2,4,6,-33.33,0,2,15,17,-11.76,0,0,1,1,0.00,8,3,13,38.46,0,1,0,1,-100.00
11920,NED,7,Lohuis Juliet ,MB,7,3,1,0.00,11,7,1,6,14,42.86,3,8,7,18,-27.78,1,2,15,18,-5.56,0,0,0,0, ,7,0,8,87.50,0,0,1,1,0.00
11920,NED,8,Korevaar Demi ,MB,0,0,0,0.00,0,0,0,0,0, ,0,0,0,0, ,0,0,2,2,0.00,0,0,0,0, ,0,0,0, ,0,0,0,0, 
11920,NED,9,Schoot Myrthe ,L,0,0,0, ,0,0,0,0,0, ,0,0,0,0, ,0,0,0,0, ,7,0,14,21,33.33,9,7,17,11.76,0,0,7,7,0.00
11920,NED,10,van Aalen Sarah ,S,0,0,0, ,0,0,0,0,0, ,0,0,0,0, ,0,0,0,0, ,0,0,0,0, ,0,0,0, ,0,0,0,0, 
11920,NED,11,Buijs Anne ,OH,16,0,0,0.00,16,16,9,23,48,14.58,0,4,5,9,-44.44,0,3,7,10,-30.00,11,1,20,32,31.25,13,2,18,61.11,0,0,0,0, 
11920,NED,12,Bongaerts Britt ,S,1,0,1,-8.00,2,1,0,5,6,16.67,0,4,1,5,-80.00,1,0,13,14,7.14,0,0,0,0, ,5,3,9,22.22,30,0,106,136,22.06
11920,NED,18,Jasper Marrit ,OH,0,0,0,-50.00,0,0,0,0,0, ,0,0,0,0, ,0,1,1,2,-50.00,2,0,7,9,22.22,4,0,4,100.00,0,0,1,1,0.00
11920,NED,19,Daalderop Nika ,OH,19,1,3,23.08,23,19,4,20,43,34.88,1,1,2,4,0.00,3,3,12,18,0.00,5,1,20,26,15.38,13,0,16,81.25,0,0,3,3,0.00
11920,NED,21,Meijers Annick ,OH,0,0,0,0.00,0,0,0,0,0, ,0,0,0,0, ,0,0,1,1,0.00,0,0,0,0, ,0,1,1,-100.00,0,0,0,0, 
11920,NED,23,Timmerman Eline ,MB,8,1,0,-14.89,9,8,5,4,17,17.65,1,7,10,18,-33.33,0,4,8,12,-33.33,0,0,1,1,0.00,6,0,8,75.00,0,0,2,2,0.00
11920,NED,27,Scholten Iris ,O,2,1,0,16.67,3,2,0,4,6,33.33,1,0,0,1,100.00,0,1,4,5,-20.00,0,0,0,0, ,6,2,9,44.44,0,0,0,0, 
11920,DOM,1,Vargas Valdez Annerys Victoria ,MB,0,0,0, ,0,0,0,0,0, ,0,0,0,0, ,0,0,0,0, ,0,0,0,0, ,0,0,0, ,0,0,0,0, 
11920,DOM,3,Eve Mejia Lisvel Elisa ,U,7,0,0,2.94,7,7,0,2,9,77.78,0,5,6,11,-45.45,0,1,13,14,-7.14,1,2,6,9,-11.11,5,1,7,57.14,0,0,2,2,0.00
11920,DOM,5,Castillo Brenda ,L,0,0,0, ,0,0,0,0,0, ,0,0,0,0, ,0,0,0,0, ,10,1,15,26,34.62,21,7,33,42.42,0,0,26,26,0.00
11920,DOM,6,Dominguez Martinez Camil Inmaculada ,S,0,0,0,-20.00,0,0,0,0,0, ,0,3,2,5,-60.00,0,0,10,10,0.00,0,0,0,0, ,5,1,9,44.44,3,1,56,60,3.33
11920,DOM,7,Marte Frica Niverka Dharlenis ,S,0,0,0,-22.22,0,0,1,1,2,-50.00,0,0,2,2,0.00,0,1,4,5,-20.00,0,0,0,0, ,8,2,14,42.86,11,0,42,53,20.75
11920,DOM,11,Rodriguez Marifranchi ,MB,0,0,0, ,0,0,0,0,0, ,0,0,0,0, ,0,0,0,0, ,0,0,0,0, ,0,0,0, ,0,0,0,0, 
11920,DOM,14,Rivera Brens Prisilla ,OH,3,1,1,9.68,5,3,1,10,14,14.29,1,1,1,3,0.00,1,0,13,14,7.14,1,0,12,13,7.69,4,1,6,50.00,0,0,1,1,0.00
11920,DOM,16,PeÃ±a Isabel Yonkaira Paola ,OH,7,1,0,17.24,8,7,3,8,18,22.22,1,0,0,1,100.00,0,0,10,10,0.00,1,0,6,7,14.29,12,1,13,84.62,0,0,1,1,0.00
11920,DOM,17,Mambru Casilla Gina Altagracia ,O,0,0,0,0.00,0,0,0,0,0, ,0,0,0,0, ,0,0,1,1,0.00,0,0,0,0, ,0,0,0, ,0,0,0,0, 
11920,DOM,18,De La Cruz De PeÃ±a Bethania ,OH,12,1,0,14.29,13,12,4,15,31,25.81,1,0,3,4,25.00,0,2,12,14,-14.29,4,1,19,24,12.50,9,6,17,17.65,0,0,4,4,0.00
11920,DOM,20,Martinez Brayelin Elizabeth ,OH,18,0,0,3.90,18,18,5,28,51,25.49,0,6,5,11,-54.55,0,4,11,15,-26.67,1,1,2,4,0.00,13,3,19,52.63,0,0,1,1,0.00
11920,DOM,21,Martinez Jineiry ,MB,11,3,1,0.00,15,11,1,8,20,50.00,3,12,12,27,-33.33,1,2,14,17,-5.88,0,0,0,0, ,1,0,1,100.00,0,0,1,1,0.00
11920,DOM,23,Gonzalez Lopez Gaila Ceneida ,O,3,0,0,0.00,3,3,1,2,6,33.33,0,1,1,2,-50.00,0,1,0,1,-100.00,0,0,0,0, ,1,0,1,100.00,0,0,0,0, 
11920,DOM,25,Martinez Caro Larysmer ,OH,0,0,0, ,0,0,0,0,0, ,0,0,0,0, ,0,0,0,0, ,0,0,0,0, ,0,0,0, ,0,0,0,0, 
11921,GER,1,Bock Linda ,L,0,0,0, ,0,0,0,0,0, ,0,0,0,0, ,0,0,0,0, ,1,0,1,2,50.00,0,0,0, ,0,0,0,0, 
11921,GER,2,KÃ¤stner Pia ,S,1,0,0,33.33,1,1,0,0,1,100.00,0,0,0,0, ,0,0,2,2,0.00,0,0,0,0, ,0,0,0, ,0,0,1,1,0.00
11921,GER,4,Imoudu Denise ,S,2,0,0,-6.25,2,2,0,1,3,66.67,0,1,1,2,-50.00,0,2,9,11,-18.18,0,0,0,0, ,7,2,12,41.67,16,0,69,85,18.82
11921,GER,5,Poll Jana Franziska ,OH,0,0,0, ,0,0,0,0,0, ,0,0,0,0, ,0,0,0,0, ,0,0,0,0, ,0,0,0, ,0,0,0,0, 
11921,GER,8,Drewniok Kimberly ,O,13,0,2,16.67,15,13,2,9,24,45.83,0,3,3,6,-50.00,2,3,7,12,-8.33,0,0,0,0, ,4,1,5,60.00,0,0,1,1,0.00
11921,GER,9,Alsmeier Lina ,OH,10,1,0,17.07,11,10,1,14,25,36.00,1,1,1,3,0.00,0,2,11,13,-15.38,8,1,10,19,36.84,6,0,7,85.71,0,0,2,2,0.00
11921,GER,10,Stigrot Lena ,OH,1,0,0,100.00,1,1,0,0,1,100.00,0,0,0,0, ,0,0,0,0, ,0,0,0,0, ,0,0,0, ,0,0,0,0, 
11921,GER,12,Orthmann Hanna ,OH,7,2,4,12.50,13,7,5,11,23,8.70,2,1,0,3,33.33,4,2,8,14,14.29,7,2,25,34,14.71,6,4,12,16.67,0,1,0,1,-100.00
11921,GER,14,SchÃ¶lzel Marie ,MB,5,2,0,0.00,7,5,2,4,11,27.27,2,5,1,8,-37.50,0,0,10,10,0.00,0,0,0,0, ,3,0,4,75.00,0,0,0,0, 
11921,GER,17,Pogany Anna ,L,0,0,0, ,0,0,0,0,0, ,0,0,0,0, ,0,0,0,0, ,3,0,4,7,42.86,11,1,13,76.92,0,0,4,4,0.00
11921,GER,20,Bock Josepha ,MB,0,0,0, ,0,0,0,0,0, ,0,0,0,0, ,0,0,0,0, ,0,0,0,0, ,0,0,0, ,0,0,0,0, 
11921,GER,21,Weitzel Camilla ,MB,7,3,2,11.43,12,7,0,2,9,77.78,3,7,4,14,-28.57,2,1,9,12,8.33,0,0,0,0, ,0,1,1,-100.00,0,0,0,0, 
11921,POL,1,Nowicka Julia ,S,0,0,0,0.00,0,0,0,0,0, ,0,0,1,1,0.00,0,0,7,7,0.00,0,0,0,0, ,1,0,1,100.00,1,0,11,12,8.33
11921,POL,3,Alagierska Klaudia ,MB,4,2,1,10.34,7,4,1,2,7,42.86,2,3,4,9,-11.11,1,0,12,13,7.69,0,0,0,0, ,3,0,3,100.00,0,0,1,1,0.00
11921,POL,8,Stenzel Maria ,L,0,0,0, ,0,0,0,0,0, ,0,0,0,0, ,0,0,0,0, ,6,3,8,17,17.65,9,1,10,80.00,0,0,10,10,0.00
11921,POL,9,Stysiak Magdalena ,O,13,0,0,6.25,13,13,7,3,23,26.09,0,1,0,1,-100.00,0,3,5,8,-37.50,1,0,4,5,20.00,2,2,4,0.00,0,0,0,0, 
11921,POL,10,Efimienko-Mlotkowska Zuzanna ,MB,2,0,1,8.33,3,2,1,1,4,25.00,0,1,1,2,-50.00,1,0,5,6,16.67,0,1,0,1,-100.00,1,3,4,-50.00,0,0,0,0, 
11921,POL,11,Lukasik Martyna ,O,4,1,0,18.75,5,4,2,4,10,20.00,1,0,0,1,100.00,0,0,5,5,0.00,2,1,3,6,16.67,1,2,4,-25.00,0,0,0,0, 
11921,POL,13,Jagla Monika ,L,0,0,0, ,0,0,0,0,0, ,0,0,0,0, ,0,0,0,0, ,0,0,0,0, ,0,0,0, ,0,0,0,0, 
11921,POL,17,Smarzek Malwina ,O,7,2,0,11.11,9,7,4,11,22,13.64,2,1,6,9,11.11,0,0,5,5,0.00,0,1,2,3,-33.33,5,1,6,66.67,0,0,1,1,0.00
11921,POL,19,Fedusio Monika ,OH,0,0,0, ,0,0,0,0,0, ,0,0,0,0, ,0,0,0,0, ,0,0,0,0, ,0,0,0, ,0,0,0,0, 
11921,POL,20,Czyrnianska Martyna ,OH,1,0,0,-20.00,1,1,0,2,3,33.33,0,1,0,1,-100.00,0,1,0,1,-100.00,1,0,1,2,50.00,0,1,1,-100.00,0,0,0,0, 
11921,POL,26,Wenerska Katarzyna ,S,1,0,0,0.00,1,1,0,1,2,50.00,0,0,2,2,0.00,0,1,9,10,-10.00,0,0,0,0, ,3,4,9,-11.11,10,1,51,62,14.52
11921,POL,30,Rozanski Olivia ,OH,0,0,0, ,0,0,0,0,0, ,0,0,0,0, ,0,0,0,0, ,0,0,0,0, ,0,0,0, ,0,0,0,0, 
11921,POL,78,Gryka Aleksandra ,MB,2,1,0,8.33,3,2,0,2,4,50.00,1,2,2,5,-20.00,0,0,3,3,0.00,0,0,0,0, ,1,1,2,0.00,0,0,0,0, 
11921,POL,88,Gorecka Zuzanna ,OH,6,2,1,33.33,9,6,0,6,12,50.00,2,1,0,3,33.33,1,0,8,9,11.11,9,2,19,30,23.33,9,3,13,46.15,0,0,4,4,0.00
11922,CHN,1,Yuan Xinyue ,MB,7,1,3,22.22,11,7,0,6,13,53.85,1,2,3,6,-16.67,3,1,13,17,11.76,0,0,0,0, ,0,0,0, ,0,0,1,1,0.00
11922,CHN,2,Zhu Ting ,OH,0,0,0, ,0,0,0,0,0, ,0,0,0,0, ,0,0,0,0, ,0,0,0,0, ,0,0,0, ,0,0,0,0, 
11922,CHN,6,Gong Xiangyu ,O,9,0,1,33.33,10,9,1,5,15,53.33,0,0,0,0, ,1,1,7,9,0.00,3,1,8,12,16.67,12,3,16,56.25,0,0,1,1,0.00
11922,CHN,7,Wang Yuanyuan ,MB,0,0,0, ,0,0,0,0,0, ,0,0,0,0, ,0,0,0,0, ,0,0,0,0, ,0,0,0, ,0,0,0,0, 
11922,CHN,8,Li Yao ,OH,0,0,0, ,0,0,0,0,0, ,0,0,0,0, ,0,0,0,0, ,0,0,0,0, ,0,0,0, ,0,0,0,0, 
11922,CHN,9,Zhang Changning ,OH,9,2,0,17.39,11,9,0,17,26,34.62,2,1,1,4,25.00,0,2,14,16,-12.50,10,0,7,17,58.82,4,2,6,33.33,0,0,2,2,0.00
11922,CHN,10,Liu Xiaotong ,OH,0,0,0, ,0,0,0,0,0, ,0,0,0,0, ,0,0,0,0, ,0,0,0,0, ,0,0,0, ,0,0,0,0, 
11922,CHN,11,Yao Di ,S,0,0,0, ,0,0,0,0,0, ,0,0,0,0, ,0,0,0,0, ,0,0,0,0, ,0,0,0, ,0,0,0,0, 
11922,CHN,12,Li Yingying ,OH,15,2,2,36.59,19,15,1,10,26,53.85,2,1,0,3,33.33,2,2,8,12,0.00,4,0,4,8,50.00,5,1,6,66.67,0,0,1,1,0.00
11922,CHN,15,Lin Li ,L,0,0,0, ,0,0,0,0,0, ,0,0,0,0, ,0,0,0,0, ,1,2,3,6,-16.67,8,1,10,70.00,0,0,3,3,0.00
11922,CHN,16,Ding Xia ,S,0,0,0,-20.00,0,0,0,2,2,0.00,0,1,0,1,-100.00,0,1,6,7,-14.29,0,0,0,0, ,3,4,7,-14.29,12,0,64,76,15.79
11922,CHN,17,Yan Ni ,MB,7,1,0,24.00,8,7,0,2,9,77.78,1,2,0,3,-33.33,0,0,13,13,0.00,0,0,0,0, ,1,2,3,-33.33,0,0,1,1,0.00
11922,CHN,18,Wang Mengjie ,L,0,0,0, ,0,0,0,0,0, ,0,0,0,0, ,0,0,0,0, ,0,0,0,0, ,0,0,0, ,0,0,0,0, 
11922,CHN,19,Liu Yanhan ,OH,0,0,0, ,0,0,0,0,0, ,0,0,0,0, ,0,0,0,0, ,0,0,0,0, ,0,0,0, ,0,0,0,0, 
11922,ITA,2,Bosio Francesca ,S,0,0,0,0.00,0,0,0,0,0, ,0,0,0,0, ,0,0,7,7,0.00,0,0,0,0, ,1,1,2,0.00,9,1,62,72,11.11
11922,ITA,4,Bonifacio Sara ,MB,0,0,0, ,0,0,0,0,0, ,0,0,0,0, ,0,0,0,0, ,0,0,0,0, ,0,0,0, ,0,0,0,0, 
11922,ITA,12,Guerra Anastasia ,OH,0,0,0, ,0,0,0,0,0, ,0,0,0,0, ,0,0,0,0, ,0,0,0,0, ,0,0,0, ,0,0,0,0, 
11922,ITA,15,Nwakalor Sylvia Chinelo ,O,0,0,0,-50.00,0,0,0,1,1,0.00,0,1,0,1,-100.00,0,0,0,0, ,0,0,0,0, ,0,0,0, ,0,0,0,0, 
11922,ITA,19,Mingardi Camilla ,OH,9,1,2,15.79,12,9,5,12,26,15.38,1,0,1,2,50.00,2,1,7,10,10.00,0,0,0,0, ,11,2,13,69.23,0,0,1,1,0.00
11922,ITA,21,Lubian Marina ,MB,7,0,1,13.64,8,7,1,4,12,50.00,0,2,1,3,-66.67,1,2,4,7,-14.29,0,0,0,0, ,0,1,2,-50.00,0,0,1,1,0.00
11922,ITA,22,Morello Rachele ,S,0,0,0, ,0,0,0,0,0, ,0,0,0,0, ,0,0,0,0, ,0,0,0,0, ,0,1,2,-50.00,0,0,9,9,0.00
11922,ITA,23,De Bortoli Chiara ,L,0,0,0, ,0,0,0,0,0, ,0,0,0,0, ,0,0,0,0, ,1,0,0,1,100.00,0,0,0, ,0,0,2,2,0.00
11922,ITA,24,Mazzaro Alessia ,MB,0,0,0, ,0,0,0,0,0, ,0,0,0,0, ,0,0,0,0, ,0,0,0,0, ,0,0,0, ,0,0,0,0, 
11922,ITA,25,Piva Rebecca ,OH,5,0,0,15.79,5,5,1,8,14,28.57,0,0,1,1,0.00,0,1,3,4,-25.00,4,1,5,10,30.00,4,2,6,33.33,0,0,0,0, 
11922,ITA,27,Furlan Eleonora ,MB,1,1,0,-20.00,2,1,1,4,6,0.00,1,2,0,3,-33.33,0,3,8,11,-27.27,0,1,0,1,-100.00,3,2,5,20.00,0,0,1,1,0.00
11922,ITA,28,Melli Giulia ,OH,11,0,0,14.63,11,11,5,17,33,18.18,0,0,0,0, ,0,0,8,8,0.00,6,1,21,28,17.86,4,3,7,14.29,0,0,3,3,0.00
11922,ITA,31,Fersino Eleonora ,L,0,0,0, ,0,0,0,0,0, ,0,0,0,0, ,0,0,0,0, ,9,1,3,13,61.54,7,6,13,7.69,0,0,9,9,0.00
11922,ITA,32,Omoruyi Oghosasere Loveth ,OH,4,0,0,33.33,4,4,1,1,6,50.00,0,0,0,0, ,0,0,3,3,0.00,1,2,11,14,-7.14,0,2,3,-66.67,0,0,0,0, 
11923,KOR,1,Lee Soyoung ,OH,2,0,0,-8.33,2,2,2,5,9,0.00,0,0,2,2,0.00,0,1,0,1,-100.00,0,0,8,8,0.00,6,0,6,100.00,0,0,0,0, 
11923,KOR,2,Lee Dahyeon ,MB,0,0,0, ,0,0,0,0,0, ,0,0,0,0, ,0,0,0,0, ,0,0,0,0, ,0,0,0, ,0,0,0,0, 
11923,KOR,3,Yeum Hye Seon ,S,2,0,0,-14.29,2,2,0,0,2,100.00,0,2,2,4,-50.00,0,3,12,15,-20.00,0,0,0,0, ,10,5,17,29.41,17,0,90,107,15.89
11923,KOR,5,Han Dahye ,L,0,0,0, ,0,0,0,0,0, ,0,0,0,0, ,0,0,0,0, ,0,0,1,1,0.00,0,0,0, ,0,0,0,0, 
11923,KOR,6,Kim Dain ,S,0,0,0,0.00,0,0,0,0,0, ,0,0,0,0, ,0,0,3,3,0.00,0,0,1,1,0.00,3,0,4,75.00,0,1,13,14,-7.14
11923,KOR,8,Park Eunjin ,MB,5,1,2,-11.11,8,5,3,4,12,16.67,1,6,3,10,-50.00,2,4,17,23,-8.70,0,0,0,0, ,3,0,4,75.00,0,0,4,4,0.00
11923,KOR,9,Oh Jiyoung ,L,0,0,0, ,0,0,0,0,0, ,0,0,0,0, ,0,0,0,0, ,7,1,20,28,21.43,22,5,27,62.96,0,0,7,7,0.00
11923,KOR,10,Kim Yeon Koung ,OH,21,2,0,14.77,23,21,5,26,52,30.77,2,4,6,12,-16.67,0,1,23,24,-4.17,8,2,8,18,33.33,10,2,12,66.67,0,0,10,10,0.00
11923,KOR,12,Han Songyi ,MB,0,0,0, ,0,0,0,0,0, ,0,0,0,0, ,0,0,0,0, ,0,0,0,0, ,0,0,0, ,0,0,0,0, 
11923,KOR,13,Park Jeongah ,OH,22,2,0,22.22,24,22,7,10,39,38.46,2,2,2,6,0.00,0,3,6,9,-33.33,5,6,25,36,-2.78,6,0,7,85.71,0,0,4,4,0.00
11923,KOR,14,Yang Hyo Jin ,MB,8,1,3,2.22,12,8,0,5,13,61.54,1,9,2,12,-66.67,3,2,15,20,5.00,0,0,0,0, ,8,0,8,100.00,0,0,4,4,0.00
11923,KOR,15,Yuk Seoyoung ,OH,0,0,0, ,0,0,0,0,0, ,0,0,0,0, ,0,0,0,0, ,0,0,0,0, ,0,0,0, ,0,0,0,0, 
11923,KOR,16,Jeong Jiyun ,O,12,1,2,10.71,15,12,2,17,31,32.26,1,7,3,11,-54.55,2,0,12,14,14.29,0,0,1,1,0.00,13,1,14,85.71,0,0,8,8,0.00
11923,KOR,19,Pyo Seungju ,OH,1,0,0,-28.57,1,1,1,1,3,0.00,0,0,0,0, ,0,2,2,4,-50.00,1,0,4,5,20.00,2,0,2,100.00,0,0,1,1,0.00
11923,CAN,1,Bujan Cassandra ,L,0,0,0, ,0,0,0,0,0, ,0,0,0,0, ,0,0,0,0, ,1,1,14,16,0.00,12,7,21,23.81,1,0,14,15,6.67
11923,CAN,3,Van Ryk Kiera ,OH,21,1,2,6.58,24,21,7,19,47,29.79,1,7,2,10,-60.00,2,5,12,19,-15.79,3,0,5,8,37.50,19,5,29,48.28,0,0,7,7,0.00
11923,CAN,7,Van Buskirk Layne ,MB,0,0,0, ,0,0,0,0,0, ,0,0,0,0, ,0,0,0,0, ,0,0,0,0, ,0,0,0, ,0,0,0,0, 
11923,CAN,8,Ogoms Alicia ,MB,0,0,0, ,0,0,0,0,0, ,0,0,0,0, ,0,0,0,0, ,0,0,0,0, ,0,0,0, ,0,0,0,0, 
11923,CAN,11,Mitrovic Andrea ,OH,16,1,2,20.63,19,16,3,22,41,31.71,1,2,4,7,-14.29,2,1,12,15,6.67,8,4,25,37,10.81,7,5,14,14.29,0,0,1,1,0.00
11923,CAN,12,Cross Jennifer ,MB,4,2,2,9.52,8,4,0,4,8,50.00,2,3,2,7,-14.29,2,1,24,27,3.70,0,0,0,0, ,2,0,3,66.67,0,0,1,1,0.00
11923,CAN,13,King Brie ,S,1,2,0,-6.90,3,1,0,4,5,20.00,2,5,2,9,-33.33,0,0,15,15,0.00,0,0,1,1,0.00,7,1,11,54.55,37,1,83,121,29.75
11923,CAN,14,Howe Hilary ,OH,15,3,0,14.29,18,15,6,12,33,27.27,3,2,1,6,16.67,0,3,7,10,-30.00,4,2,24,30,6.67,13,3,16,62.50,0,0,2,2,0.00
11923,CAN,15,Joseph Shainah ,O,0,0,0, ,0,0,0,0,0, ,0,0,0,0, ,0,0,0,0, ,0,0,0,0, ,0,0,0, ,0,0,0,0, 
11923,CAN,16,Livingston Caroline ,OH,0,0,1,10.00,1,0,0,0,0, ,0,0,0,0, ,1,0,9,10,10.00,2,0,2,4,50.00,0,1,1,-100.00,0,0,0,0, 
11923,CAN,18,Robitaille Kim ,S,0,0,0, ,0,0,0,0,0, ,0,0,0,0, ,0,0,0,0, ,0,0,0,0, ,0,0,0, ,0,0,0,0, 
11923,CAN,19,Maglio Emily ,MB,8,2,2,-3.77,12,8,2,11,21,28.57,2,9,6,17,-41.18,2,3,10,15,-6.67,0,0,1,1,0.00,5,1,6,66.67,0,0,1,1,0.00
11923,CAN,22,Snape Kennedy Brooklyn ,L,0,0,0, ,0,0,0,0,0, ,0,0,0,0, ,0,0,0,0, ,0,0,0,0, ,0,0,0, ,0,0,0,0, 
11923,CAN,23,Austin Parker Jane ,OH,0,0,0, ,0,0,0,0,0, ,0,0,0,0, ,0,0,0,0, ,0,0,0,0, ,0,0,0, ,0,0,0,0, 
11924,BRA,5,Da Silva Adenizia ,MB,4,1,0,9.52,5,4,0,2,6,66.67,1,3,1,5,-40.00,0,0,10,10,0.00,0,0,0,0, ,1,0,1,100.00,0,0,1,1,0.00
11924,BRA,6,Alexandre Costa Nunes Nyeme Victoria ,L,0,0,0, ,0,0,0,0,0, ,0,0,0,0, ,0,0,0,0, ,0,0,2,2,0.00,2,0,2,100.00,0,0,0,0, 
11924,BRA,7,Montibeller Rosamaria ,OH,4,0,1,20.00,5,4,0,3,7,57.14,0,1,0,1,-100.00,1,1,5,7,0.00,1,0,1,2,50.00,2,0,3,66.67,0,0,0,0, 
11924,BRA,8,Silva Carneiro Macris Fernanda ,S,0,0,1,-9.09,1,0,0,1,1,0.00,0,1,1,2,-50.00,1,1,6,8,0.00,0,0,0,0, ,6,0,6,100.00,15,0,38,53,28.30
11924,BRA,9,Ratzke Roberta Silva ,S,0,0,0,0.00,0,0,0,0,0, ,0,0,0,0, ,0,0,3,3,0.00,0,0,0,0, ,2,1,3,33.33,4,0,15,19,21.05
11924,BRA,10,Braga Guimaraes Gabriela ,OH,8,2,0,26.67,10,8,0,8,16,50.00,2,0,0,2,100.00,0,2,10,12,-16.67,12,0,6,18,66.67,8,0,8,100.00,0,0,1,1,0.00
11924,BRA,11,Caixeta Tandara ,OH,7,2,2,21.88,11,7,2,7,16,31.25,2,1,0,3,33.33,2,1,10,13,7.69,0,0,0,0, ,3,0,3,100.00,0,0,0,0, 
11924,BRA,13,Castro De Paula Blassioli Sheilla ,O,0,0,0, ,0,0,0,0,0, ,0,0,0,0, ,0,0,0,0, ,0,0,0,0, ,0,0,0, ,0,0,0,0, 
11924,BRA,15,Da Silva Ana Carolina ,MB,1,2,0,20.00,3,1,0,1,2,50.00,2,1,1,4,25.00,0,0,4,4,0.00,0,0,0,0, ,0,0,0, ,0,0,1,1,0.00
11924,BRA,16,Rodrigues Fernanda ,OH,9,1,0,34.62,10,9,0,9,18,50.00,1,1,0,2,0.00,0,0,6,6,0.00,4,0,2,6,66.67,4,1,5,60.00,0,1,0,1,-100.00
11924,BRA,18,Brait Camila ,L,0,0,0, ,0,0,0,0,0, ,0,0,0,0, ,0,0,0,0, ,3,0,1,4,75.00,8,1,9,77.78,0,0,6,6,0.00
11924,BRA,20,Correa Ana Beatriz ,MB,4,3,0,21.05,7,4,0,3,7,57.14,3,3,1,7,0.00,0,0,5,5,0.00,0,0,0,0, ,0,0,0, ,0,0,0,0, 
11924,BRA,24,Geraldo Teixeira Lorenne ,O,6,0,1,46.67,7,6,0,4,10,60.00,0,0,0,0, ,1,0,4,5,20.00,0,0,0,0, ,0,0,0, ,0,0,0,0, 
11924,BRA,28,Araujo De Souza Mayany Cristina ,MB,0,0,0,-50.00,0,0,0,1,1,0.00,0,0,0,0, ,0,1,0,1,-100.00,0,0,0,0, ,0,0,0, ,0,0,0,0, 
11924,THA,2,Pannoy Piyanut ,L,0,0,0, ,0,0,0,0,0, ,0,0,0,0, ,0,0,0,0, ,5,0,8,13,38.46,14,5,19,47.37,0,0,8,8,0.00
11924,THA,5,Thinkaow Pleumjit ,MB,8,0,0,21.74,8,8,2,8,18,33.33,0,0,0,0, ,0,1,4,5,-20.00,0,0,0,0, ,0,0,0, ,0,0,2,2,0.00
11924,THA,6,Sittirak Onuma ,OH,8,0,0,2.94,8,8,6,13,27,7.41,0,0,0,0, ,0,1,6,7,-14.29,7,0,7,14,50.00,3,2,5,20.00,0,1,3,4,-25.00
11924,THA,8,Sang-Ob Tirawan ,MB,0,0,0, ,0,0,0,0,0, ,0,0,0,0, ,0,0,0,0, ,0,0,0,0, ,0,0,0, ,0,0,0,0, 
11924,THA,9,Chuewulim Sutadta ,OH,0,0,0,-15.38,0,0,2,6,8,-25.00,0,0,0,0, ,0,0,5,5,0.00,2,2,8,12,0.00,3,1,4,50.00,0,0,1,1,0.00
11924,THA,10,Apinyapong Wilavan ,L,1,0,0,-19.05,1,1,3,12,16,-12.50,0,2,0,2,-100.00,0,0,3,3,0.00,2,1,11,14,7.14,1,1,2,0.00,0,0,1,1,0.00
11924,THA,12,Chaisri Tapaphaipun ,L,0,0,0, ,0,0,0,0,0, ,0,0,0,0, ,0,0,0,0, ,0,0,0,0, ,0,0,0, ,0,0,0,0, 
11924,THA,13,Tomkom Nootsara ,S,0,0,0,-14.29,0,0,0,3,3,0.00,0,0,1,1,0.00,0,1,2,3,-33.33,0,0,0,0, ,4,2,6,33.33,8,2,71,81,7.41
11924,THA,14,Juangjan Pattiya ,OH,0,0,0,-66.67,0,0,2,1,3,-66.67,0,0,0,0, ,0,0,0,0, ,0,0,0,0, ,0,0,0, ,0,0,1,1,0.00
11924,THA,15,Kanthong Malika ,O,6,0,0,12.00,6,6,2,12,20,20.00,0,0,1,1,0.00,0,1,3,4,-25.00,5,2,8,15,20.00,1,2,3,-33.33,0,1,0,1,-100.00
11924,THA,17,Piampongsan Gullapa ,S,0,0,0, ,0,0,0,0,0, ,0,0,0,0, ,0,0,0,0, ,0,0,0,0, ,2,0,2,100.00,0,0,9,9,0.00
11924,THA,19,Krause Karina ,MB,2,1,0,13.33,3,2,0,5,7,28.57,1,1,0,2,0.00,0,0,6,6,0.00,0,0,0,0, ,0,1,1,-100.00,0,0,1,1,0.00
11924,THA,22,Nilapa Chatsuda ,OH,0,0,0,-50.00,0,0,1,0,1,-100.00,0,0,0,0, ,0,0,1,1,0.00,0,0,0,0, ,0,0,0, ,0,0,0,0, 
11924,THA,24,Nuanjam Watchareeya ,MB,1,0,0,25.00,1,1,0,1,2,50.00,0,0,0,0, ,0,0,2,2,0.00,0,0,0,0, ,0,0,0, ,0,0,0,0, 
11925,USA,1,Hancock Micha ,S,0,0,0,-12.50,0,0,0,0,0, ,0,0,0,0, ,0,1,7,8,-12.50,0,0,0,0, ,3,0,3,100.00,2,1,12,15,6.67
11925,USA,2,Poulter Jordyn ,S,0,1,1,5.00,2,0,0,1,1,0.00,1,1,1,3,0.00,1,0,15,16,6.25,0,0,0,0, ,12,1,13,84.62,22,0,61,83,26.51
11925,USA,4,Wong-Orantes Justine ,L,0,0,0, ,0,0,0,0,0, ,0,0,0,0, ,0,0,0,0, ,9,1,10,20,40.00,13,4,18,50.00,0,0,11,11,0.00
11925,USA,8,Tapp Hannah ,MB,0,0,0, ,0,0,0,0,0, ,0,0,0,0, ,0,0,0,0, ,0,0,0,0, ,0,0,0, ,0,0,0,0, 
11925,USA,10,Larson Jordan ,OH,13,0,0,16.33,13,13,0,14,27,48.15,0,3,1,4,-75.00,0,2,16,18,-11.11,9,3,15,27,22.22,11,3,14,57.14,0,0,6,6,0.00
11925,USA,11,Drews Andrea ,O,5,0,0,27.27,5,5,1,3,9,44.44,0,1,1,2,-50.00,0,0,0,0, ,0,0,0,0, ,2,0,2,100.00,0,0,0,0, 
11925,USA,12,Thompson Jordan ,O,14,5,0,12.50,19,14,7,15,36,19.44,5,4,5,14,7.14,0,1,5,6,-16.67,0,0,0,0, ,7,2,10,50.00,0,0,1,1,0.00
11925,USA,14,Bartsch-Hackley Michelle ,OH,12,1,1,15.56,14,12,3,11,26,34.62,1,1,6,8,0.00,1,3,7,11,-18.18,7,1,11,19,31.58,6,1,8,62.50,0,0,6,6,0.00
11925,USA,15,Hill Kimberly ,OH,0,0,0,-6.67,0,0,0,0,0, ,0,0,0,0, ,0,1,14,15,-6.67,0,0,0,0, ,2,1,4,25.00,0,0,1,1,0.00
11925,USA,16,Akinradewo Foluke ,MB,9,1,0,7.41,10,9,1,3,13,61.54,1,5,3,9,-44.44,0,2,3,5,-40.00,0,0,0,0, ,5,1,9,44.44,0,0,0,0, 
11925,USA,17,Courtney Megan ,OH,0,0,0, ,0,0,0,0,0, ,0,0,0,0, ,0,0,0,0, ,0,0,0,0, ,0,0,0, ,0,0,0,0, 
11925,USA,22,Washington Haleigh ,MB,8,2,2,12.20,12,8,0,2,10,80.00,2,6,5,13,-30.77,2,1,15,18,5.56,0,0,0,0, ,1,0,1,100.00,0,0,0,0, 
11925,USA,23,Robinson Kelsey ,OH,0,0,0, ,0,0,0,0,0, ,0,0,0,0, ,0,0,0,0, ,0,0,0,0, ,0,0,0, ,0,0,0,0, 
11925,USA,24,Ogbogu Chiaka ,MB,0,0,0, ,0,0,0,0,0, ,0,0,0,0, ,0,0,0,0, ,0,0,0,0, ,0,0,0, ,0,0,0,0, 
11925,TUR,2,Akoz Simge Sebnem ,L,0,0,0, ,0,0,0,0,0, ,0,0,0,0, ,0,0,0,0, ,9,1,11,21,38.10,14,4,19,52.63,0,0,8,8,0.00
11925,TUR,3,Ãzbay Cansu ,S,0,0,0,-40.00,0,0,0,1,1,0.00,0,4,1,5,-80.00,0,2,7,9,-22.22,0,0,0,0, ,11,2,15,60.00,9,1,78,88,9.09
11925,TUR,4,Senoglu Tugba ,OH,1,0,0,-30.00,1,1,3,3,7,-28.57,0,1,0,1,-100.00,0,0,2,2,0.00,3,1,5,9,22.22,0,0,0, ,0,0,1,1,0.00
11925,TUR,5,Ercan Seyma ,OH,1,0,0,0.00,1,1,0,1,2,50.00,0,1,0,1,-100.00,0,0,1,1,0.00,1,0,3,4,25.00,0,0,1,0.00,0,0,0,0, 
11925,TUR,6,Caliskan Kubra ,MB,1,1,1,-11.11,3,1,1,1,3,0.00,1,3,2,6,-33.33,1,1,7,9,0.00,0,0,0,0, ,1,0,1,100.00,0,0,0,0, 
11925,TUR,7,Baladin Hande ,OH,10,1,2,9.76,13,10,5,14,29,17.24,1,2,0,3,-33.33,2,2,5,9,0.00,4,1,14,19,15.79,4,1,6,50.00,0,0,2,2,0.00
11925,TUR,9,Ismailoglu Meliha ,OH,3,1,1,-5.56,5,3,4,10,17,-5.88,1,1,1,3,0.00,1,2,13,16,-6.25,14,1,17,32,40.62,7,4,11,27.27,0,0,0,0, 
11925,TUR,12,Unal Buse ,S,0,0,0, ,0,0,0,0,0, ,0,0,0,0, ,0,0,0,0, ,0,0,0,0, ,1,0,1,100.00,2,0,16,18,11.11
11925,TUR,13,Boz Meryem ,O,2,0,0,7.14,2,2,1,5,8,12.50,0,0,0,0, ,0,0,6,6,0.00,0,0,0,0, ,3,0,3,100.00,0,0,1,1,0.00
11925,TUR,14,Erdem DÃ¼ndar Eda ,MB,7,0,1,6.25,8,7,1,6,14,42.86,0,4,4,8,-50.00,1,1,8,10,0.00,0,0,0,0, ,2,1,4,25.00,0,0,1,1,0.00
11925,TUR,16,Sahin Saliha ,OH,0,0,0, ,0,0,0,0,0, ,0,0,0,0, ,0,0,0,0, ,0,0,0,0, ,0,0,0, ,0,0,0,0, 
11925,TUR,18,Gunes Zehra ,MB,4,0,0,-5.88,4,4,2,2,8,25.00,0,2,1,3,-66.67,0,1,5,6,-16.67,0,0,0,0, ,0,1,1,-100.00,0,0,0,0, 
11925,TUR,22,Aydin Ä°lkin ,OH,0,0,0, ,0,0,0,0,0, ,0,0,0,0, ,0,0,0,0, ,1,0,0,1,100.00,0,1,1,-100.00,0,0,0,0, 
11925,TUR,99,Karakurt Ebrar ,OH,15,3,0,20.00,18,15,4,18,37,29.73,3,2,5,10,10.00,0,1,7,8,-12.50,0,0,0,0, ,7,0,8,87.50,0,0,2,2,0.00
11772,RUS,1,Podlesnykh Yaroslav ,OH,9,1,0,14.29,10,9,1,4,14,57.14,1,2,2,5,-20.00,0,3,6,9,-33.33,3,0,9,12,25.00,3,1,4,50.00,0,0,1,1,0.00
11772,RUS,2,Vlasov Ilia ,MB,0,0,0, ,0,0,0,0,0, ,0,0,0,0, ,0,0,0,0, ,0,0,0,0, ,0,0,0, ,0,0,0,0, 
11772,RUS,4,Volvich Artem ,MB,5,3,0,16.67,8,5,1,3,9,44.44,3,2,4,9,11.11,0,0,12,12,0.00,1,1,1,3,0.00,2,0,2,100.00,0,0,2,2,0.00
11772,RUS,6,Baranov Evgeny ,L,0,0,0, ,0,0,0,0,0, ,0,0,0,0, ,0,0,0,0, ,0,0,0,0, ,0,0,0, ,0,0,0,0, 
11772,RUS,7,Volkov Dmitry ,OH,2,1,0,0.00,3,2,2,6,10,0.00,1,0,1,2,50.00,0,1,3,4,-25.00,4,0,6,10,40.00,4,0,4,100.00,0,0,1,1,0.00
11772,RUS,10,Bogdan Denis ,OH,0,0,1,33.33,1,0,0,0,0, ,0,0,0,0, ,1,0,2,3,33.33,0,0,0,0, ,0,0,0, ,0,0,0,0, 
11772,RUS,11,Pankov Pavel ,S,0,0,0,-42.86,0,0,0,0,0, ,0,1,1,2,-50.00,0,2,3,5,-40.00,0,0,0,0, ,3,1,4,50.00,10,0,22,32,31.25
11772,RUS,13,Muserskiy Dmitriy ,MB,0,0,0, ,0,0,0,0,0, ,0,0,0,0, ,0,0,0,0, ,0,0,0,0, ,0,0,0, ,0,0,0,0, 
11772,RUS,15,Poletaev Victor ,O,0,0,0,0.00,0,0,0,0,0, ,0,0,0,0, ,0,0,2,2,0.00,0,0,0,0, ,0,0,0, ,0,0,0,0, 
11772,RUS,17,Mikhaylov Maxim ,O,20,3,0,14.75,23,20,5,14,39,38.46,3,6,1,10,-30.00,0,3,9,12,-25.00,0,0,7,7,0.00,6,2,8,50.00,0,0,1,1,0.00
11772,RUS,18,Kliuka Egor ,OH,9,2,2,11.76,13,9,3,15,27,22.22,2,1,0,3,33.33,2,3,16,21,-4.76,13,2,11,26,42.31,5,1,6,66.67,0,0,7,7,0.00
11772,RUS,20,Kurkaev Ilyas ,MB,5,4,2,-2.78,11,5,2,4,11,27.27,4,6,3,13,-15.38,2,4,6,12,-16.67,0,0,0,0, ,2,1,3,33.33,0,0,2,2,0.00
11772,RUS,24,Kobzar Igor ,S,0,1,2,-4.00,3,0,0,3,3,0.00,1,4,1,6,-50.00,2,0,14,16,12.50,0,0,1,1,0.00,8,2,10,60.00,14,2,45,61,19.67
11772,RUS,27,Golubev Valentin ,L,0,0,0, ,0,0,0,0,0, ,0,0,0,0, ,0,0,0,0, ,6,0,12,18,33.33,9,3,12,50.00,0,0,7,7,0.00
11772,SRB,2,Kovacevic Uros ,OH,15,1,2,0.00,18,15,9,7,31,19.35,1,5,4,10,-40.00,2,4,11,17,-11.76,12,2,30,44,22.73,6,1,8,62.50,0,0,3,3,0.00
11772,SRB,3,Kapur Milorad ,L,0,0,0, ,0,0,0,0,0, ,0,0,0,0, ,0,0,0,0, ,0,0,0,0, ,0,1,1,-100.00,0,0,1,1,0.00
11772,SRB,6,Pekovic Nikola ,L,0,0,0, ,0,0,0,0,0, ,0,0,0,0, ,0,0,0,0, ,3,3,10,16,0.00,3,3,8,0.00,0,0,1,1,0.00
11772,SRB,8,Ivovic Marko ,OH,14,1,0,6.12,15,14,4,10,28,35.71,1,4,2,7,-42.86,0,4,10,14,-28.57,4,1,13,18,16.67,5,3,10,20.00,0,0,5,5,0.00
11772,SRB,9,Jovovic Nikola ,S,1,0,1,-4.35,2,1,0,2,3,33.33,0,2,3,5,-40.00,1,1,13,15,0.00,0,1,0,1,-100.00,10,3,19,36.84,20,0,66,86,23.26
11772,SRB,10,KujundÅ¾iÄ Miran ,OH,0,0,0, ,0,0,0,0,0, ,0,0,0,0, ,0,0,0,0, ,0,0,0,0, ,0,0,0, ,0,0,0,0, 
11772,SRB,12,Peric Pavle ,OH,0,0,0, ,0,0,0,0,0, ,0,0,0,0, ,0,0,0,0, ,0,0,0,0, ,0,0,0, ,0,0,0,0, 
11772,SRB,13,Simic Stevan ,MB,0,0,0, ,0,0,0,0,0, ,0,0,0,0, ,0,0,0,0, ,0,0,0,0, ,0,0,0, ,0,0,0,0, 
11772,SRB,14,Atanasijevic Aleksandar ,O,7,2,0,2.86,9,7,6,7,20,5.00,2,1,2,5,20.00,0,1,9,10,-10.00,0,0,0,0, ,2,1,5,20.00,0,0,2,2,0.00
11772,SRB,18,Podrascanin Marko ,MB,5,1,0,-13.16,6,5,0,2,7,71.43,1,8,5,14,-50.00,0,3,14,17,-17.65,0,0,0,0, ,1,1,2,0.00,0,0,2,2,0.00
11772,SRB,20,Krsmanovic Petar ,MB,9,2,0,16.67,11,9,0,2,11,81.82,2,5,3,10,-30.00,0,0,15,15,0.00,1,0,0,1,100.00,2,0,2,100.00,0,0,4,4,0.00
11772,SRB,21,Todorovic Vuk ,S,0,0,0, ,0,0,0,0,0, ,0,0,0,0, ,0,0,0,0, ,0,0,0,0, ,0,0,0, ,2,0,2,4,50.00
11772,SRB,23,Luburic Drazen ,O,4,0,0,-14.29,4,4,4,2,10,0.00,0,0,0,0, ,0,2,2,4,-50.00,0,0,0,0, ,1,1,2,0.00,0,0,0,0, 
11772,SRB,26,Kovac Davide ,OH,0,0,0, ,0,0,0,0,0, ,0,0,0,0, ,0,0,0,0, ,0,0,0,0, ,0,0,0, ,0,0,0,0, 
11773,IRI,2,Ebadipour Ghara H. Milad ,OH,8,0,1,-2.63,9,8,6,8,22,9.09,0,1,0,1,-100.00,1,3,11,15,-13.33,20,1,16,37,51.35,5,5,10,0.00,0,0,2,2,0.00
11773,IRI,3,Abedini Reza ,MB,0,0,0, ,0,0,0,0,0, ,0,0,0,0, ,0,0,0,0, ,0,0,0,0, ,0,0,0, ,0,0,0,0, 
11773,IRI,4,Marouflakrani Mir Saeid ,S,1,0,1,-4.35,2,1,0,1,2,50.00,0,1,0,1,-100.00,1,2,17,20,-5.00,0,0,1,1,0.00,8,4,13,30.77,19,0,91,110,17.27
11773,IRI,6,Mousavi Eraghi Seyed Mohammad ,MB,8,5,1,0.00,14,8,6,7,21,9.52,5,6,1,12,-8.33,1,2,9,12,-8.33,0,0,3,3,0.00,0,2,2,-100.00,0,0,4,4,0.00
11773,IRI,7,Fayazi D. Purya ,OH,0,0,0, ,0,0,0,0,0, ,0,0,0,0, ,0,0,0,0, ,0,0,0,0, ,0,0,0, ,0,0,0,0, 
11773,IRI,8,Hazratpourtalatappeh Mohammadreza ,L,0,0,0, ,0,0,0,0,0, ,0,0,0,0, ,0,0,0,0, ,5,0,10,15,33.33,3,2,5,20.00,0,0,1,1,0.00
11773,IRI,9,Gholami Masoud ,MB,3,1,0,9.52,4,3,0,1,4,75.00,1,2,1,4,-25.00,0,0,13,13,0.00,0,0,0,0, ,0,1,1,-100.00,0,0,0,0, 
11773,IRI,11,Kazemi Saber ,O,9,2,0,12.12,11,9,5,9,23,17.39,2,1,1,4,25.00,0,1,5,6,-16.67,0,0,1,1,0.00,1,1,2,0.00,0,0,1,1,0.00
11773,IRI,15,Mojarad Aliasghar ,MB,2,2,0,7.69,4,2,1,2,5,20.00,2,0,0,2,100.00,0,2,4,6,-33.33,0,1,1,2,-50.00,0,0,0, ,0,0,0,0, 
11773,IRI,17,Salehi Meisam ,OH,9,2,1,-2.04,12,9,3,8,20,30.00,2,4,1,7,-28.57,1,6,15,22,-22.73,4,2,11,17,11.76,5,2,7,42.86,0,0,1,1,0.00
11773,IRI,21,Salehi Arman ,L,0,0,0, ,0,0,0,0,0, ,0,0,0,0, ,0,0,0,0, ,5,1,7,13,30.77,5,4,9,11.11,0,0,3,3,0.00
11773,IRI,22,Esfandiar Amirhossein ,OH,0,0,0,0.00,0,0,0,0,0, ,0,0,0,0, ,0,0,1,1,0.00,0,0,0,0, ,0,1,1,-100.00,0,0,0,0, 
11773,IRI,23,Saadat Bardia ,O,14,1,1,15.91,16,14,5,8,27,33.33,1,2,1,4,-25.00,1,2,10,13,-7.69,0,0,0,0, ,0,1,1,-100.00,0,0,0,0, 
11773,IRI,24,Karimisouchelmaei Javad ,S,0,0,0, ,0,0,0,0,0, ,0,0,0,0, ,0,0,0,0, ,0,0,0,0, ,0,0,0, ,0,0,1,1,0.00
11773,AUS,1,Graham Beau ,MB,12,0,3,12.73,15,12,4,9,25,32.00,0,2,1,3,-66.67,3,2,22,27,3.70,1,0,1,2,50.00,2,5,7,-42.86,0,0,2,2,0.00
11773,AUS,2,Dosanjh Arshdeep ,S,1,1,1,-14.29,3,1,1,3,5,0.00,1,3,1,5,-40.00,1,3,14,18,-11.11,0,0,0,0, ,4,5,9,-11.11,17,1,82,100,16.00
11773,AUS,7,Weir James ,MB,0,0,0,0.00,0,0,0,0,0, ,0,0,0,0, ,0,0,1,1,0.00,0,0,0,0, ,0,0,0, ,0,0,0,0, 
11773,AUS,8,O'Dea Trent ,MB,13,4,0,28.95,17,13,2,4,19,57.89,4,2,0,6,33.33,0,2,11,13,-15.38,1,0,0,1,100.00,1,0,1,100.00,0,0,0,0, 
11773,AUS,11,Perry Luke ,L,0,0,0, ,0,0,0,0,0, ,0,0,0,0, ,0,0,0,0, ,13,0,5,18,72.22,14,8,24,25.00,0,0,14,14,0.00
11773,AUS,12,Mote Nehemiah ,MB,8,4,0,20.00,12,8,3,7,18,27.78,4,1,0,5,60.00,0,1,11,12,-8.33,3,0,1,4,75.00,1,2,3,-33.33,0,0,1,1,0.00
11773,AUS,15,Smith Luke ,OH,11,2,0,-1.79,13,11,8,13,32,9.38,2,5,0,7,-42.86,0,1,16,17,-5.88,15,1,20,36,38.89,3,3,6,0.00,0,0,0,0, 
11773,AUS,16,Douglas-Powell Thomas Ewen ,OH,1,0,0,0.00,1,1,0,0,1,100.00,0,0,0,0, ,0,1,0,1,-100.00,3,1,2,6,33.33,0,1,1,-100.00,0,0,0,0, 
11773,AUS,21,Butler Nicholas ,S,0,0,0, ,0,0,0,0,0, ,0,0,0,0, ,0,0,0,0, ,0,0,0,0, ,2,0,2,100.00,2,0,4,6,33.33
11773,AUS,27,Senica Max ,OH,0,0,0,0.00,0,0,0,0,0, ,0,0,0,0, ,0,0,1,1,0.00,2,0,1,3,66.67,0,0,0, ,0,0,0,0, 
11773,AUS,28,Taylor Tim ,OH,0,0,0, ,0,0,0,0,0, ,0,0,0,0, ,0,0,0,0, ,0,0,0,0, ,0,0,0, ,0,0,0,0, 
11773,AUS,29,Garrett Ethan ,OH,8,1,1,-20.41,10,8,11,9,28,-10.71,1,3,2,6,-33.33,1,6,8,15,-33.33,11,3,6,20,40.00,0,1,1,-100.00,0,0,1,1,0.00
11773,AUS,31,Aubrey Matthew ,O,0,0,0, ,0,0,0,0,0, ,0,0,0,0, ,0,0,0,0, ,0,0,0,0, ,0,0,0, ,0,0,0,0, 
11773,AUS,32,Azeez Oluwatobi Elliot ,OH,1,0,0,100.00,1,1,0,0,1,100.00,0,0,0,0, ,0,0,0,0, ,0,0,0,0, ,0,0,0, ,0,0,0,0, 
11774,ARG,1,Sanchez Matias ,S,0,0,0, ,0,0,0,0,0, ,0,0,0,0, ,0,0,0,0, ,0,0,0,0, ,1,0,1,100.00,2,0,6,8,25.00
11774,ARG,2,Pereyra Federico ,O,2,0,0,66.67,2,2,0,0,2,100.00,0,0,0,0, ,0,0,1,1,0.00,0,0,0,0, ,2,1,3,33.33,0,0,0,0, 
11774,ARG,6,Poglajen Cristian ,OH,0,0,0, ,0,0,0,0,0, ,0,0,0,0, ,0,0,0,0, ,0,0,0,0, ,0,0,0, ,0,0,0,0, 
11774,ARG,7,Conte Facundo ,OH,12,0,0,7.14,12,12,1,8,21,52.38,0,3,3,6,-50.00,0,5,10,15,-33.33,3,2,10,15,6.67,9,3,12,50.00,0,0,3,3,0.00
11774,ARG,8,Loser Agustin ,MB,7,1,2,0.00,10,7,0,0,7,100.00,1,5,5,11,-36.36,2,5,10,17,-17.65,0,0,2,2,0.00,2,1,3,33.33,0,0,0,0, 
11774,ARG,9,Danani Santiago ,L,0,0,0, ,0,0,0,0,0, ,0,0,0,0, ,0,0,0,0, ,8,0,14,22,36.36,9,1,11,72.73,0,0,5,5,0.00
11774,ARG,10,Lazo NicolÃ¡s ,OH,5,1,0,-5.26,6,5,4,2,11,9.09,1,2,0,3,-33.33,0,1,4,5,-20.00,1,1,6,8,0.00,3,1,4,50.00,0,0,0,0, 
11774,ARG,11,SolÃ© Sebastian ,MB,6,1,0,-2.56,7,6,1,5,12,41.67,1,5,7,13,-30.77,0,2,12,14,-14.29,1,0,0,1,100.00,1,0,1,100.00,0,0,1,1,0.00
11774,ARG,12,Lima Bruno ,O,14,0,2,4.26,16,14,6,4,24,33.33,0,5,3,8,-62.50,2,3,10,15,-6.67,0,0,0,0, ,2,2,5,0.00,0,0,1,1,0.00
11774,ARG,13,Palacios Ezequiel ,OH,7,0,2,25.93,9,7,1,5,13,46.15,0,0,3,3,0.00,2,1,8,11,9.09,7,1,9,17,35.29,3,2,5,20.00,0,0,0,0, 
11774,ARG,15,De Cecco Luciano ,S,1,0,0,-11.11,1,1,0,1,2,50.00,0,1,3,4,-25.00,0,2,10,12,-16.67,0,0,0,0, ,4,3,8,12.50,20,0,56,76,26.32
11774,ARG,17,Mendez Nicolas ,OH,0,0,0, ,0,0,0,0,0, ,0,0,0,0, ,0,0,0,0, ,0,0,1,1,0.00,0,0,0, ,0,0,0,0, 
11774,ARG,18,Ramos Martin ,MB,0,0,0, ,0,0,0,0,0, ,0,0,0,0, ,0,0,0,0, ,0,0,0,0, ,0,0,0, ,0,0,0,0, 
11774,ARG,19,Massimino Franco ,L,0,0,0, ,0,0,0,0,0, ,0,0,0,0, ,0,0,0,0, ,0,0,0,0, ,0,0,0, ,0,0,0,0, 
11774,BUL,1,Karyagin Denis ,O,3,0,0,8.33,3,3,1,4,8,25.00,0,0,1,1,0.00,0,1,2,3,-33.33,0,0,0,0, ,0,1,1,-100.00,0,0,1,1,0.00
11774,BUL,2,Chavdarov Stefan ,MB,4,0,0,-11.76,4,4,2,0,6,33.33,0,2,2,4,-50.00,0,2,5,7,-28.57,0,0,0,0, ,3,1,4,50.00,0,0,0,0, 
11774,BUL,3,Kolev Nikolay ,MB,5,2,0,10.34,7,5,1,5,11,36.36,2,3,0,5,-20.00,0,0,13,13,0.00,0,0,1,1,0.00,0,2,2,-100.00,0,0,1,1,0.00
11774,BUL,4,Atanasov Martin ,OH,11,1,2,13.04,14,11,3,14,28,28.57,1,1,1,3,0.00,2,4,9,15,-13.33,9,0,10,19,47.37,4,1,6,50.00,0,0,1,1,0.00
11774,BUL,9,Seganov Georgi ,S,1,1,1,-23.08,3,1,0,0,1,100.00,1,5,3,9,-44.44,1,4,11,16,-18.75,0,0,1,1,0.00,5,2,7,42.86,12,1,75,88,12.50
11774,BUL,10,Stankov Svetoslav ,S,0,0,0, ,0,0,0,0,0, ,0,0,0,0, ,0,0,0,0, ,0,0,0,0, ,0,0,0, ,0,0,4,4,0.00
11774,BUL,12,Petrov Georgi ,OH,0,0,0, ,0,0,0,0,0, ,0,0,0,0, ,0,0,0,0, ,0,0,0,0, ,0,0,0, ,0,0,0,0, 
11774,BUL,14,Asparuhov Asparuh ,OH,2,0,0,0.00,2,2,0,4,6,33.33,0,2,0,2,-100.00,0,0,4,4,0.00,4,0,5,9,44.44,1,1,2,0.00,0,0,1,1,0.00
11774,BUL,15,Lyutskanov Gordan ,OH,0,0,0,-50.00,0,0,1,0,1,-100.00,0,0,0,0, ,0,0,1,1,0.00,0,0,2,2,0.00,0,0,0, ,0,0,0,0, 
11774,BUL,16,Ivanov Vladislav ,L,0,0,0, ,0,0,0,0,0, ,0,0,0,0, ,0,0,0,0, ,4,2,11,17,11.76,12,6,20,30.00,0,0,4,4,0.00
11774,BUL,22,Kartev Nikolay ,MB,0,0,0,-40.00,0,0,0,2,2,0.00,0,1,0,1,-100.00,0,1,1,2,-50.00,0,0,0,0, ,2,0,2,100.00,0,0,1,1,0.00
11774,BUL,24,Ivanov Martin ,L,0,0,0, ,0,0,0,0,0, ,0,0,0,0, ,0,0,0,0, ,0,0,0,0, ,0,0,0, ,0,0,0,0, 
11774,BUL,25,Parapunov Radoslav ,O,11,2,0,5.00,13,11,4,5,20,35.00,2,3,5,10,-10.00,0,4,6,10,-40.00,0,0,0,0, ,2,3,5,-20.00,0,0,1,1,0.00
11774,BUL,26,Ivanov Svetoslav ,OH,8,1,1,28.12,10,8,0,11,19,42.11,1,1,0,2,0.00,1,0,10,11,9.09,7,4,11,22,13.64,0,1,1,-100.00,0,0,0,0, 
11775,JPN,1,Shimizu Kunihiro ,O,11,0,0,21.88,11,11,3,7,21,38.10,0,0,2,2,0.00,0,1,8,9,-11.11,0,0,0,0, ,1,1,3,0.00,0,0,0,0, 
11775,JPN,2,Onodera Taishi ,MB,6,2,0,8.33,8,6,1,3,10,50.00,2,3,0,5,-20.00,0,2,7,9,-22.22,2,0,0,2,100.00,1,0,1,100.00,0,0,0,0, 
11775,JPN,5,Fukuzawa Tatsuya ,OH,0,0,0, ,0,0,0,0,0, ,0,0,0,0, ,0,0,0,0, ,0,0,0,0, ,0,0,0, ,0,0,0,0, 
11775,JPN,6,Yamauchi Akihiro ,MB,2,1,1,18.75,4,2,1,2,5,20.00,1,0,0,1,100.00,1,0,9,10,10.00,0,0,0,0, ,0,1,1,-100.00,0,0,2,2,0.00
11775,JPN,12,Sekita Masahiro ,S,0,1,0,-4.76,1,0,0,3,3,0.00,1,1,0,2,0.00,0,1,15,16,-6.25,0,0,0,0, ,6,3,9,33.33,19,0,47,66,28.79
11775,JPN,13,Oya Masaki ,S,0,0,0, ,0,0,0,0,0, ,0,0,0,0, ,0,0,0,0, ,0,0,0,0, ,0,0,0, ,0,0,0,0, 
11775,JPN,14,Ishikawa Yuki ,OH,17,0,3,29.55,20,17,1,5,23,69.57,0,2,0,2,-100.00,3,4,12,19,-5.26,8,1,9,18,38.89,5,5,10,0.00,0,0,3,3,0.00
11775,JPN,15,Ri Haku ,MB,0,0,0, ,0,0,0,0,0, ,0,0,0,0, ,0,0,0,0, ,0,0,0,0, ,0,0,0, ,0,0,0,0, 
11775,JPN,16,Takahashi Kentaro ,MB,0,0,0, ,0,0,0,0,0, ,0,0,0,0, ,0,0,0,0, ,0,0,0,0, ,0,0,0, ,0,0,0,0, 
11775,JPN,17,Takanashi Kenta ,OH,0,1,0,0.00,1,0,1,0,1,-100.00,1,0,0,1,100.00,0,0,0,0, ,0,0,0,0, ,0,0,0, ,0,0,0,0, 
11775,JPN,19,Otsuka Tatsunori ,OH,0,0,0, ,0,0,0,0,0, ,0,0,0,0, ,0,0,0,0, ,0,0,0,0, ,0,0,0, ,0,0,0,0, 
11775,JPN,20,Yamamoto Tomohiro ,L,0,0,0, ,0,0,0,0,0, ,0,0,0,0, ,0,0,0,0, ,7,0,2,9,77.78,8,1,9,77.78,0,0,5,5,0.00
11775,JPN,21,Takahashi Ran ,OH,10,0,0,15.15,10,10,2,8,20,40.00,0,1,1,2,-50.00,0,2,9,11,-18.18,8,1,6,15,46.67,8,5,13,23.08,0,0,1,1,0.00
11775,JPN,24,Ogawa Tomohiro ,L,0,0,0, ,0,0,0,0,0, ,0,0,0,0, ,0,0,0,0, ,0,0,0,0, ,0,0,0, ,0,0,0,0, 
11775,GER,1,Fromm Christian ,OH,0,0,0, ,0,0,0,0,0, ,0,0,0,0, ,0,0,0,0, ,0,0,0,0, ,0,0,0, ,0,0,0,0, 
11775,GER,3,Schott Ruben ,OH,7,0,0,13.04,7,7,1,8,16,37.50,0,1,1,2,-50.00,0,2,3,5,-40.00,6,2,10,18,22.22,2,5,7,-42.86,0,0,0,0, 
11775,GER,5,Reichert Moritz ,OH,8,0,2,19.35,10,8,1,8,17,41.18,0,1,1,2,-50.00,2,2,8,12,0.00,3,0,7,10,30.00,2,0,2,100.00,0,0,1,1,0.00
11775,GER,6,Kaliberda Denys ,OH,3,0,0,-12.50,3,3,3,3,9,0.00,0,1,0,1,-100.00,0,1,5,6,-16.67,6,0,10,16,37.50,1,1,2,0.00,0,0,3,3,0.00
11775,GER,7,Sossenheimer David ,OH,0,0,0,-50.00,0,0,0,0,0, ,0,0,0,0, ,0,1,1,2,-50.00,0,0,0,0, ,0,0,0, ,0,0,0,0, 
11775,GER,8,BÃ¶hme Marcus ,MB,0,0,0, ,0,0,0,0,0, ,0,0,0,0, ,0,0,0,0, ,0,0,0,0, ,0,0,0, ,0,0,0,0, 
11775,GER,10,Zenger Julian ,L,0,0,0, ,0,0,0,0,0, ,0,0,0,0, ,0,0,0,0, ,4,2,11,17,11.76,2,6,9,-44.44,0,0,4,4,0.00
11775,GER,13,Hirsch Simon ,O,0,0,0, ,0,0,0,0,0, ,0,0,0,0, ,0,0,0,0, ,0,0,0,0, ,0,0,0, ,0,0,1,1,0.00
11775,GER,16,BurggrÃ¤f Eric ,S,0,0,0, ,0,0,0,0,0, ,0,0,0,0, ,0,0,0,0, ,0,0,0,0, ,0,0,0, ,0,0,1,1,0.00
11775,GER,17,Zimmermann Jan ,S,1,0,0,-9.09,1,1,0,0,1,100.00,0,1,0,1,-100.00,0,1,8,9,-11.11,0,0,1,1,0.00,3,2,5,20.00,5,0,65,70,7.14
11775,GER,18,Krage Florian ,MB,3,1,0,11.76,4,3,1,3,7,28.57,1,1,0,2,0.00,0,0,8,8,0.00,0,0,0,0, ,2,2,4,0.00,0,0,0,0, 
11775,GER,19,RÃ¶hrs Erik ,OH,0,0,0, ,0,0,0,0,0, ,0,0,0,0, ,0,0,0,0, ,0,0,0,0, ,0,0,0, ,0,0,0,0, 
11775,GER,20,Weber Linus ,O,13,2,0,12.20,15,13,1,10,24,50.00,2,3,1,6,-16.67,0,6,5,11,-54.55,1,0,0,1,100.00,0,1,1,-100.00,0,0,1,1,0.00
11775,GER,21,Krick Tobias ,MB,3,2,0,-15.00,5,3,1,3,7,28.57,2,3,0,5,-20.00,0,4,4,8,-50.00,1,0,0,1,100.00,0,0,0, ,0,0,0,0, 
11776,ITA,1,Gardini Davide ,OH,5,0,0,11.76,5,5,1,5,11,36.36,0,0,1,1,0.00,0,2,3,5,-40.00,1,2,7,10,-10.00,2,2,4,0.00,0,0,0,0, 
11776,ITA,7,Balaso Fabio ,L,0,0,0, ,0,0,0,0,0, ,0,0,0,0, ,0,0,0,0, ,4,2,8,14,14.29,6,2,10,40.00,0,0,9,9,0.00
11776,ITA,15,Sbertoli Riccardo ,S,0,0,0,-50.00,0,0,1,0,1,-100.00,0,2,0,2,-100.00,0,1,4,5,-20.00,0,0,1,1,0.00,5,4,10,10.00,15,0,34,49,30.61
11776,ITA,18,Michieletto Alessandro ,OH,0,0,0, ,0,0,0,0,0, ,0,0,0,0, ,0,0,0,0, ,2,0,0,2,100.00,2,0,2,100.00,0,0,0,0, 
11776,ITA,21,Spirito Luca ,S,0,0,0,0.00,0,0,0,1,1,0.00,0,0,2,2,0.00,0,0,3,3,0.00,0,0,0,0, ,0,0,0, ,2,0,10,12,16.67
11776,ITA,23,Pinali Giulio ,O,5,0,2,-2.78,7,5,3,9,17,11.76,0,2,7,9,-22.22,2,3,5,10,-10.00,0,1,1,2,-50.00,5,1,6,66.67,0,0,0,0, 
11776,ITA,24,Cavuto Oreste ,OH,4,1,0,16.67,5,4,3,1,8,12.50,1,0,0,1,100.00,0,0,3,3,0.00,3,2,4,9,11.11,1,0,1,100.00,0,0,1,1,0.00
11776,ITA,25,Vitelli Marco ,MB,0,0,0,-66.67,0,0,0,0,0, ,0,0,0,0, ,0,2,1,3,-66.67,0,0,0,0, ,0,1,1,-100.00,0,0,0,0, 
11776,ITA,26,Cortesia Lorenzo ,MB,5,0,1,0.00,6,5,0,5,10,50.00,0,5,1,6,-83.33,1,1,10,12,0.00,0,0,1,1,0.00,4,1,5,60.00,0,0,1,1,0.00
11776,ITA,27,Scanferla Leonardo ,L,0,0,0, ,0,0,0,0,0, ,0,0,0,0, ,0,0,0,0, ,0,0,0,0, ,0,0,0, ,0,0,0,0, 
11776,ITA,28,Recine Francesco ,OH,1,0,0,-29.41,1,1,3,6,10,-20.00,0,2,0,2,-100.00,0,1,4,5,-20.00,1,1,7,9,0.00,1,0,1,100.00,0,0,2,2,0.00
11776,ITA,29,Bottolo Mattia ,OH,5,0,0,5.26,5,5,3,7,15,13.33,0,0,0,0, ,0,1,3,4,-25.00,4,0,6,10,40.00,2,1,3,33.33,0,0,0,0, 
11776,ITA,30,Mosca Leandro Ausibio ,MB,4,0,0,15.38,4,4,1,1,6,50.00,0,1,1,2,-50.00,0,0,5,5,0.00,0,1,0,1,-100.00,1,0,1,100.00,0,0,0,0, 
11776,ITA,31,Federici Filippo ,L,0,0,0, ,0,0,0,0,0, ,0,0,0,0, ,0,0,0,0, ,0,0,0,0, ,0,0,0, ,0,0,0,0, 
11776,USA,1,Anderson Matthew ,O,13,1,3,24.39,17,13,3,5,21,47.62,1,1,3,5,0.00,3,3,9,15,0.00,2,0,0,2,100.00,4,1,6,50.00,0,0,0,0, 
11776,USA,3,Sander Taylor ,OH,12,2,0,40.00,14,12,0,7,19,63.16,2,0,0,2,100.00,0,2,7,9,-22.22,6,1,10,17,29.41,4,0,4,100.00,0,0,2,2,0.00
11776,USA,4,Jendryk II Jeffrey ,MB,0,0,0, ,0,0,0,0,0, ,0,0,0,0, ,0,0,0,0, ,0,0,0,0, ,0,0,0, ,0,0,0,0, 
11776,USA,5,Ensing Kyle ,O,0,0,0, ,0,0,0,0,0, ,0,0,0,0, ,0,0,0,0, ,0,0,0,0, ,0,0,0, ,0,0,0,0, 
11776,USA,6,Stahl Mitchell ,MB,1,1,2,8.33,4,1,1,1,3,0.00,1,1,1,3,0.00,2,1,3,6,16.67,0,0,0,0, ,1,0,1,100.00,0,0,1,1,0.00
11776,USA,7,Shoji Kawika ,S,0,0,0, ,0,0,0,0,0, ,0,0,0,0, ,0,0,0,0, ,0,0,0,0, ,0,0,0, ,0,0,0,0, 
11776,USA,8,Defalco Torey ,OH,8,0,0,9.68,8,8,1,10,19,36.84,0,1,0,1,-100.00,0,3,8,11,-27.27,1,0,13,14,7.14,10,2,13,61.54,0,0,1,1,0.00
11776,USA,11,Christenson Micah ,S,0,0,2,-11.76,2,0,0,1,1,0.00,0,2,1,3,-66.67,2,2,9,13,0.00,0,0,0,0, ,5,1,6,66.67,17,1,51,69,23.19
11776,USA,12,Holt Maxwell ,MB,2,1,1,6.67,4,2,0,3,5,40.00,1,1,4,6,0.00,1,2,1,4,-25.00,0,0,1,1,0.00,2,0,2,100.00,0,0,0,0, 
11776,USA,17,Jaeschke Thomas ,OH,0,0,0, ,0,0,0,0,0, ,0,0,0,0, ,0,0,0,0, ,0,0,0,0, ,0,0,0, ,0,0,0,0, 
11776,USA,18,Muagututia Garrett ,OH,0,0,0,-100.00,0,0,0,0,0, ,0,0,0,0, ,0,1,0,1,-100.00,0,0,0,0, ,0,0,0, ,0,0,0,0, 
11776,USA,20,Smith David ,MB,3,2,1,15.38,6,3,0,2,5,60.00,2,1,3,6,16.67,1,1,13,15,0.00,1,0,0,1,100.00,5,2,7,42.86,0,0,0,0, 
11776,USA,21,Watten Dustin ,L,0,0,0, ,0,0,0,0,0, ,0,0,0,0, ,0,0,0,0, ,0,0,0,0, ,0,0,0, ,0,0,0,0, 
11776,USA,22,Shoji Erik ,L,0,0,0, ,0,0,0,0,0, ,0,0,0,0, ,0,0,0,0, ,5,2,2,9,33.33,6,5,11,9.09,0,0,3,3,0.00
11777,CAN,1,Sanders Tyler ,S,0,0,0,-35.29,0,0,0,0,0, ,0,4,2,6,-66.67,0,2,9,11,-18.18,0,0,0,0, ,6,0,6,100.00,15,1,47,63,22.22
11777,CAN,2,Perrin John Gordon ,OH,7,1,1,16.67,9,7,1,7,15,40.00,1,1,1,3,0.00,1,2,9,12,-8.33,3,2,12,17,5.88,3,4,9,-11.11,0,0,2,2,0.00
11777,CAN,3,Marshall Steven ,OH,0,0,0, ,0,0,0,0,0, ,0,0,0,0, ,0,0,0,0, ,2,2,18,22,0.00,5,1,7,57.14,0,0,4,4,0.00
11777,CAN,4,Hoag Nicholas ,OH,9,1,1,2.56,11,9,3,10,22,27.27,1,3,4,8,-25.00,1,4,4,9,-33.33,1,0,16,17,5.88,1,2,5,-20.00,0,0,3,3,0.00
11777,CAN,6,Pereira Jordan ,OH,0,0,0, ,0,0,0,0,0, ,0,0,0,0, ,0,0,0,0, ,0,0,0,0, ,0,0,0, ,0,0,0,0, 
11777,CAN,7,Maar Stephen Timothy ,OH,1,0,0,-25.00,1,1,2,1,4,-25.00,0,0,0,0, ,0,0,0,0, ,0,0,0,0, ,1,0,1,100.00,0,0,0,0, 
11777,CAN,8,Blankenau Jay ,S,0,0,0, ,0,0,0,0,0, ,0,0,0,0, ,0,0,0,0, ,0,0,0,0, ,1,0,1,100.00,2,0,4,6,33.33
11777,CAN,10,Sclater Ryan Joseph ,O,0,0,0,0.00,0,0,0,0,0, ,0,0,0,0, ,0,0,3,3,0.00,0,0,0,0, ,1,0,1,100.00,0,0,0,0, 
11777,CAN,11,Jansen Vandoorn Daniel ,MB,0,0,0, ,0,0,0,0,0, ,0,0,0,0, ,0,0,0,0, ,0,0,0,0, ,0,0,0, ,0,0,0,0, 
11777,CAN,12,Van Berkel Lucas ,MB,5,1,0,-3.33,6,5,0,4,9,55.56,1,7,4,12,-50.00,0,0,9,9,0.00,0,0,2,2,0.00,3,0,3,100.00,0,0,0,0, 
11777,CAN,13,Vernon-Evans Sharone ,O,13,1,2,6.98,16,13,3,4,20,50.00,1,7,3,11,-54.55,2,3,7,12,-8.33,1,0,2,3,33.33,5,0,5,100.00,0,0,1,1,0.00
11777,CAN,14,Loeppky Eric ,OH,0,0,0, ,0,0,0,0,0, ,0,0,0,0, ,0,0,0,0, ,0,0,0,0, ,0,0,0, ,0,0,0,0, 
11777,CAN,17,Vigrass Graham ,MB,0,0,0, ,0,0,0,0,0, ,0,0,0,0, ,0,0,0,0, ,0,0,0,0, ,0,0,0, ,0,0,0,0, 
11777,CAN,20,Szwarc Arthur ,O,4,0,1,4.76,5,4,0,3,7,57.14,0,1,4,5,-20.00,1,3,5,9,-22.22,0,0,0,0, ,2,0,4,50.00,0,1,1,2,-50.00
11777,POL,1,Nowakowski Piotr ,MB,7,1,0,13.79,8,7,0,1,8,87.50,1,3,7,11,-18.18,0,1,9,10,-10.00,0,0,0,0, ,1,0,2,50.00,0,0,0,0, 
11777,POL,2,Muzaj Maciej ,O,0,0,0, ,0,0,0,0,0, ,0,0,0,0, ,0,0,0,0, ,0,0,0,0, ,0,0,0, ,0,0,0,0, 
11777,POL,4,Komenda Marcin ,S,0,0,0, ,0,0,0,0,0, ,0,0,0,0, ,0,0,0,0, ,0,0,0,0, ,0,0,0, ,0,0,0,0, 
11777,POL,6,Kurek Bartosz ,O,13,2,0,19.51,15,13,2,9,24,45.83,2,1,5,8,12.50,0,4,5,9,-44.44,1,0,0,1,100.00,3,1,5,40.00,0,0,1,1,0.00
11777,POL,9,Leon Venero Wilfredo ,OH,11,1,3,22.50,15,11,1,10,22,45.45,1,3,0,4,-50.00,3,2,9,14,7.14,2,2,10,14,0.00,5,4,11,9.09,0,0,1,1,0.00
11777,POL,11,Drzyzga Fabian ,S,0,0,1,-16.67,1,0,0,0,0, ,0,2,2,4,-50.00,1,2,11,14,-7.14,0,0,0,0, ,7,1,10,60.00,18,0,50,68,26.47
11777,POL,12,Lomacz Grzegorz ,S,0,0,0, ,0,0,0,0,0, ,0,0,0,0, ,0,0,0,0, ,0,0,0,0, ,0,0,0, ,0,0,0,0, 
11777,POL,13,Kubiak Michal ,OH,8,0,0,5.26,8,8,4,9,21,19.05,0,1,2,3,-33.33,0,1,13,14,-7.14,3,2,16,21,4.76,10,1,11,81.82,0,0,6,6,0.00
11777,POL,14,Sliwka Aleksander ,OH,0,0,0, ,0,0,0,0,0, ,0,0,0,0, ,0,0,0,0, ,0,0,0,0, ,0,0,0, ,0,0,0,0, 
11777,POL,15,Kochanowski Jakub ,MB,5,0,0,-12.90,5,5,0,3,8,62.50,0,6,4,10,-60.00,0,3,10,13,-23.08,0,0,0,0, ,1,0,1,100.00,0,0,0,0, 
11777,POL,17,Zatorski Pawel ,L,0,0,0, ,0,0,0,0,0, ,0,0,0,0, ,0,0,0,0, ,3,1,11,15,13.33,4,3,8,12.50,0,0,1,1,0.00
11777,POL,21,Fornal Tomasz ,OH,0,0,0, ,0,0,0,0,0, ,0,0,0,0, ,0,0,0,0, ,0,0,0,0, ,0,0,0, ,0,0,0,0, 
11777,POL,77,Klos Karol ,MB,0,0,0, ,0,0,0,0,0, ,0,0,0,0, ,0,0,0,0, ,0,0,0,0, ,0,0,0, ,0,0,0,0, 
11777,POL,99,Huber Norbert ,MB,0,0,0, ,0,0,0,0,0, ,0,0,0,0, ,0,0,0,0, ,0,0,0,0, ,0,0,0, ,0,0,0,0, 
11778,BRA,1,Rezende Bruno Mossa ,S,0,1,0,-6.25,1,0,0,0,0, ,1,2,4,7,-14.29,0,0,9,9,0.00,0,0,0,0, ,9,2,13,53.85,31,0,59,90,34.44
11778,BRA,5,Borges Almeida Silva Mauricio ,OH,0,0,0, ,0,0,0,0,0, ,0,0,0,0, ,0,0,0,0, ,0,0,1,1,0.00,1,1,2,0.00,0,0,0,0, 
11778,BRA,6,Gil Kreling Fernando ,S,0,0,0,-100.00,0,0,0,0,0, ,0,1,0,1,-100.00,0,0,0,0, ,0,0,0,0, ,0,0,0, ,1,0,6,7,14.29
11778,BRA,8,De Souza Wallace ,O,17,0,1,15.09,18,17,2,7,26,57.69,0,4,3,7,-57.14,1,4,15,20,-15.00,0,0,0,0, ,5,3,10,20.00,0,0,3,3,0.00
11778,BRA,9,Leal Hidalgo Yoandy ,OH,16,1,0,15.69,17,16,5,10,31,35.48,1,2,1,4,-25.00,0,2,14,16,-12.50,6,1,27,34,14.71,3,1,4,50.00,0,0,2,2,0.00
11778,BRA,11,Kavalkievicz Gabriel ,OH,0,0,0,-100.00,0,0,0,0,0, ,0,0,0,0, ,0,1,0,1,-100.00,0,0,0,0, ,0,0,0, ,0,0,0,0, 
11778,BRA,12,Santos Isac ,MB,4,3,1,31.25,8,4,0,0,4,100.00,3,1,0,4,50.00,1,2,5,8,-12.50,0,0,1,1,0.00,1,0,1,100.00,0,0,0,0, 
11778,BRA,13,De Souza Mauricio Luiz ,MB,3,0,0,-19.05,3,3,1,2,6,33.33,0,5,0,5,-100.00,0,1,9,10,-10.00,0,0,0,0, ,1,1,2,0.00,0,0,0,0, 
11778,BRA,14,Correia De Souza Douglas ,OH,8,0,3,5.13,11,8,4,11,23,17.39,0,2,1,3,-66.67,3,3,7,13,0.00,5,2,6,13,23.08,4,2,7,28.57,0,0,4,4,0.00
11778,BRA,15,Nascimento Maique Reis ,L,0,0,0, ,0,0,0,0,0, ,0,0,0,0, ,0,0,0,0, ,0,0,0,0, ,0,0,0, ,0,0,0,0, 
11778,BRA,17,Hoss Thales ,L,0,0,0, ,0,0,0,0,0, ,0,0,0,0, ,0,0,0,0, ,8,0,12,20,40.00,8,3,12,41.67,0,0,3,3,0.00
11778,BRA,18,Souza Ricardo Lucarelli ,OH,1,0,1,-14.29,2,1,3,4,8,-25.00,0,0,0,0, ,1,1,4,6,0.00,1,1,7,9,0.00,1,0,1,100.00,0,0,1,1,0.00
11778,BRA,21,Souza Alan ,O,0,0,1,-28.57,1,0,2,1,3,-66.67,0,0,1,1,0.00,1,1,1,3,0.00,0,0,0,0, ,2,0,2,100.00,0,0,0,0, 
11778,BRA,23,Resende Gualberto Flavio ,MB,7,2,0,-2.38,9,7,1,3,11,54.55,2,9,8,19,-36.84,0,0,12,12,0.00,1,1,0,2,0.00,5,1,6,66.67,0,0,1,1,0.00
11778,SLO,1,Å tern TonÄek ,O,15,0,0,11.36,15,15,4,7,26,42.31,0,2,2,4,-50.00,0,4,10,14,-28.57,0,0,0,0, ,2,1,3,33.33,0,0,2,2,0.00
11778,SLO,2,Pajenk Alen ,MB,8,4,1,6.67,13,8,1,4,13,53.85,4,6,4,14,-14.29,1,3,14,18,-11.11,0,0,0,0, ,1,2,3,-33.33,0,0,1,1,0.00
11778,SLO,4,Kozamernik Jan ,MB,7,2,3,4.76,12,7,3,2,12,33.33,2,6,2,10,-40.00,3,1,16,20,10.00,1,0,0,1,100.00,5,3,8,25.00,0,0,0,0, 
11778,SLO,5,Å ket Alen ,O,0,0,0,-20.00,0,0,0,3,3,0.00,0,0,0,0, ,0,1,1,2,-50.00,0,0,0,0, ,1,0,1,100.00,0,0,2,2,0.00
11778,SLO,6,Gasparini Mitja ,O,0,0,0, ,0,0,0,0,0, ,0,0,0,0, ,0,0,0,0, ,0,0,0,0, ,0,0,0, ,0,0,0,0, 
11778,SLO,9,Vincic Dejan ,S,0,0,0, ,0,0,0,0,0, ,0,0,0,0, ,0,0,0,0, ,0,1,0,1,-100.00,0,1,1,-100.00,3,0,1,4,75.00
11778,SLO,10,Å talekar SaÅ¡o ,MB,0,0,0, ,0,0,0,0,0, ,0,0,0,0, ,0,0,0,0, ,0,0,0,0, ,0,0,0, ,0,0,0,0, 
11778,SLO,11,Å tern Å½iga ,OH,0,0,0, ,0,0,0,0,0, ,0,0,0,0, ,0,0,0,0, ,0,0,0,0, ,0,0,0, ,0,0,0,0, 
11778,SLO,13,KovaÄiÄ Jani ,L,0,0,0, ,0,0,0,0,0, ,0,0,0,0, ,0,0,0,0, ,6,1,11,18,27.78,8,5,14,21.43,0,0,4,4,0.00
11778,SLO,15,VideÄnik Matic ,MB,0,0,0, ,0,0,0,0,0, ,0,0,0,0, ,0,0,0,0, ,0,0,0,0, ,0,0,0, ,0,0,0,0, 
11778,SLO,16,Ropret Gregor ,S,3,0,0,-8.33,3,3,0,0,3,100.00,0,4,1,5,-80.00,0,1,15,16,-6.25,0,0,0,0, ,4,4,13,0.00,33,1,58,92,34.78
11778,SLO,17,Urnaut Tine ,OH,9,0,0,2.44,9,9,2,12,23,30.43,0,3,2,5,-60.00,0,3,10,13,-23.08,4,2,12,18,11.11,7,2,9,55.56,0,0,1,1,0.00
11778,SLO,18,Äebulj Klemen ,OH,14,1,1,10.00,16,14,4,11,29,34.48,1,3,3,7,-28.57,1,4,9,14,-21.43,12,2,28,42,23.81,12,1,13,84.62,0,0,3,3,0.00
11778,SLO,19,MoÅ¾iÄ Rok ,OH,2,0,0,25.00,2,2,0,1,3,66.67,0,0,0,0, ,0,1,0,1,-100.00,0,1,2,3,-33.33,0,0,0, ,0,0,1,1,0.00
11779,NED,4,Ter Horst Thijs ,OH,0,0,0,-50.00,0,0,1,1,2,-50.00,0,0,0,0, ,0,0,0,0, ,0,0,3,3,0.00,0,0,0, ,0,0,0,0, 
11779,NED,6,Dronkers Just ,L,0,0,0, ,0,0,0,0,0, ,0,0,0,0, ,0,0,0,0, ,0,0,0,0, ,0,0,0, ,0,0,0,0, 
11779,NED,8,Plak Fabian ,MB,0,0,0,-100.00,0,0,0,0,0, ,0,1,0,1,-100.00,0,0,0,0, ,0,0,0,0, ,0,0,0, ,0,0,0,0, 
11779,NED,10,van Zeist Maikel ,MB,3,0,0,-5.88,3,3,1,3,7,28.57,0,2,6,8,-25.00,0,2,17,19,-10.53,0,0,3,3,0.00,0,1,3,-33.33,0,0,0,0, 
11779,NED,12,Tuinstra Bennie Junior ,OH,13,1,0,9.84,14,13,5,17,35,22.86,1,2,6,9,-11.11,0,1,16,17,-5.88,3,3,30,36,0.00,7,0,9,77.78,0,1,5,6,-16.67
11779,NED,13,Ottevanger Steven ,L,0,0,0, ,0,0,0,0,0, ,0,0,0,0, ,0,0,0,0, ,3,1,14,18,11.11,11,2,15,60.00,0,0,4,4,0.00
11779,NED,14,Abdel-Aziz Nimir ,O,37,2,4,20.00,43,37,8,12,57,50.88,2,10,4,16,-50.00,4,6,12,22,-9.09,0,0,0,0, ,8,5,14,21.43,0,0,1,1,0.00
11779,NED,15,van Solkema Gijs ,S,0,0,0, ,0,0,0,0,0, ,0,0,0,0, ,0,0,0,0, ,0,0,0,0, ,0,0,0, ,2,0,4,6,33.33
11779,NED,17,Parkinson Michael ,MB,5,0,0,-3.57,5,5,0,4,9,55.56,0,6,4,10,-60.00,0,0,9,9,0.00,0,0,0,0, ,1,2,5,-20.00,0,0,1,1,0.00
11779,NED,18,Andringa Robbert ,L,6,2,1,-5.00,9,6,3,7,16,18.75,2,3,3,8,-12.50,1,5,10,16,-25.00,13,1,16,30,40.00,13,4,18,50.00,0,0,4,4,0.00
11779,NED,19,de Weijer Freek ,S,0,1,0,-10.00,1,0,0,1,1,0.00,1,2,3,6,-16.67,0,1,12,13,-7.69,0,1,2,3,-33.33,4,1,6,50.00,39,1,70,110,34.55
11779,NED,21,van Schie Stijn ,OH,0,0,0, ,0,0,0,0,0, ,0,0,0,0, ,0,0,0,0, ,0,0,0,0, ,0,0,0, ,0,0,0,0, 
11779,NED,22,Wiltenburg Twan ,MB,0,0,2,15.38,2,0,0,0,0, ,0,0,1,1,0.00,2,0,10,12,16.67,0,0,0,0, ,0,0,0, ,0,0,0,0, 
11779,NED,25,van Tilburg Stijn ,OH,0,0,0,-100.00,0,0,2,0,2,-100.00,0,1,0,1,-100.00,0,0,0,0, ,0,0,0,0, ,0,0,0, ,0,0,0,0, 
11779,FRA,1,Chinenyeze BarthÃ©lÃ©my ,MB,11,2,0,6.67,13,11,1,3,15,66.67,2,7,4,13,-38.46,0,2,15,17,-11.76,0,0,0,0, ,1,0,1,100.00,0,0,1,1,0.00
11779,FRA,2,Grebennikov Jenia ,L,0,0,0, ,0,0,0,0,0, ,0,0,0,0, ,0,0,0,0, ,8,0,12,20,40.00,17,2,20,75.00,0,0,7,7,0.00
11779,FRA,6,Toniutti Benjamin ,S,0,0,0, ,0,0,0,0,0, ,0,0,0,0, ,0,0,0,0, ,0,0,0,0, ,0,0,0, ,0,0,0,0, 
11779,FRA,7,Tillie Kevin ,OH,2,0,0,16.67,2,2,0,1,3,66.67,0,0,1,1,0.00,0,1,1,2,-50.00,1,1,2,4,0.00,1,3,5,-40.00,0,0,0,0, 
11779,FRA,9,Ngapeth Earvin ,OH,7,0,0,0.00,7,7,2,5,14,35.71,0,1,0,1,-100.00,0,4,7,11,-36.36,4,0,14,18,22.22,3,2,6,16.67,0,0,4,4,0.00
11779,FRA,11,Brizard Antoine ,S,1,2,0,-7.14,3,1,0,2,3,33.33,2,2,4,8,0.00,0,3,14,17,-17.65,0,0,0,0, ,5,2,8,37.50,38,0,69,107,35.51
11779,FRA,12,Boyer Stephen ,O,0,0,0, ,0,0,0,0,0, ,0,0,0,0, ,0,0,0,0, ,0,0,0,0, ,0,0,0, ,0,0,0,0, 
11779,FRA,14,Le Goff Nicolas ,MB,11,4,0,16.28,15,11,2,4,17,52.94,4,3,5,12,8.33,0,3,11,14,-21.43,0,0,0,0, ,3,0,4,75.00,0,0,2,2,0.00
11779,FRA,16,Bultor Daryl ,MB,0,0,0, ,0,0,0,0,0, ,0,0,0,0, ,0,0,0,0, ,0,0,0,0, ,0,0,0, ,0,0,0,0, 
11779,FRA,18,Rossard Thibault ,OH,8,0,2,16.67,10,8,2,2,12,50.00,0,1,0,1,-100.00,2,3,6,11,-9.09,6,1,7,14,35.71,3,2,6,16.67,0,0,3,3,0.00
11779,FRA,19,Louati Yacine ,OH,10,1,0,-2.08,11,10,4,11,25,24.00,1,6,3,10,-50.00,0,2,11,13,-15.38,7,5,25,37,5.41,6,2,8,50.00,0,0,2,2,0.00
11779,FRA,20,Diez Benjamin ,L,0,0,0, ,0,0,0,0,0, ,0,0,0,0, ,0,0,0,0, ,0,0,0,0, ,0,0,0, ,0,0,0,0, 
11779,FRA,21,Faure ThÃ©o ,O,23,3,4,15.73,30,23,3,14,40,50.00,3,7,7,17,-23.53,4,6,22,32,-6.25,0,0,0,0, ,8,5,15,20.00,0,0,2,2,0.00
11779,FRA,24,Gueye Mousse ,MB,0,0,0, ,0,0,0,0,0, ,0,0,0,0, ,0,0,0,0, ,0,0,0,0, ,0,0,0, ,0,0,0,0, 
11780,ARG,2,Pereyra Federico ,O,15,0,1,13.89,16,15,6,5,26,34.62,0,3,1,4,-75.00,1,2,3,6,-16.67,0,0,1,1,0.00,0,2,2,-100.00,0,0,1,1,0.00
11780,ARG,5,Uriarte Nicolas ,S,2,0,0,18.18,2,2,0,1,3,66.67,0,0,1,1,0.00,0,0,7,7,0.00,0,0,0,0, ,6,1,8,62.50,14,0,35,49,28.57
11780,ARG,6,Poglajen Cristian ,OH,5,0,0,-16.13,5,5,4,6,15,6.67,0,3,2,5,-60.00,0,3,8,11,-27.27,3,3,16,22,0.00,6,0,6,100.00,0,0,3,3,0.00
11780,ARG,7,Conte Facundo ,OH,7,0,0,-12.50,7,7,6,10,23,4.35,0,2,1,3,-66.67,0,4,10,14,-28.57,4,0,22,26,15.38,7,1,10,60.00,0,0,10,10,0.00
11780,ARG,8,Loser Agustin ,MB,7,2,1,11.11,10,7,1,5,13,46.15,2,3,3,8,-12.50,1,2,12,15,-6.67,0,0,0,0, ,4,1,6,50.00,0,0,0,0, 
11780,ARG,9,Danani Santiago ,L,0,0,0, ,0,0,0,0,0, ,0,0,0,0, ,0,0,0,0, ,5,0,12,17,29.41,13,2,16,68.75,0,0,3,3,0.00
11780,ARG,10,Lazo NicolÃ¡s ,OH,0,0,0, ,0,0,0,0,0, ,0,0,0,0, ,0,0,0,0, ,0,0,0,0, ,0,0,0, ,0,0,0,0, 
11780,ARG,11,SolÃ© Sebastian ,MB,5,3,1,13.64,9,5,0,7,12,41.67,3,2,8,13,7.69,1,1,17,19,0.00,0,0,0,0, ,5,0,5,100.00,0,0,2,2,0.00
11780,ARG,12,Lima Bruno ,O,6,0,0,-9.09,6,6,5,4,15,6.67,0,0,1,1,0.00,0,3,3,6,-50.00,0,0,0,0, ,2,1,4,25.00,0,0,1,1,0.00
11780,ARG,13,Palacios Ezequiel ,OH,1,0,0,-25.00,1,1,2,3,6,-16.67,0,0,0,0, ,0,1,1,2,-50.00,2,0,5,7,28.57,2,0,2,100.00,0,0,0,0, 
11780,ARG,15,De Cecco Luciano ,S,0,0,1,-9.09,1,0,0,1,1,0.00,0,2,1,3,-66.67,1,0,6,7,14.29,0,1,0,1,-100.00,5,0,5,100.00,11,1,30,42,23.81
11780,ARG,17,Mendez Nicolas ,OH,0,0,0,-33.33,0,0,1,2,3,-33.33,0,0,0,0, ,0,0,0,0, ,0,1,0,1,-100.00,0,0,0, ,0,0,0,0, 
11780,ARG,18,Ramos Martin ,MB,0,0,0, ,0,0,0,0,0, ,0,0,0,0, ,0,0,0,0, ,0,0,0,0, ,0,0,0, ,0,0,0,0, 
11780,ARG,19,Massimino Franco ,L,0,0,0, ,0,0,0,0,0, ,0,0,0,0, ,0,0,0,0, ,0,0,0,0, ,0,0,0, ,0,0,0,0, 
11780,RUS,1,Podlesnykh Yaroslav ,OH,7,2,3,11.90,12,7,3,8,18,22.22,2,4,2,8,-25.00,3,0,13,16,18.75,6,3,13,22,13.64,8,1,10,70.00,0,0,6,6,0.00
11780,RUS,2,Vlasov Ilia ,MB,0,0,0, ,0,0,0,0,0, ,0,0,0,0, ,0,0,0,0, ,0,0,0,0, ,0,0,0, ,0,0,0,0, 
11780,RUS,4,Volvich Artem ,MB,7,2,0,-5.00,9,7,2,1,10,50.00,2,7,6,15,-33.33,0,2,13,15,-13.33,0,0,1,1,0.00,0,0,1,0.00,0,0,1,1,0.00
11780,RUS,6,Baranov Evgeny ,L,0,0,0, ,0,0,0,0,0, ,0,0,0,0, ,0,0,0,0, ,0,0,0,0, ,0,0,0, ,0,0,0,0, 
11780,RUS,7,Volkov Dmitry ,OH,0,0,0,0.00,0,0,0,0,0, ,0,0,0,0, ,0,0,2,2,0.00,0,0,0,0, ,0,0,1,0.00,0,0,0,0, 
11780,RUS,10,Bogdan Denis ,OH,0,0,0,0.00,0,0,0,0,0, ,0,0,0,0, ,0,0,5,5,0.00,0,0,0,0, ,0,0,0, ,0,0,1,1,0.00
11780,RUS,11,Pankov Pavel ,S,1,1,0,-11.11,2,1,0,0,1,100.00,1,1,1,3,0.00,0,2,3,5,-40.00,0,0,0,0, ,4,1,5,60.00,7,1,20,28,21.43
11780,RUS,13,Muserskiy Dmitriy ,MB,8,2,0,23.81,10,8,2,3,13,46.15,2,1,2,5,20.00,0,2,1,3,-66.67,0,0,0,0, ,4,2,7,28.57,0,0,3,3,0.00
11780,RUS,15,Poletaev Victor ,O,3,1,1,13.64,5,3,1,8,12,16.67,1,0,0,1,100.00,1,1,7,9,0.00,0,0,0,0, ,1,0,2,50.00,0,0,0,0, 
11780,RUS,17,Mikhaylov Maxim ,O,1,2,0,-7.69,3,1,0,4,5,20.00,2,2,1,5,0.00,0,2,1,3,-66.67,0,0,0,0, ,0,0,0, ,0,0,0,0, 
11780,RUS,18,Kliuka Egor ,OH,14,1,0,3.77,15,14,3,14,31,35.48,1,4,1,6,-50.00,0,6,10,16,-37.50,10,0,16,26,38.46,4,1,5,60.00,0,0,6,6,0.00
11780,RUS,20,Kurkaev Ilyas ,MB,7,1,0,6.67,8,7,0,4,11,63.64,1,4,6,11,-27.27,0,2,6,8,-25.00,0,0,1,1,0.00,2,0,2,100.00,0,0,0,0, 
11780,RUS,24,Kobzar Igor ,S,1,2,1,0.00,4,1,0,2,3,33.33,2,1,0,3,33.33,1,3,9,13,-15.38,0,0,0,0, ,7,0,7,100.00,21,0,32,53,39.62
11780,RUS,27,Golubev Valentin ,L,0,0,0, ,0,0,0,0,0, ,0,0,0,0, ,0,0,0,0, ,7,1,13,21,28.57,6,3,10,30.00,0,0,3,3,0.00
11781,SRB,2,Kovacevic Uros ,OH,6,1,2,6.90,9,6,3,2,11,27.27,1,2,3,6,-16.67,2,2,8,12,0.00,2,1,10,13,7.69,0,0,0, ,0,0,2,2,0.00
11781,SRB,3,Kapur Milorad ,L,0,0,0, ,0,0,0,0,0, ,0,0,0,0, ,0,0,0,0, ,0,0,0,0, ,0,0,0, ,0,0,0,0, 
11781,SRB,6,Pekovic Nikola ,L,0,0,0, ,0,0,0,0,0, ,0,0,0,0, ,0,0,0,0, ,4,1,12,17,17.65,5,0,5,100.00,0,0,1,1,0.00
11781,SRB,7,Krsmanovic Petar ,MB,7,0,2,17.86,9,7,0,0,7,100.00,0,3,2,5,-60.00,2,1,13,16,6.25,1,0,0,1,100.00,2,0,2,100.00,0,0,3,3,0.00
11781,SRB,8,Ivovic Marko ,OH,9,1,3,24.32,13,9,2,3,14,50.00,1,1,2,4,0.00,3,1,15,19,10.53,2,1,8,11,9.09,6,0,6,100.00,0,0,2,2,0.00
11781,SRB,9,Jovovic Nikola ,S,0,0,0,0.00,0,0,0,1,1,0.00,0,0,1,1,0.00,0,0,7,7,0.00,0,0,0,0, ,4,3,8,12.50,21,1,29,51,39.22
11781,SRB,10,KujundÅ¾iÄ Miran ,OH,0,0,0, ,0,0,0,0,0, ,0,0,0,0, ,0,0,0,0, ,0,0,0,0, ,0,0,0, ,0,0,0,0, 
11781,SRB,12,Peric Pavle ,OH,0,0,0, ,0,0,0,0,0, ,0,0,0,0, ,0,0,0,0, ,0,0,0,0, ,0,0,0, ,0,0,0,0, 
11781,SRB,13,Simic Stevan ,MB,1,0,0,50.00,1,1,0,0,1,100.00,0,0,1,1,0.00,0,0,0,0, ,0,0,0,0, ,0,0,0, ,0,0,0,0, 
11781,SRB,14,Atanasijevic Aleksandar ,O,11,0,1,8.82,12,11,5,3,19,31.58,0,1,5,6,-16.67,1,3,5,9,-22.22,0,0,0,0, ,4,2,8,25.00,0,0,1,1,0.00
11781,SRB,16,Luburic Drazen ,O,0,0,0, ,0,0,0,0,0, ,0,0,0,0, ,0,0,0,0, ,0,0,0,0, ,0,0,0, ,0,0,0,0, 
11781,SRB,18,Podrascanin Marko ,MB,7,5,1,25.81,13,7,0,1,8,87.50,5,4,3,12,8.33,1,1,9,11,0.00,0,0,0,0, ,1,1,2,0.00,0,0,4,4,0.00
11781,SRB,21,Todorovic Vuk ,S,0,0,0, ,0,0,0,0,0, ,0,0,0,0, ,0,0,0,0, ,0,0,0,0, ,0,0,0, ,0,0,0,0, 
11781,SRB,26,Kovac Davide ,OH,1,0,0,25.00,1,1,0,3,4,25.00,0,0,0,0, ,0,0,0,0, ,1,0,2,3,33.33,3,0,3,100.00,0,0,1,1,0.00
11781,BUL,1,Karyagin Denis ,O,1,0,0,0.00,1,1,1,2,4,0.00,0,0,1,1,0.00,0,0,1,1,0.00,0,0,0,0, ,0,0,0, ,0,0,0,0, 
11781,BUL,2,Chavdarov Stefan ,MB,5,2,0,8.70,7,5,0,4,9,55.56,2,1,0,3,33.33,0,4,7,11,-36.36,1,0,2,3,33.33,2,1,4,25.00,0,0,0,0, 
11781,BUL,3,Kolev Nikolay ,MB,1,0,0,-37.50,1,1,2,0,3,-33.33,0,5,2,7,-71.43,0,0,6,6,0.00,0,0,1,1,0.00,0,0,1,0.00,0,0,0,0, 
11781,BUL,4,Atanasov Martin ,OH,7,1,2,9.38,10,7,2,7,16,31.25,1,4,0,5,-60.00,2,1,8,11,9.09,4,0,11,15,26.67,1,1,2,0.00,0,0,2,2,0.00
11781,BUL,6,Stankov Vladimir ,S,0,0,0,0.00,0,0,0,0,0, ,0,0,0,0, ,0,0,1,1,0.00,0,0,0,0, ,0,0,0, ,1,1,6,8,0.00
11781,BUL,9,Seganov Georgi ,S,1,1,0,8.33,2,1,0,2,3,33.33,1,0,1,2,50.00,0,1,6,7,-14.29,0,0,0,0, ,3,2,6,16.67,15,1,39,55,25.45
11781,BUL,10,Stankov Svetoslav ,S,0,0,0,0.00,0,0,0,0,0, ,0,0,0,0, ,0,0,1,1,0.00,0,0,0,0, ,0,1,1,-100.00,0,0,0,0, 
11781,BUL,12,Petrov Georgi ,OH,1,1,0,14.29,2,1,0,2,3,33.33,1,0,0,1,100.00,0,1,2,3,-33.33,0,2,6,8,-25.00,1,0,1,100.00,0,0,0,0, 
11781,BUL,14,Asparuhov Asparuh ,OH,4,0,1,-8.33,5,4,2,6,12,16.67,0,3,1,4,-75.00,1,2,5,8,-12.50,3,5,12,20,-10.00,1,1,3,0.00,0,0,3,3,0.00
11781,BUL,15,Lyutskanov Gordan ,OH,1,0,0,0.00,1,1,0,0,1,100.00,0,1,0,1,-100.00,0,0,0,0, ,0,0,1,1,0.00,1,0,1,100.00,0,0,0,0, 
11781,BUL,16,Ivanov Vladislav ,L,0,0,0, ,0,0,0,0,0, ,0,0,0,0, ,0,0,0,0, ,5,2,11,18,16.67,5,4,10,10.00,0,0,4,4,0.00
11781,BUL,24,Ivanov Martin ,L,0,0,0, ,0,0,0,0,0, ,0,0,0,0, ,0,0,0,0, ,0,0,0,0, ,0,0,0, ,0,0,0,0, 
11781,BUL,25,Parapunov Radoslav ,O,11,2,0,23.33,13,11,5,5,21,28.57,2,0,1,3,66.67,0,1,5,6,-16.67,0,0,0,0, ,4,2,7,28.57,0,0,0,0, 
11781,BUL,26,Ivanov Svetoslav ,OH,0,0,0, ,0,0,0,0,0, ,0,0,0,0, ,0,0,0,0, ,0,0,0,0, ,0,0,0, ,0,0,0,0, 
11782,SLO,2,Pajenk Alen ,MB,7,0,3,9.76,10,7,1,0,8,75.00,0,1,4,5,-20.00,3,4,21,28,-3.57,1,0,2,3,33.33,4,1,5,60.00,0,0,1,1,0.00
11782,SLO,4,Kozamernik Jan ,MB,7,1,0,6.67,8,7,1,2,10,60.00,1,3,6,10,-20.00,0,2,8,10,-20.00,0,0,0,0, ,2,2,4,0.00,0,0,0,0, 
11782,SLO,5,Å ket Alen ,O,8,1,0,5.13,9,8,3,12,23,21.74,1,1,4,6,0.00,0,3,7,10,-30.00,0,0,0,0, ,3,3,6,0.00,0,0,3,3,0.00
11782,SLO,6,Gasparini Mitja ,O,2,0,0,0.00,2,2,2,0,4,0.00,0,0,0,0, ,0,0,1,1,0.00,0,0,0,0, ,0,0,0, ,0,0,0,0, 
11782,SLO,9,Vincic Dejan ,S,0,0,0,-100.00,0,0,0,0,0, ,0,1,0,1,-100.00,0,0,0,0, ,0,0,0,0, ,0,0,0, ,3,0,6,9,33.33
11782,SLO,10,Å talekar SaÅ¡o ,MB,0,0,0, ,0,0,0,0,0, ,0,0,0,0, ,0,0,0,0, ,0,0,0,0, ,0,0,0, ,0,0,0,0, 
11782,SLO,11,Å tern Å½iga ,OH,5,0,0,23.08,5,5,1,4,10,40.00,0,1,0,1,-100.00,0,0,2,2,0.00,3,2,5,10,10.00,1,0,1,100.00,0,0,0,0, 
11782,SLO,12,Klobucar Jan ,L,0,0,0, ,0,0,0,0,0, ,0,0,0,0, ,0,0,0,0, ,0,0,0,0, ,0,0,0, ,0,0,0,0, 
11782,SLO,13,KovaÄiÄ Jani ,L,0,0,0, ,0,0,0,0,0, ,0,0,0,0, ,0,0,0,0, ,7,1,7,15,40.00,9,6,15,20.00,0,0,3,3,0.00
11782,SLO,15,VideÄnik Matic ,MB,0,0,0, ,0,0,0,0,0, ,0,0,0,0, ,0,0,0,0, ,0,0,0,0, ,0,0,0, ,0,0,0,0, 
11782,SLO,16,Ropret Gregor ,S,2,0,0,4.76,2,2,0,0,2,100.00,0,0,1,1,0.00,0,1,17,18,-5.56,0,0,0,0, ,6,2,10,40.00,36,0,43,79,45.57
11782,SLO,17,Urnaut Tine ,OH,1,0,0,-30.00,1,1,3,3,7,-28.57,0,0,0,0, ,0,1,2,3,-33.33,2,0,1,3,66.67,5,0,5,100.00,0,0,0,0, 
11782,SLO,18,Äebulj Klemen ,OH,14,1,1,29.41,16,14,2,5,21,57.14,1,1,1,3,0.00,1,3,6,10,-20.00,6,0,4,10,60.00,7,3,10,40.00,0,0,4,4,0.00
11782,SLO,19,MoÅ¾iÄ Rok ,OH,11,3,0,12.82,14,11,4,4,19,36.84,3,3,4,10,0.00,0,2,8,10,-20.00,8,0,17,25,32.00,3,1,4,50.00,0,0,2,2,0.00
11782,AUS,1,Graham Beau ,MB,7,1,0,2.86,8,7,2,10,19,26.32,1,3,1,5,-40.00,0,2,9,11,-18.18,0,0,0,0, ,1,2,3,-33.33,0,0,1,1,0.00
11782,AUS,2,Dosanjh Arshdeep ,S,1,1,3,-7.41,5,1,0,2,3,33.33,1,3,1,5,-40.00,3,4,12,19,-5.26,0,0,0,0, ,6,3,10,30.00,23,0,48,71,32.39
11782,AUS,7,Weir James ,MB,0,0,0,0.00,0,0,0,0,0, ,0,0,0,0, ,0,0,1,1,0.00,0,0,0,0, ,0,0,0, ,0,0,0,0, 
11782,AUS,8,O'Dea Trent ,MB,2,3,0,-20.00,5,2,4,1,7,-28.57,3,4,3,10,-10.00,0,3,10,13,-23.08,1,0,2,3,33.33,2,0,2,100.00,0,0,2,2,0.00
11782,AUS,11,Perry Luke ,L,0,0,0, ,0,0,0,0,0, ,0,0,0,0, ,0,0,0,0, ,9,2,6,17,41.18,11,4,18,38.89,0,0,13,13,0.00
11782,AUS,12,Mote Nehemiah ,MB,9,2,0,12.82,11,9,3,7,19,31.58,2,3,4,9,-11.11,0,0,11,11,0.00,1,0,0,1,100.00,4,0,4,100.00,0,0,1,1,0.00
11782,AUS,15,Smith Luke ,OH,12,2,0,27.03,14,12,2,8,22,45.45,2,1,0,3,33.33,0,1,11,12,-8.33,10,1,25,36,25.00,4,4,8,0.00,0,0,1,1,0.00
11782,AUS,21,Butler Nicholas ,S,0,0,0, ,0,0,0,0,0, ,0,0,0,0, ,0,0,0,0, ,0,0,0,0, ,1,0,1,100.00,2,0,2,4,50.00
11782,AUS,27,Senica Max ,OH,3,1,0,6.67,4,3,0,2,5,60.00,1,1,2,4,0.00,0,2,4,6,-33.33,6,0,4,10,60.00,0,0,1,0.00,0,0,0,0, 
11782,AUS,28,Taylor Tim ,OH,3,0,0,50.00,3,3,0,0,3,100.00,0,0,0,0, ,0,1,0,1,-100.00,0,0,0,0, ,0,0,0, ,0,0,0,0, 
11782,AUS,29,Garrett Ethan ,OH,2,0,0,-30.00,2,2,4,5,11,-18.18,0,4,1,5,-80.00,0,0,4,4,0.00,3,1,5,9,22.22,0,1,1,-100.00,0,1,2,3,-33.33
11782,AUS,31,Aubrey Matthew ,O,0,0,0, ,0,0,0,0,0, ,0,0,0,0, ,0,0,0,0, ,0,0,0,0, ,0,0,0, ,0,0,0,0, 
11782,AUS,32,Azeez Oluwatobi Elliot ,OH,3,0,0,33.33,3,3,1,1,5,40.00,0,0,0,0, ,0,0,1,1,0.00,0,0,0,0, ,1,1,2,0.00,0,0,0,0, 
11782,AUS,34,Greber Billy ,L,0,0,0, ,0,0,0,0,0, ,0,0,0,0, ,0,0,0,0, ,0,0,0,0, ,0,0,0, ,0,0,0,0, 
11783,JPN,4,Otake Issei ,O,3,0,0,-7.69,3,3,2,4,9,11.11,0,0,1,1,0.00,0,2,1,3,-66.67,0,0,0,0, ,2,0,3,66.67,0,0,0,0, 
11783,JPN,5,Fukuzawa Tatsuya ,OH,3,0,0,-14.29,3,3,2,6,11,9.09,0,1,0,1,-100.00,0,2,0,2,-100.00,1,1,5,7,0.00,3,0,3,100.00,0,0,1,1,0.00
11783,JPN,6,Yamauchi Akihiro ,MB,2,0,0,10.00,2,2,0,2,4,50.00,0,1,3,4,-25.00,0,0,2,2,0.00,0,0,1,1,0.00,2,1,3,33.33,0,0,1,1,0.00
11783,JPN,11,Nishida Yuji ,O,2,0,0,-33.33,2,2,3,1,6,-16.67,0,0,0,0, ,0,2,1,3,-66.67,0,0,0,0, ,2,0,2,100.00,0,0,0,0, 
11783,JPN,12,Sekita Masahiro ,S,0,0,0,0.00,0,0,0,0,0, ,0,0,0,0, ,0,0,2,2,0.00,0,0,1,1,0.00,1,0,1,100.00,8,0,11,19,42.11
11783,JPN,13,Oya Masaki ,S,0,0,0,-25.00,0,0,0,0,0, ,0,1,4,5,-20.00,0,2,5,7,-28.57,0,0,0,0, ,3,2,6,16.67,20,1,29,50,38.00
11783,JPN,14,Ishikawa Yuki ,OH,0,0,0, ,0,0,0,0,0, ,0,0,0,0, ,0,0,0,0, ,0,0,0,0, ,0,0,0, ,0,0,0,0, 
11783,JPN,15,Ri Haku ,MB,3,0,0,5.88,3,3,0,2,5,60.00,0,1,3,4,-25.00,0,1,7,8,-12.50,0,1,0,1,-100.00,1,2,3,-33.33,0,0,1,1,0.00
11783,JPN,16,Takahashi Kentaro ,MB,4,0,0,-28.57,4,4,0,1,5,80.00,0,4,1,5,-80.00,0,4,0,4,-100.00,0,0,0,0, ,0,0,0, ,0,0,0,0, 
11783,JPN,17,Takanashi Kenta ,OH,10,0,0,10.34,10,10,3,3,16,43.75,0,0,0,0, ,0,4,9,13,-30.77,3,2,16,21,4.76,4,2,7,28.57,0,0,4,4,0.00
11783,JPN,19,Otsuka Tatsunori ,OH,7,0,0,-2.94,7,7,4,12,23,13.04,0,2,1,3,-66.67,0,2,6,8,-25.00,1,0,7,8,12.50,1,1,2,0.00,0,0,0,0, 
11783,JPN,20,Yamamoto Tomohiro ,L,0,0,0, ,0,0,0,0,0, ,0,0,0,0, ,0,0,0,0, ,0,0,0,0, ,0,0,0, ,0,0,0,0, 
11783,JPN,21,Takahashi Ran ,OH,0,0,0, ,0,0,0,0,0, ,0,0,0,0, ,0,0,0,0, ,0,0,0,0, ,0,0,0, ,0,0,0,0, 
11783,JPN,24,Ogawa Tomohiro ,L,0,0,0, ,0,0,0,0,0, ,0,0,0,0, ,0,0,0,0, ,9,2,10,21,33.33,11,3,17,47.06,0,0,5,5,0.00
11783,POL,2,Muzaj Maciej ,O,10,2,2,19.44,14,10,0,6,16,62.50,2,3,3,8,-12.50,2,4,6,12,-16.67,0,0,0,0, ,1,0,2,50.00,0,0,0,0, 
11783,POL,4,Komenda Marcin ,S,1,0,0,50.00,1,1,0,0,1,100.00,0,0,0,0, ,0,0,1,1,0.00,0,0,0,0, ,0,0,0, ,4,0,3,7,57.14
11783,POL,5,Kaczmarek Lukasz ,O,0,0,0, ,0,0,0,0,0, ,0,0,0,0, ,0,0,0,0, ,0,0,0,0, ,0,0,0, ,0,0,0,0, 
11783,POL,9,Leon Venero Wilfredo ,OH,0,0,0, ,0,0,0,0,0, ,0,0,0,0, ,0,0,0,0, ,0,0,0,0, ,0,0,0, ,0,0,0,0, 
11783,POL,11,Drzyzga Fabian ,S,0,0,0, ,0,0,0,0,0, ,0,0,0,0, ,0,0,0,0, ,0,0,0,0, ,0,0,0, ,0,0,0,0, 
11783,POL,12,Lomacz Grzegorz ,S,0,0,0,-10.00,0,0,0,0,0, ,0,1,1,2,-50.00,0,0,8,8,0.00,0,0,0,0, ,4,0,7,57.14,13,0,29,42,30.95
11783,POL,14,Sliwka Aleksander ,OH,0,0,0, ,0,0,0,0,0, ,0,0,0,0, ,0,0,0,0, ,0,0,0,0, ,0,0,0, ,0,0,0,0, 
11783,POL,15,Kochanowski Jakub ,MB,0,0,0, ,0,0,0,0,0, ,0,0,0,0, ,0,0,0,0, ,0,0,0,0, ,0,0,0, ,0,0,0,0, 
11783,POL,16,Semeniuk Kamil ,OH,3,2,0,0.00,5,3,0,4,7,42.86,2,2,3,7,0.00,0,3,9,12,-25.00,5,0,13,18,27.78,4,0,4,100.00,0,0,6,6,0.00
11783,POL,17,Zatorski Pawel ,L,0,0,0, ,0,0,0,0,0, ,0,0,0,0, ,0,0,0,0, ,3,0,5,8,37.50,5,2,9,33.33,0,0,4,4,0.00
11783,POL,20,Bieniek Mateusz ,MB,5,1,3,5.88,9,5,0,5,10,50.00,1,3,3,7,-28.57,3,4,10,17,-5.88,0,0,0,0, ,2,3,6,-16.67,0,0,0,0, 
11783,POL,21,Fornal Tomasz ,OH,15,0,1,26.83,16,15,2,8,25,52.00,0,1,3,4,-25.00,1,2,9,12,-8.33,2,0,5,7,28.57,10,1,12,75.00,0,0,1,1,0.00
11783,POL,77,Klos Karol ,MB,1,1,0,-16.00,2,1,1,2,4,0.00,1,4,4,9,-33.33,0,1,11,12,-8.33,0,0,0,0, ,3,1,4,50.00,0,0,0,0, 
11783,POL,99,Huber Norbert ,MB,0,0,0, ,0,0,0,0,0, ,0,0,0,0, ,0,0,0,0, ,0,0,0,0, ,0,0,0, ,0,0,0,0, 
11784,NED,2,Keemink Wessel ,S,0,0,0,-22.22,0,0,0,0,0, ,0,1,1,2,-50.00,0,1,6,7,-14.29,0,0,0,0, ,5,2,9,33.33,14,0,38,52,26.92
11784,NED,4,Ter Horst Thijs ,OH,11,1,0,13.89,12,11,2,11,24,37.50,1,2,3,6,-16.67,0,3,3,6,-50.00,1,2,10,13,-7.69,0,1,1,-100.00,0,0,4,4,0.00
11784,NED,5,van der Ent Luuc ,MB,0,0,0, ,0,0,0,0,0, ,0,0,0,0, ,0,0,0,0, ,0,0,0,0, ,0,0,0, ,0,0,0,0, 
11784,NED,6,Dronkers Just ,L,0,0,0, ,0,0,0,0,0, ,0,0,0,0, ,0,0,0,0, ,9,2,12,23,30.43,13,7,23,26.09,0,0,10,10,0.00
11784,NED,8,Plak Fabian ,MB,11,3,0,15.91,14,11,2,3,16,56.25,3,5,4,12,-16.67,0,0,16,16,0.00,0,0,1,1,0.00,3,2,5,20.00,0,0,2,2,0.00
11784,NED,12,Tuinstra Bennie Junior ,OH,8,1,2,6.67,11,8,4,10,22,18.18,1,1,2,4,0.00,2,3,14,19,-5.26,11,3,18,32,25.00,5,4,10,10.00,0,0,2,2,0.00
11784,NED,13,Ottevanger Steven ,L,0,0,0, ,0,0,0,0,0, ,0,0,0,0, ,0,0,0,0, ,0,0,0,0, ,0,0,0, ,0,0,0,0, 
11784,NED,14,Abdel-Aziz Nimir ,O,20,2,2,7.25,24,20,10,11,41,24.39,2,4,5,11,-18.18,2,5,10,17,-17.65,2,0,0,2,100.00,9,2,11,63.64,0,0,0,0, 
11784,NED,17,Parkinson Michael ,MB,0,0,0, ,0,0,0,0,0, ,0,0,0,0, ,0,0,0,0, ,0,0,0,0, ,0,0,0, ,0,0,0,0, 
11784,NED,18,Andringa Robbert ,L,2,0,0,-11.76,2,2,1,5,8,12.50,0,1,3,4,-25.00,0,2,3,5,-40.00,3,1,8,12,16.67,4,0,4,100.00,0,0,2,2,0.00
11784,NED,19,de Weijer Freek ,S,0,0,0,-60.00,0,0,0,0,0, ,0,1,0,1,-100.00,0,2,2,4,-50.00,0,0,0,0, ,3,2,5,20.00,10,0,38,48,20.83
11784,NED,21,van Schie Stijn ,OH,0,0,0, ,0,0,0,0,0, ,0,0,0,0, ,0,0,0,0, ,0,0,0,0, ,0,0,0, ,0,0,0,0, 
11784,NED,22,Wiltenburg Twan ,MB,3,0,1,-13.79,4,3,1,3,7,28.57,0,7,3,10,-70.00,1,0,11,12,8.33,0,0,0,0, ,1,2,5,-20.00,0,0,0,0, 
11784,NED,25,van Tilburg Stijn ,OH,0,0,0,0.00,0,0,0,1,1,0.00,0,0,0,0, ,0,0,3,3,0.00,0,0,1,1,0.00,0,0,0, ,0,0,0,0, 
11784,ITA,1,Gardini Davide ,OH,0,0,0, ,0,0,0,0,0, ,0,0,0,0, ,0,0,0,0, ,0,0,0,0, ,0,0,0, ,0,0,0,0, 
11784,ITA,7,Balaso Fabio ,L,0,0,0, ,0,0,0,0,0, ,0,0,0,0, ,0,0,0,0, ,6,1,17,24,20.83,7,3,14,28.57,0,0,9,9,0.00
11784,ITA,11,Galassi Gianluca ,MB,1,0,0,0.00,1,1,0,2,3,33.33,0,0,0,0, ,0,1,0,1,-100.00,0,0,0,0, ,0,0,0, ,0,0,0,0, 
11784,ITA,15,Sbertoli Riccardo ,S,1,1,0,-15.00,2,1,0,1,2,50.00,1,3,2,6,-33.33,0,2,10,12,-16.67,0,0,0,0, ,6,1,9,55.56,14,1,60,75,17.33
11784,ITA,18,Michieletto Alessandro ,OH,14,1,5,20.00,20,14,3,11,28,39.29,1,3,3,7,-28.57,5,2,18,25,12.00,8,2,22,32,18.75,9,2,11,63.64,0,0,2,2,0.00
11784,ITA,20,Nelli Gabriele ,O,0,0,0, ,0,0,0,0,0, ,0,0,0,0, ,0,0,0,0, ,0,0,0,0, ,0,0,0, ,0,0,0,0, 
11784,ITA,21,Spirito Luca ,S,1,0,0,25.00,1,1,0,0,1,100.00,0,0,0,0, ,0,0,3,3,0.00,0,0,0,0, ,0,0,0, ,3,0,10,13,23.08
11784,ITA,23,Pinali Giulio ,O,13,3,1,1.85,17,13,4,7,24,37.50,3,9,6,18,-33.33,1,3,8,12,-16.67,0,0,0,0, ,4,0,4,100.00,0,0,0,0, 
11784,ITA,24,Cavuto Oreste ,OH,0,0,0, ,0,0,0,0,0, ,0,0,0,0, ,0,0,0,0, ,0,0,0,0, ,0,0,0, ,0,0,0,0, 
11784,ITA,26,Cortesia Lorenzo ,MB,4,0,2,0.00,6,4,0,3,7,57.14,0,5,3,8,-62.50,2,1,18,21,4.76,1,0,0,1,100.00,4,0,4,100.00,0,0,1,1,0.00
11784,ITA,28,Recine Francesco ,OH,16,4,0,25.00,20,16,4,11,31,38.71,4,1,0,5,60.00,0,3,9,12,-25.00,5,2,9,16,18.75,5,2,7,42.86,0,0,3,3,0.00
11784,ITA,29,Bottolo Mattia ,OH,0,0,0, ,0,0,0,0,0, ,0,0,0,0, ,0,0,0,0, ,0,0,0,0, ,0,0,0, ,0,0,0,0, 
11784,ITA,30,Mosca Leandro Ausibio ,MB,3,3,0,0.00,6,3,2,4,9,11.11,3,3,8,14,0.00,0,1,10,11,-9.09,0,0,0,0, ,1,0,1,100.00,0,0,2,2,0.00
11784,ITA,31,Federici Filippo ,L,0,0,0, ,0,0,0,0,0, ,0,0,0,0, ,0,0,0,0, ,0,0,0,0, ,0,0,0, ,0,0,0,0, 
11785,CAN,3,Marshall Steven ,OH,0,0,0, ,0,0,0,0,0, ,0,0,0,0, ,0,0,0,0, ,1,0,1,2,50.00,0,0,0, ,0,0,0,0, 
11785,CAN,4,Hoag Nicholas ,OH,9,1,0,8.82,10,9,4,6,19,26.32,1,0,0,1,100.00,0,3,11,14,-21.43,5,2,8,15,20.00,2,3,6,-16.67,0,0,4,4,0.00
11785,CAN,6,Pereira Jordan ,OH,0,0,0, ,0,0,0,0,0, ,0,0,0,0, ,0,0,0,0, ,0,0,0,0, ,0,0,0, ,0,0,0,0, 
11785,CAN,7,Maar Stephen Timothy ,OH,10,1,0,15.62,11,10,1,10,21,42.86,1,2,0,3,-33.33,0,3,5,8,-37.50,4,1,14,19,15.79,2,0,3,66.67,0,0,2,2,0.00
11785,CAN,8,Blankenau Jay ,S,2,0,1,0.00,3,2,0,1,3,66.67,0,2,0,2,-100.00,1,1,15,17,0.00,0,0,0,0, ,9,2,11,63.64,8,0,51,59,13.56
11785,CAN,10,Sclater Ryan Joseph ,O,0,0,0, ,0,0,0,0,0, ,0,0,0,0, ,0,0,0,0, ,0,0,0,0, ,0,0,0, ,0,0,0,0, 
11785,CAN,11,Jansen Vandoorn Daniel ,MB,2,1,0,-8.33,3,2,0,4,6,33.33,1,4,1,6,-50.00,0,1,11,12,-8.33,1,0,1,2,50.00,2,0,2,100.00,0,0,0,0, 
11785,CAN,12,Van Berkel Lucas ,MB,0,0,0, ,0,0,0,0,0, ,0,0,0,0, ,0,0,0,0, ,0,0,0,0, ,0,0,0, ,0,0,0,0, 
11785,CAN,13,Vernon-Evans Sharone ,O,14,1,0,19.05,15,14,3,11,28,39.29,1,1,0,2,0.00,0,3,9,12,-25.00,0,0,0,0, ,4,4,8,0.00,1,0,4,5,20.00
11785,CAN,14,Loeppky Eric ,OH,0,0,0, ,0,0,0,0,0, ,0,0,0,0, ,0,0,0,0, ,0,0,0,0, ,0,0,0, ,0,0,0,0, 
11785,CAN,17,Vigrass Graham ,MB,2,1,0,0.00,3,2,0,1,3,66.67,1,3,2,6,-33.33,0,0,7,7,0.00,0,0,0,0, ,2,3,5,-20.00,0,0,0,0, 
11785,CAN,19,Bann Blair Cameron ,L,0,0,0, ,0,0,0,0,0, ,0,0,0,0, ,0,0,0,0, ,8,0,3,11,72.73,9,3,12,50.00,0,0,6,6,0.00
11785,CAN,20,Szwarc Arthur ,O,0,1,0,-16.67,1,0,0,0,0, ,1,2,0,3,-33.33,0,0,3,3,0.00,0,0,0,0, ,0,0,0, ,0,0,0,0, 
11785,CAN,21,Walsh Brett James ,S,0,0,0, ,0,0,0,0,0, ,0,0,0,0, ,0,0,0,0, ,0,0,0,0, ,0,0,0, ,0,0,1,1,0.00
11785,GER,1,Fromm Christian ,OH,1,0,0,0.00,1,1,0,0,1,100.00,0,1,0,1,-100.00,0,0,0,0, ,0,0,0,0, ,0,0,0, ,0,0,0,0, 
11785,GER,3,Schott Ruben ,OH,4,0,0,-25.81,4,4,4,8,16,0.00,0,5,0,5,-100.00,0,3,7,10,-30.00,13,1,6,20,60.00,6,6,12,0.00,0,0,1,1,0.00
11785,GER,5,Reichert Moritz ,OH,0,0,0, ,0,0,0,0,0, ,0,0,0,0, ,0,0,0,0, ,0,0,0,0, ,0,0,0, ,0,0,0,0, 
11785,GER,6,Kaliberda Denys ,OH,6,1,0,10.71,7,6,0,7,13,46.15,1,2,0,3,-33.33,0,2,10,12,-16.67,6,0,15,21,28.57,7,2,9,55.56,0,0,3,3,0.00
11785,GER,7,Sossenheimer David ,OH,0,0,0,-100.00,0,0,0,0,0, ,0,0,0,0, ,0,2,0,2,-100.00,0,0,0,0, ,0,0,0, ,0,0,0,0, 
11785,GER,8,BÃ¶hme Marcus ,MB,0,0,0, ,0,0,0,0,0, ,0,0,0,0, ,0,0,0,0, ,0,0,0,0, ,0,0,0, ,0,0,0,0, 
11785,GER,10,Zenger Julian ,L,0,0,0, ,0,0,0,0,0, ,0,0,0,0, ,0,0,0,0, ,9,0,11,20,45.00,7,3,12,33.33,0,0,5,5,0.00
11785,GER,13,Hirsch Simon ,O,2,0,0,33.33,2,2,0,3,5,40.00,0,0,1,1,0.00,0,0,0,0, ,0,0,0,0, ,0,0,0, ,0,0,0,0, 
11785,GER,16,BurggrÃ¤f Eric ,S,0,0,0, ,0,0,0,0,0, ,0,0,0,0, ,0,0,0,0, ,0,0,1,1,0.00,0,0,0, ,3,1,5,9,22.22
11785,GER,17,Zimmermann Jan ,S,1,0,0,0.00,1,1,0,1,2,50.00,0,0,0,0, ,0,1,9,10,-10.00,0,0,0,0, ,0,3,3,-100.00,15,2,49,66,19.70
11785,GER,18,Krage Florian ,MB,5,1,0,4.76,6,5,1,4,10,40.00,1,3,1,5,-40.00,0,1,5,6,-16.67,0,0,0,0, ,0,1,1,-100.00,0,0,0,0, 
11785,GER,19,RÃ¶hrs Erik ,OH,0,0,0, ,0,0,0,0,0, ,0,0,0,0, ,0,0,0,0, ,0,0,0,0, ,0,0,0, ,0,0,0,0, 
11785,GER,20,Weber Linus ,O,12,1,3,13.95,16,12,5,7,24,29.17,1,3,2,6,-33.33,3,2,8,13,7.69,0,0,0,0, ,1,1,2,0.00,0,0,0,0, 
11785,GER,21,Krick Tobias ,MB,7,0,0,-6.90,7,7,1,5,13,46.15,0,4,1,5,-80.00,0,4,7,11,-36.36,0,0,0,0, ,0,0,0, ,0,1,0,1,-100.00
11786,USA,1,Anderson Matthew ,O,0,0,0, ,0,0,0,0,0, ,0,0,0,0, ,0,0,0,0, ,0,0,0,0, ,0,0,0, ,0,0,0,0, 
11786,USA,4,Jendryk II Jeffrey ,MB,0,0,0, ,0,0,0,0,0, ,0,0,0,0, ,0,0,0,0, ,0,0,0,0, ,0,0,0, ,0,0,0,0, 
11786,USA,5,Ensing Kyle ,O,7,5,2,0.00,14,7,5,13,25,8.00,5,4,4,13,7.69,2,5,9,16,-18.75,0,0,1,1,0.00,6,3,9,33.33,0,0,1,1,0.00
11786,USA,6,Stahl Mitchell ,MB,6,3,1,-14.55,10,6,2,5,13,30.77,3,9,9,21,-28.57,1,7,13,21,-28.57,1,0,0,1,100.00,4,0,6,66.67,0,0,1,1,0.00
11786,USA,7,Shoji Kawika ,S,3,1,0,-11.11,4,3,0,1,4,75.00,1,4,3,8,-37.50,0,3,12,15,-20.00,0,0,0,0, ,9,0,10,90.00,33,0,76,109,30.28
11786,USA,8,Defalco Torey ,OH,19,2,0,11.27,21,19,5,21,45,31.11,2,4,3,9,-22.22,0,4,13,17,-23.53,14,0,21,35,40.00,9,3,14,42.86,0,0,5,5,0.00
11786,USA,11,Christenson Micah ,S,0,0,0, ,0,0,0,0,0, ,0,0,0,0, ,0,0,0,0, ,0,0,0,0, ,0,0,0, ,0,0,0,0, 
11786,USA,12,Holt Maxwell ,MB,10,2,0,7.50,12,10,0,5,15,66.67,2,4,5,11,-18.18,0,5,9,14,-35.71,0,0,0,0, ,4,0,4,100.00,0,0,3,3,0.00
11786,USA,15,Sander Brenden ,OH,0,0,0, ,0,0,0,0,0, ,0,0,0,0, ,0,0,0,0, ,0,0,0,0, ,0,0,0, ,0,0,0,0, 
11786,USA,17,Jaeschke Thomas ,OH,12,1,0,5.36,13,12,5,13,30,23.33,1,5,5,11,-36.36,0,0,15,15,0.00,13,2,14,29,37.93,6,2,9,44.44,0,0,2,2,0.00
11786,USA,18,Muagututia Garrett ,OH,0,0,0,0.00,0,0,0,0,0, ,0,0,0,0, ,0,0,2,2,0.00,0,0,0,0, ,0,0,0, ,0,0,0,0, 
11786,USA,20,Smith David ,MB,0,0,0, ,0,0,0,0,0, ,0,0,0,0, ,0,0,0,0, ,0,0,0,0, ,0,0,0, ,0,0,0,0, 
11786,USA,21,Watten Dustin ,L,0,0,0, ,0,0,0,0,0, ,0,0,0,0, ,0,0,0,0, ,0,0,0,0, ,0,0,0, ,0,0,0,0, 
11786,USA,22,Shoji Erik ,L,0,0,0, ,0,0,0,0,0, ,0,0,0,0, ,0,0,0,0, ,8,1,12,21,33.33,14,3,17,64.71,0,0,8,8,0.00
11786,FRA,1,Chinenyeze BarthÃ©lÃ©my ,MB,6,2,0,5.13,8,6,1,5,12,41.67,2,3,7,12,-8.33,0,2,13,15,-13.33,2,0,0,2,100.00,4,0,7,57.14,0,1,1,2,-50.00
11786,FRA,2,Grebennikov Jenia ,L,0,0,0, ,0,0,0,0,0, ,0,0,0,0, ,0,0,0,0, ,8,0,16,24,33.33,11,5,18,33.33,0,0,10,10,0.00
11786,FRA,4,Patry Jean ,O,13,1,0,17.02,14,13,4,9,26,34.62,1,1,6,8,0.00,0,1,12,13,-7.69,0,0,0,0, ,8,2,10,60.00,0,0,6,6,0.00
11786,FRA,6,Toniutti Benjamin ,S,0,0,0,-13.33,0,0,0,0,0, ,0,1,0,1,-100.00,0,1,13,14,-7.14,0,0,0,0, ,9,0,10,90.00,13,0,50,63,20.63
11786,FRA,7,Tillie Kevin ,OH,7,0,0,18.18,7,7,1,4,12,50.00,0,1,2,3,-33.33,0,1,6,7,-14.29,4,0,7,11,36.36,4,2,6,33.33,0,0,2,2,0.00
11786,FRA,9,Ngapeth Earvin ,OH,12,1,3,3.45,16,12,7,16,35,14.29,1,2,1,4,-25.00,3,5,11,19,-10.53,4,1,19,24,12.50,10,4,14,42.86,0,0,7,7,0.00
11786,FRA,11,Brizard Antoine ,S,0,0,0,-28.57,0,0,0,1,1,0.00,0,1,1,2,-50.00,0,1,3,4,-25.00,0,0,0,0, ,3,0,3,100.00,9,0,27,36,25.00
11786,FRA,12,Boyer Stephen ,O,10,0,0,21.74,10,10,2,4,16,50.00,0,1,1,2,-50.00,0,2,3,5,-40.00,0,0,0,0, ,2,2,5,0.00,0,0,1,1,0.00
11786,FRA,14,Le Goff Nicolas ,MB,4,0,0,-3.23,4,4,1,3,8,37.50,0,4,4,8,-50.00,0,0,15,15,0.00,1,0,1,2,50.00,2,0,2,100.00,0,0,2,2,0.00
11786,FRA,16,Bultor Daryl ,MB,0,0,0, ,0,0,0,0,0, ,0,0,0,0, ,0,0,0,0, ,0,0,0,0, ,0,0,0, ,0,0,0,0, 
11786,FRA,17,Clevenot Trevor ,OH,5,2,0,-6.67,7,5,6,7,18,-5.56,2,1,1,4,25.00,0,2,6,8,-25.00,6,2,5,13,30.77,5,0,5,100.00,0,0,2,2,0.00
11786,FRA,18,Rossard Thibault ,OH,0,0,0,0.00,0,0,0,0,0, ,0,0,0,0, ,0,0,2,2,0.00,0,0,0,0, ,0,0,0, ,0,0,1,1,0.00
11786,FRA,19,Louati Yacine ,OH,0,0,0, ,0,0,0,0,0, ,0,0,0,0, ,0,0,0,0, ,0,0,0,0, ,0,0,0, ,0,0,0,0, 
11786,FRA,20,Diez Benjamin ,L,0,0,0, ,0,0,0,0,0, ,0,0,0,0, ,0,0,0,0, ,0,0,0,0, ,0,0,0, ,0,0,0,0, 
11787,IRI,2,Ebadipour Ghara H. Milad ,OH,10,1,0,2.78,11,10,3,6,19,36.84,1,3,0,4,-50.00,0,4,9,13,-30.77,19,2,9,30,56.67,2,1,3,33.33,0,0,5,5,0.00
11787,IRI,3,Abedini Reza ,MB,0,1,0,-60.00,1,0,1,0,1,-100.00,1,1,0,2,0.00,0,2,0,2,-100.00,0,0,0,0, ,0,0,0, ,0,0,0,0, 
11787,IRI,4,Marouflakrani Mir Saeid ,S,0,0,0,0.00,0,0,0,4,4,0.00,0,0,0,0, ,0,0,8,8,0.00,0,0,1,1,0.00,2,2,4,0.00,10,0,47,57,17.54
11787,IRI,6,Mousavi Eraghi Seyed Mohammad ,MB,4,2,1,-16.13,7,4,3,6,13,7.69,2,5,1,8,-37.50,1,4,5,10,-30.00,0,0,0,0, ,1,0,1,100.00,0,0,2,2,0.00
11787,IRI,8,Hazratpourtalatappeh Mohammadreza ,L,0,0,0, ,0,0,0,0,0, ,0,0,0,0, ,0,0,0,0, ,0,0,0,0, ,0,0,0, ,0,0,0,0, 
11787,IRI,9,Gholami Masoud ,MB,0,0,0, ,0,0,0,0,0, ,0,0,0,0, ,0,0,0,0, ,0,0,0,0, ,0,0,0, ,0,0,0,0, 
11787,IRI,11,Kazemi Saber ,O,9,0,1,-6.67,10,9,4,15,28,17.86,0,3,0,3,-100.00,1,6,7,14,-35.71,0,0,0,0, ,3,0,3,100.00,0,0,0,0, 
11787,IRI,12,Sharifi Morteza ,OH,0,0,0, ,0,0,0,0,0, ,0,0,0,0, ,0,0,0,0, ,0,0,0,0, ,0,0,0, ,0,0,0,0, 
11787,IRI,15,Mojarad Aliasghar ,MB,4,1,0,14.29,5,4,0,1,5,80.00,1,2,0,3,-33.33,0,1,5,6,-16.67,0,0,0,0, ,1,0,1,100.00,0,0,0,0, 
11787,IRI,17,Salehi Meisam ,OH,12,1,2,14.29,15,12,4,10,26,30.77,1,2,0,3,-33.33,2,3,8,13,-7.69,8,0,13,21,38.10,3,0,3,100.00,0,0,1,1,0.00
11787,IRI,21,Salehi Arman ,L,0,0,0, ,0,0,0,0,0, ,0,0,0,0, ,0,0,0,0, ,13,1,14,28,42.86,18,4,22,63.64,0,0,7,7,0.00
11787,IRI,22,Esfandiar Amirhossein ,OH,1,0,1,-11.11,2,1,1,3,5,0.00,0,1,0,1,-100.00,1,2,9,12,-8.33,0,0,1,1,0.00,0,1,1,-100.00,0,0,0,0, 
11787,IRI,23,Saadat Bardia ,O,8,0,0,22.22,8,8,3,4,15,33.33,0,0,0,0, ,0,1,2,3,-33.33,0,0,0,0, ,2,0,2,100.00,0,0,1,1,0.00
11787,IRI,24,Karimisouchelmaei Javad ,S,0,1,0,-14.29,1,0,1,1,2,-50.00,1,0,0,1,100.00,0,1,3,4,-25.00,0,0,0,0, ,0,1,1,-100.00,8,0,29,37,21.62
11787,BRA,1,Rezende Bruno Mossa ,S,0,0,0, ,0,0,0,0,0, ,0,0,0,0, ,0,0,0,0, ,0,0,0,0, ,0,0,0, ,0,0,5,5,0.00
11787,BRA,3,De Barros Ferreira JoÃ£o Rafael ,OH,0,0,0,0.00,0,0,0,2,2,0.00,0,0,0,0, ,0,0,1,1,0.00,0,0,0,0, ,0,0,0, ,0,0,0,0, 
11787,BRA,5,Borges Almeida Silva Mauricio ,OH,0,0,0, ,0,0,0,0,0, ,0,0,0,0, ,0,0,0,0, ,1,1,5,7,0.00,0,1,1,-100.00,0,0,0,0, 
11787,BRA,6,Gil Kreling Fernando ,S,2,1,0,-4.55,3,2,0,0,2,100.00,1,2,0,3,-33.33,0,2,15,17,-11.76,0,0,1,1,0.00,9,2,11,63.64,7,0,77,84,8.33
11787,BRA,8,De Souza Wallace ,O,0,0,0, ,0,0,0,0,0, ,0,0,0,0, ,0,0,0,0, ,0,0,0,0, ,0,0,0, ,0,0,0,0, 
11787,BRA,9,Leal Hidalgo Yoandy ,OH,2,1,1,0.00,4,2,1,4,7,14.29,1,1,0,2,0.00,1,2,3,6,-16.67,2,0,3,5,40.00,2,2,4,0.00,0,0,0,0, 
11787,BRA,12,Santos Isac ,MB,5,1,0,2.94,6,5,0,9,14,35.71,1,3,1,5,-40.00,0,2,13,15,-13.33,1,0,0,1,100.00,2,1,3,33.33,0,0,2,2,0.00
11787,BRA,13,De Souza Mauricio Luiz ,MB,5,3,1,-2.94,9,5,1,2,8,50.00,3,6,1,10,-30.00,1,3,12,16,-12.50,0,0,1,1,0.00,1,0,2,50.00,0,0,4,4,0.00
11787,BRA,14,Correia De Souza Douglas ,OH,5,1,0,-6.25,6,5,2,12,19,15.79,1,4,0,5,-60.00,0,2,6,8,-25.00,5,4,10,19,5.26,3,1,4,50.00,0,0,5,5,0.00
11787,BRA,15,Nascimento Maique Reis ,L,0,0,0, ,0,0,0,0,0, ,0,0,0,0, ,0,0,0,0, ,0,0,0,0, ,0,0,0, ,0,0,0,0, 
11787,BRA,17,Hoss Thales ,L,0,0,0, ,0,0,0,0,0, ,0,0,0,0, ,0,0,0,0, ,6,0,9,15,40.00,13,2,15,73.33,0,0,5,5,0.00
11787,BRA,18,Souza Ricardo Lucarelli ,OH,17,2,1,21.05,20,17,5,9,31,38.71,2,0,2,4,50.00,1,3,18,22,-9.09,2,0,10,12,16.67,5,1,6,66.67,0,0,4,4,0.00
11787,BRA,21,Souza Alan ,O,13,3,0,12.24,16,13,6,12,31,22.58,3,2,1,6,16.67,0,2,10,12,-16.67,0,0,0,0, ,7,1,8,75.00,0,0,3,3,0.00
11787,BRA,23,Resende Gualberto Flavio ,MB,0,0,0, ,0,0,0,0,0, ,0,0,0,0, ,0,0,0,0, ,0,0,0,0, ,0,0,0, ,0,0,0,0, 
11788,ARG,1,Sanchez Matias ,S,0,0,1,0.00,1,0,0,0,0, ,0,0,0,0, ,1,1,11,13,0.00,0,0,0,0, ,5,0,6,83.33,25,0,22,47,53.19
11788,ARG,2,Pereyra Federico ,O,6,0,0,33.33,6,6,1,2,9,55.56,0,0,1,1,0.00,0,1,1,2,-50.00,0,0,0,0, ,0,0,0, ,0,0,0,0, 
11788,ARG,6,Poglajen Cristian ,OH,0,0,0, ,0,0,0,0,0, ,0,0,0,0, ,0,0,0,0, ,0,0,0,0, ,0,0,0, ,0,0,0,0, 
11788,ARG,7,Conte Facundo ,OH,12,2,0,18.92,14,12,2,6,20,50.00,2,3,2,7,-14.29,0,2,8,10,-20.00,5,1,13,19,21.05,3,2,6,16.67,0,0,3,3,0.00
11788,ARG,8,Loser Agustin ,MB,8,3,1,15.38,12,8,1,5,14,50.00,3,3,2,8,0.00,1,2,14,17,-5.88,0,0,1,1,0.00,3,2,5,20.00,0,0,0,0, 
11788,ARG,9,Danani Santiago ,L,0,0,0, ,0,0,0,0,0, ,0,0,0,0, ,0,0,0,0, ,6,1,8,15,33.33,7,1,9,66.67,0,0,4,4,0.00
11788,ARG,10,Lazo NicolÃ¡s ,OH,0,0,0, ,0,0,0,0,0, ,0,0,0,0, ,0,0,0,0, ,0,0,0,0, ,0,0,0, ,0,0,0,0, 
11788,ARG,12,Lima Bruno ,O,9,1,0,6.90,10,9,4,4,17,29.41,1,3,4,8,-25.00,0,1,3,4,-25.00,0,0,0,0, ,0,1,1,-100.00,0,0,0,0, 
11788,ARG,13,Palacios Ezequiel ,OH,4,0,1,-17.39,5,4,2,3,9,22.22,0,2,0,2,-100.00,1,5,6,12,-33.33,9,0,12,21,42.86,5,0,6,83.33,0,1,2,3,-33.33
11788,ARG,15,De Cecco Luciano ,S,0,0,0,-16.67,0,0,0,0,0, ,0,0,0,0, ,0,1,5,6,-16.67,0,0,0,0, ,1,0,2,50.00,11,0,13,24,45.83
11788,ARG,16,Palonsky Luciano ,OH,0,0,0, ,0,0,0,0,0, ,0,0,0,0, ,0,0,0,0, ,0,0,0,0, ,0,0,0, ,0,0,0,0, 
11788,ARG,17,Mendez Nicolas ,OH,0,0,0, ,0,0,0,0,0, ,0,0,0,0, ,0,0,0,0, ,0,0,0,0, ,0,0,0, ,0,0,0,0, 
11788,ARG,18,Ramos Martin ,MB,6,2,0,-8.57,8,6,3,2,11,27.27,2,7,2,11,-45.45,0,1,12,13,-7.69,1,0,0,1,100.00,0,0,1,0.00,0,0,1,1,0.00
11788,ARG,19,Massimino Franco ,L,0,0,0, ,0,0,0,0,0, ,0,0,0,0, ,0,0,0,0, ,0,0,0,0, ,0,0,0, ,0,0,0,0, 
11788,SRB,2,Kovacevic Uros ,OH,3,0,0,-13.33,3,3,4,3,10,-10.00,0,0,0,0, ,0,1,4,5,-20.00,1,0,7,8,12.50,1,0,1,100.00,0,0,1,1,0.00
11788,SRB,3,Kapur Milorad ,L,0,0,0, ,0,0,0,0,0, ,0,0,0,0, ,0,0,0,0, ,0,0,0,0, ,0,0,0, ,0,0,0,0, 
11788,SRB,6,Pekovic Nikola ,L,0,0,0, ,0,0,0,0,0, ,0,0,0,0, ,0,0,0,0, ,5,1,15,21,19.05,6,5,13,7.69,0,0,4,4,0.00
11788,SRB,7,Krsmanovic Petar ,MB,4,3,0,16.67,7,4,2,1,7,28.57,3,1,4,8,25.00,0,0,9,9,0.00,0,0,0,0, ,0,1,1,-100.00,0,0,2,2,0.00
11788,SRB,8,Ivovic Marko ,OH,11,1,0,12.82,12,11,3,9,23,34.78,1,3,1,5,-40.00,0,1,10,11,-9.09,4,1,13,18,16.67,2,0,2,100.00,0,0,2,2,0.00
11788,SRB,9,Jovovic Nikola ,S,0,0,0,-12.50,0,0,0,0,0, ,0,0,1,1,0.00,0,1,6,7,-14.29,0,0,0,0, ,4,2,7,28.57,20,0,43,63,31.75
11788,SRB,10,KujundÅ¾iÄ Miran ,OH,0,0,0, ,0,0,0,0,0, ,0,0,0,0, ,0,0,0,0, ,0,0,0,0, ,0,0,0, ,0,0,0,0, 
11788,SRB,12,Peric Pavle ,OH,2,1,1,0.00,4,2,2,3,7,0.00,1,0,1,2,50.00,1,2,4,7,-14.29,2,1,12,15,6.67,0,0,1,0.00,0,0,0,0, 
11788,SRB,13,Simic Stevan ,MB,4,0,0,7.14,4,4,0,0,4,100.00,0,3,0,3,-100.00,0,0,7,7,0.00,0,0,0,0, ,1,1,2,0.00,0,0,1,1,0.00
11788,SRB,14,Atanasijevic Aleksandar ,O,1,0,0,-14.29,1,1,0,1,2,50.00,0,1,0,1,-100.00,0,1,3,4,-25.00,0,0,0,0, ,0,1,1,-100.00,0,0,1,1,0.00
11788,SRB,16,Luburic Drazen ,O,10,1,1,0.00,12,10,5,6,21,23.81,1,2,4,7,-14.29,1,5,6,12,-33.33,0,0,0,0, ,5,0,6,83.33,0,0,2,2,0.00
11788,SRB,18,Podrascanin Marko ,MB,3,1,0,-20.00,4,3,1,2,6,33.33,1,5,0,6,-66.67,0,2,6,8,-25.00,0,0,0,0, ,1,1,2,0.00,0,0,1,1,0.00
11788,SRB,21,Todorovic Vuk ,S,0,0,0, ,0,0,0,0,0, ,0,0,0,0, ,0,0,0,0, ,0,0,0,0, ,1,1,2,0.00,0,0,4,4,0.00
11788,SRB,26,Kovac Davide ,OH,0,0,0, ,0,0,0,0,0, ,0,0,0,0, ,0,0,0,0, ,0,0,1,1,0.00,0,0,0, ,0,0,0,0, 
11789,BUL,1,Karyagin Denis ,O,1,1,0,-20.00,2,1,3,6,10,-20.00,1,1,2,4,0.00,0,2,4,6,-33.33,0,0,0,0, ,0,0,0, ,0,1,0,1,-100.00
11789,BUL,2,Chavdarov Stefan ,MB,0,0,0,-45.45,0,0,0,0,0, ,0,3,2,5,-60.00,0,2,4,6,-33.33,0,0,0,0, ,1,0,1,100.00,0,0,0,0, 
11789,BUL,3,Kolev Nikolay ,MB,6,0,1,-5.88,7,6,0,5,11,54.55,0,8,5,13,-61.54,1,1,8,10,0.00,0,0,0,0, ,1,1,2,0.00,0,0,2,2,0.00
11789,BUL,4,Atanasov Martin ,OH,7,0,2,3.12,9,7,5,6,18,11.11,0,1,0,1,-100.00,2,2,9,13,0.00,4,0,13,17,23.53,6,4,11,18.18,0,0,3,3,0.00
11789,BUL,6,Stankov Vladimir ,S,0,0,0,-27.27,0,0,0,0,0, ,0,3,1,4,-75.00,0,0,7,7,0.00,0,0,0,0, ,0,1,1,-100.00,5,1,38,44,9.09
11789,BUL,9,Seganov Georgi ,S,0,0,0, ,0,0,0,0,0, ,0,0,0,0, ,0,0,0,0, ,0,0,0,0, ,0,0,0, ,0,0,0,0, 
11789,BUL,10,Stankov Svetoslav ,S,0,0,1,0.00,1,0,0,0,0, ,0,1,0,1,-100.00,1,0,2,3,33.33,0,0,0,0, ,1,1,2,0.00,1,0,16,17,5.88
11789,BUL,12,Petrov Georgi ,OH,0,0,0, ,0,0,0,0,0, ,0,0,0,0, ,0,0,0,0, ,0,0,0,0, ,0,0,0, ,0,0,0,0, 
11789,BUL,14,Asparuhov Asparuh ,OH,9,1,0,13.33,10,9,1,7,17,47.06,1,3,3,7,-28.57,0,2,4,6,-33.33,5,4,12,21,4.76,2,1,3,33.33,0,0,1,1,0.00
11789,BUL,15,Lyutskanov Gordan ,OH,0,0,0, ,0,0,0,0,0, ,0,0,0,0, ,0,0,0,0, ,0,0,0,0, ,0,0,0, ,0,0,0,0, 
11789,BUL,16,Ivanov Vladislav ,L,0,0,0, ,0,0,0,0,0, ,0,0,0,0, ,0,0,0,0, ,1,1,5,7,0.00,3,2,5,20.00,0,0,2,2,0.00
11789,BUL,24,Ivanov Martin ,L,0,0,0, ,0,0,0,0,0, ,0,0,0,0, ,0,0,0,0, ,3,1,3,7,28.57,3,0,3,100.00,0,0,0,0, 
11789,BUL,25,Parapunov Radoslav ,O,1,1,1,-5.56,3,1,3,5,9,-22.22,1,0,2,3,33.33,1,1,4,6,0.00,0,0,0,0, ,3,0,3,100.00,0,0,0,0, 
11789,BUL,26,Ivanov Svetoslav ,OH,0,0,0, ,0,0,0,0,0, ,0,0,0,0, ,0,0,0,0, ,0,0,0,0, ,0,0,0, ,0,0,0,0, 
11789,RUS,1,Podlesnykh Yaroslav ,OH,0,0,0,0.00,0,0,0,0,0, ,0,0,0,0, ,0,0,3,3,0.00,0,0,0,0, ,0,0,0, ,0,0,0,0, 
11789,RUS,2,Vlasov Ilia ,MB,6,2,0,17.65,8,6,0,1,7,85.71,2,2,2,6,0.00,0,3,1,4,-75.00,0,0,2,2,0.00,1,0,1,100.00,0,0,0,0, 
11789,RUS,4,Volvich Artem ,MB,1,1,0,-11.11,2,1,0,1,2,50.00,1,1,1,3,0.00,0,2,2,4,-50.00,0,0,0,0, ,1,0,1,100.00,0,0,1,1,0.00
11789,RUS,6,Baranov Evgeny ,L,0,0,0, ,0,0,0,0,0, ,0,0,0,0, ,0,0,0,0, ,0,0,0,0, ,0,0,1,0.00,0,0,0,0, 
11789,RUS,7,Volkov Dmitry ,OH,12,1,1,31.03,14,12,1,3,16,68.75,1,1,2,4,0.00,1,3,5,9,-22.22,5,1,8,14,28.57,2,1,4,25.00,0,0,3,3,0.00
11789,RUS,10,Bogdan Denis ,OH,6,2,1,3.57,9,6,1,5,12,41.67,2,4,0,6,-33.33,1,3,6,10,-20.00,3,3,7,13,0.00,7,1,9,66.67,0,0,6,6,0.00
11789,RUS,11,Pankov Pavel ,S,0,0,0,0.00,0,0,0,0,0, ,0,0,0,0, ,0,0,2,2,0.00,0,0,0,0, ,0,1,1,-100.00,0,0,0,0, 
11789,RUS,13,Muserskiy Dmitriy ,MB,0,0,0, ,0,0,0,0,0, ,0,0,0,0, ,0,0,0,0, ,0,0,0,0, ,0,0,0, ,0,0,0,0, 
11789,RUS,15,Poletaev Victor ,O,12,1,0,18.42,13,12,3,8,23,39.13,1,0,2,3,33.33,0,3,9,12,-25.00,0,0,1,1,0.00,2,0,2,100.00,0,0,1,1,0.00
11789,RUS,17,Mikhaylov Maxim ,O,0,0,0, ,0,0,0,0,0, ,0,0,0,0, ,0,0,0,0, ,0,0,0,0, ,0,0,0, ,0,0,0,0, 
11789,RUS,18,Kliuka Egor ,OH,0,0,0, ,0,0,0,0,0, ,0,0,0,0, ,0,0,0,0, ,0,0,0,0, ,0,0,0, ,0,0,0,0, 
11789,RUS,20,Kurkaev Ilyas ,MB,6,0,0,0.00,6,6,0,1,7,85.71,0,3,2,5,-60.00,0,3,5,8,-37.50,0,0,0,0, ,0,1,1,-100.00,0,0,0,0, 
11789,RUS,24,Kobzar Igor ,S,2,0,4,3.85,6,2,0,0,2,100.00,0,1,2,3,-33.33,4,4,13,21,0.00,0,0,1,1,0.00,7,1,8,75.00,16,0,37,53,30.19
11789,RUS,27,Golubev Valentin ,L,0,0,0, ,0,0,0,0,0, ,0,0,0,0, ,0,0,0,0, ,5,1,10,16,25.00,10,2,12,66.67,0,0,5,5,0.00
11790,JPN,1,Shimizu Kunihiro ,O,10,1,0,14.29,11,10,2,12,24,33.33,1,2,2,5,-20.00,0,2,4,6,-33.33,0,0,1,1,0.00,5,0,5,100.00,0,0,0,0, 
11790,JPN,2,Onodera Taishi ,MB,4,0,0,0.00,4,4,0,2,6,66.67,0,4,7,11,-36.36,0,0,9,9,0.00,3,0,0,3,100.00,4,1,5,60.00,0,0,0,0, 
11790,JPN,5,Fukuzawa Tatsuya ,OH,0,0,0, ,0,0,0,0,0, ,0,0,0,0, ,0,0,0,0, ,0,0,0,0, ,0,0,0, ,0,0,0,0, 
11790,JPN,6,Yamauchi Akihiro ,MB,5,0,0,-10.71,5,5,1,2,8,50.00,0,6,3,9,-66.67,0,1,10,11,-9.09,1,0,3,4,25.00,3,0,3,100.00,0,0,0,0, 
11790,JPN,11,Nishida Yuji ,O,0,0,0,-40.00,0,0,1,1,2,-50.00,0,0,0,0, ,0,1,2,3,-33.33,0,0,0,0, ,2,2,4,0.00,0,0,1,1,0.00
11790,JPN,12,Sekita Masahiro ,S,0,0,1,-20.00,1,0,0,0,0, ,0,3,3,6,-50.00,1,2,11,14,-7.14,0,0,1,1,0.00,5,1,7,57.14,18,1,57,76,22.37
11790,JPN,13,Oya Masaki ,S,0,0,0, ,0,0,0,0,0, ,0,0,0,0, ,0,0,0,0, ,0,0,0,0, ,0,0,0, ,0,0,0,0, 
11790,JPN,14,Ishikawa Yuki ,OH,11,1,0,4.65,12,11,3,12,26,30.77,1,4,2,7,-42.86,0,3,7,10,-30.00,5,1,13,19,21.05,5,4,11,9.09,0,0,6,6,0.00
11790,JPN,15,Ri Haku ,MB,0,0,0, ,0,0,0,0,0, ,0,0,0,0, ,0,0,0,0, ,0,0,0,0, ,0,0,0, ,0,0,0,0, 
11790,JPN,17,Takanashi Kenta ,OH,4,0,0,7.69,4,4,1,3,8,37.50,0,2,0,2,-100.00,0,0,3,3,0.00,0,2,5,7,-28.57,0,2,2,-100.00,0,0,2,2,0.00
11790,JPN,19,Otsuka Tatsunori ,OH,2,0,0,66.67,2,2,0,0,2,100.00,0,0,0,0, ,0,0,1,1,0.00,0,0,0,0, ,1,0,1,100.00,0,0,0,0, 
11790,JPN,20,Yamamoto Tomohiro ,L,0,0,0, ,0,0,0,0,0, ,0,0,0,0, ,0,0,0,0, ,2,2,6,10,0.00,6,3,10,30.00,0,0,4,4,0.00
11790,JPN,21,Takahashi Ran ,OH,6,0,0,-9.09,6,6,4,2,12,16.67,0,3,0,3,-100.00,0,1,6,7,-14.29,1,2,15,18,-5.56,6,0,6,100.00,0,0,1,1,0.00
11790,JPN,24,Ogawa Tomohiro ,L,0,0,0, ,0,0,0,0,0, ,0,0,0,0, ,0,0,0,0, ,0,0,0,0, ,0,0,0, ,0,0,0,0, 
11790,CAN,1,Sanders Tyler ,S,0,0,0,-5.56,0,0,0,3,3,0.00,0,1,2,3,-33.33,0,0,12,12,0.00,0,0,0,0, ,9,1,12,66.67,28,1,35,64,42.19
11790,CAN,2,Perrin John Gordon ,OH,12,0,2,24.39,14,12,1,9,22,50.00,0,1,2,3,-33.33,2,2,12,16,0.00,7,1,12,20,30.00,4,2,7,28.57,0,0,6,6,0.00
11790,CAN,3,Marshall Steven ,OH,0,0,0, ,0,0,0,0,0, ,0,0,0,0, ,0,0,0,0, ,0,0,0,0, ,0,0,0, ,0,0,0,0, 
11790,CAN,4,Hoag Nicholas ,OH,0,0,0, ,0,0,0,0,0, ,0,0,0,0, ,0,0,0,0, ,0,0,0,0, ,0,0,0, ,0,0,0,0, 
11790,CAN,6,Pereira Jordan ,OH,0,0,0, ,0,0,0,0,0, ,0,0,0,0, ,0,0,0,0, ,0,0,0,0, ,0,0,0, ,0,0,0,0, 
11790,CAN,7,Maar Stephen Timothy ,OH,8,2,1,10.81,11,8,3,10,21,23.81,2,2,2,6,0.00,1,2,7,10,-10.00,2,0,11,13,15.38,5,2,10,30.00,0,0,1,1,0.00
11790,CAN,8,Blankenau Jay ,S,0,0,0, ,0,0,0,0,0, ,0,0,0,0, ,0,0,0,0, ,0,0,0,0, ,0,0,0, ,0,0,0,0, 
11790,CAN,10,Sclater Ryan Joseph ,O,15,0,1,13.64,16,15,1,8,24,58.33,0,5,4,9,-55.56,1,4,6,11,-27.27,0,0,0,0, ,2,2,7,0.00,0,0,2,2,0.00
11790,CAN,11,Jansen Vandoorn Daniel ,MB,0,0,0, ,0,0,0,0,0, ,0,0,0,0, ,0,0,0,0, ,0,0,0,0, ,0,0,0, ,0,0,0,0, 
11790,CAN,12,Van Berkel Lucas ,MB,0,0,0, ,0,0,0,0,0, ,0,0,0,0, ,0,0,0,0, ,0,0,0,0, ,0,0,0, ,0,0,0,0, 
11790,CAN,13,Vernon-Evans Sharone ,O,0,0,0, ,0,0,0,0,0, ,0,0,0,0, ,0,0,0,0, ,0,0,0,0, ,0,0,0, ,0,0,0,0, 
11790,CAN,17,Vigrass Graham ,MB,3,0,2,0.00,5,3,0,5,8,37.50,0,5,2,7,-71.43,2,0,10,12,16.67,0,0,2,2,0.00,1,0,1,100.00,0,0,1,1,0.00
11790,CAN,19,Bann Blair Cameron ,L,0,0,0, ,0,0,0,0,0, ,0,0,0,0, ,0,0,0,0, ,5,0,13,18,27.78,6,0,8,75.00,0,1,6,7,-14.29
11790,CAN,20,Szwarc Arthur ,O,6,4,1,-5.13,11,6,0,1,7,85.71,4,10,5,19,-31.58,1,3,9,13,-15.38,1,0,0,1,100.00,3,0,3,100.00,0,0,0,0, 
11791,AUS,1,Graham Beau ,MB,10,0,0,2.63,10,10,4,11,25,24.00,0,4,1,5,-80.00,0,1,7,8,-12.50,0,0,0,0, ,2,1,3,33.33,0,0,0,0, 
11791,AUS,2,Dosanjh Arshdeep ,S,2,0,0,-6.25,2,2,0,3,5,40.00,0,2,1,3,-66.67,0,1,7,8,-12.50,0,0,0,0, ,5,3,9,22.22,7,0,50,57,12.28
11791,AUS,7,Weir James ,MB,1,0,0,-25.00,1,1,0,0,1,100.00,0,0,0,0, ,0,2,1,3,-66.67,0,0,0,0, ,0,0,0, ,0,0,0,0, 
11791,AUS,8,O'Dea Trent ,MB,0,0,1,-18.75,1,0,3,5,8,-37.50,0,0,2,2,0.00,1,1,4,6,0.00,0,0,0,0, ,2,1,3,33.33,0,0,0,0, 
11791,AUS,11,Perry Luke ,L,0,0,0, ,0,0,0,0,0, ,0,0,0,0, ,0,0,0,0, ,5,0,5,10,50.00,8,2,10,60.00,0,0,11,11,0.00
11791,AUS,12,Mote Nehemiah ,MB,3,1,0,-4.17,4,3,1,5,9,22.22,1,4,2,7,-42.86,0,0,8,8,0.00,0,0,0,0, ,5,1,6,66.67,0,0,4,4,0.00
11791,AUS,15,Smith Luke ,OH,8,2,1,18.92,11,8,1,10,19,36.84,2,3,2,7,-14.29,1,0,10,11,9.09,6,1,17,24,20.83,5,2,7,42.86,0,0,0,0, 
11791,AUS,21,Butler Nicholas ,S,0,0,0,-100.00,0,0,0,0,0, ,0,0,0,0, ,0,1,0,1,-100.00,0,0,0,0, ,2,0,2,100.00,2,0,15,17,11.76
11791,AUS,27,Senica Max ,OH,0,0,0,0.00,0,0,0,0,0, ,0,0,0,0, ,0,0,2,2,0.00,0,1,2,3,-33.33,1,0,2,50.00,0,0,0,0, 
11791,AUS,28,Taylor Tim ,OH,0,0,0, ,0,0,0,0,0, ,0,0,0,0, ,0,0,0,0, ,0,0,0,0, ,0,0,0, ,0,0,0,0, 
11791,AUS,29,Garrett Ethan ,OH,7,0,0,4.00,7,7,3,9,19,21.05,0,1,0,1,-100.00,0,2,3,5,-40.00,7,1,21,29,20.69,2,5,8,-37.50,0,0,3,3,0.00
11791,AUS,31,Aubrey Matthew ,O,0,0,0, ,0,0,0,0,0, ,0,0,0,0, ,0,0,0,0, ,0,0,0,0, ,0,0,0, ,0,0,0,0, 
11791,AUS,32,Azeez Oluwatobi Elliot ,OH,4,0,0,20.00,4,4,1,4,9,33.33,0,0,0,0, ,0,1,0,1,-100.00,0,0,0,0, ,0,0,0, ,0,0,0,0, 
11791,AUS,33,Flowerday Sam ,OH,0,0,0, ,0,0,0,0,0, ,0,0,0,0, ,0,0,0,0, ,0,0,0,0, ,0,0,0, ,0,0,0,0, 
11791,BRA,1,Rezende Bruno Mossa ,S,2,1,0,0.00,3,2,0,1,3,66.67,1,2,0,3,-33.33,0,1,11,12,-8.33,0,0,0,0, ,9,1,14,57.14,25,0,36,61,40.98
11791,BRA,3,De Barros Ferreira JoÃ£o Rafael ,OH,3,0,1,37.50,4,3,0,1,4,75.00,0,0,0,0, ,1,1,2,4,0.00,0,0,1,1,0.00,1,0,1,100.00,0,0,2,2,0.00
11791,BRA,5,Borges Almeida Silva Mauricio ,OH,10,1,0,25.00,11,10,1,7,18,50.00,1,1,4,6,0.00,0,1,7,8,-12.50,4,0,9,13,30.77,4,0,4,100.00,0,0,7,7,0.00
11791,BRA,6,Gil Kreling Fernando ,S,0,0,0, ,0,0,0,0,0, ,0,0,0,0, ,0,0,0,0, ,0,0,0,0, ,0,0,0, ,0,0,0,0, 
11791,BRA,8,De Souza Wallace ,O,0,0,0, ,0,0,0,0,0, ,0,0,0,0, ,0,0,0,0, ,0,0,0,0, ,0,0,0, ,0,0,0,0, 
11791,BRA,9,Leal Hidalgo Yoandy ,OH,0,0,0, ,0,0,0,0,0, ,0,0,0,0, ,0,0,0,0, ,0,0,0,0, ,0,0,0, ,0,0,0,0, 
11791,BRA,11,Kavalkievicz Gabriel ,OH,3,1,0,8.33,4,3,1,2,6,33.33,1,1,1,3,0.00,0,1,2,3,-33.33,2,0,1,3,66.67,1,0,1,100.00,0,0,1,1,0.00
11791,BRA,12,Santos Isac ,MB,7,2,2,19.44,11,7,1,5,13,46.15,2,2,6,10,0.00,2,1,10,13,7.69,0,0,0,0, ,1,0,1,100.00,0,0,0,0, 
11791,BRA,13,De Souza Mauricio Luiz ,MB,0,0,0, ,0,0,0,0,0, ,0,0,0,0, ,0,0,0,0, ,0,0,0,0, ,0,0,0, ,0,0,0,0, 
11791,BRA,14,Correia De Souza Douglas ,OH,10,0,0,17.24,10,10,1,2,13,69.23,0,4,2,6,-66.67,0,0,10,10,0.00,11,2,6,19,47.37,2,2,4,0.00,0,0,5,5,0.00
11791,BRA,15,Nascimento Maique Reis ,L,0,0,0, ,0,0,0,0,0, ,0,0,0,0, ,0,0,0,0, ,4,0,1,5,80.00,13,2,16,68.75,0,0,0,0, 
11791,BRA,17,Hoss Thales ,L,0,0,0, ,0,0,0,0,0, ,0,0,0,0, ,0,0,0,0, ,0,0,0,0, ,0,0,0, ,0,0,0,0, 
11791,BRA,21,Souza Alan ,O,9,0,0,12.12,9,9,3,7,19,31.58,0,2,3,5,-40.00,0,0,9,9,0.00,0,0,1,1,0.00,3,3,7,0.00,0,0,1,1,0.00
11791,BRA,23,Resende Gualberto Flavio ,MB,4,1,0,-3.45,5,4,0,0,4,100.00,1,4,6,11,-27.27,0,2,12,14,-14.29,0,0,2,2,0.00,4,0,4,100.00,0,0,1,1,0.00
11792,IRI,2,Ebadipour Ghara H. Milad ,OH,10,1,1,13.64,12,10,2,10,22,36.36,1,1,2,4,0.00,1,3,14,18,-11.11,8,0,14,22,36.36,1,7,9,-66.67,0,0,3,3,0.00
11792,IRI,3,Abedini Reza ,MB,0,0,0, ,0,0,0,0,0, ,0,0,0,0, ,0,0,0,0, ,0,0,0,0, ,0,0,0, ,0,0,0,0, 
11792,IRI,4,Marouflakrani Mir Saeid ,S,1,0,0,-5.56,1,1,0,1,2,50.00,0,2,0,2,-100.00,0,0,14,14,0.00,0,1,0,1,-100.00,4,5,9,-11.11,19,2,61,82,20.73
11792,IRI,6,Mousavi Eraghi Seyed Mohammad ,MB,4,5,1,3.23,10,4,2,2,8,25.00,5,4,0,9,11.11,1,3,10,14,-14.29,0,1,2,3,-33.33,1,1,2,0.00,0,0,1,1,0.00
11792,IRI,8,Hazratpourtalatappeh Mohammadreza ,L,0,0,0, ,0,0,0,0,0, ,0,0,0,0, ,0,0,0,0, ,0,0,0,0, ,0,0,0, ,0,0,0,0, 
11792,IRI,9,Gholami Masoud ,MB,5,3,1,8.33,9,5,1,4,10,40.00,3,5,0,8,-25.00,1,0,17,18,5.56,0,0,0,0, ,1,1,2,0.00,0,0,2,2,0.00
11792,IRI,11,Kazemi Saber ,O,14,1,1,10.87,16,14,3,12,29,37.93,1,5,0,6,-66.67,1,3,7,11,-18.18,0,0,0,0, ,5,3,8,25.00,0,0,1,1,0.00
11792,IRI,12,Sharifi Morteza ,OH,0,0,0, ,0,0,0,0,0, ,0,0,0,0, ,0,0,0,0, ,0,0,0,0, ,0,0,0, ,0,0,0,0, 
11792,IRI,15,Mojarad Aliasghar ,MB,0,0,0, ,0,0,0,0,0, ,0,0,0,0, ,0,0,0,0, ,0,0,0,0, ,0,0,0, ,0,0,0,0, 
11792,IRI,17,Salehi Meisam ,OH,15,2,0,17.78,17,15,4,6,25,44.00,2,2,0,4,0.00,0,3,13,16,-18.75,10,1,17,28,32.14,5,4,9,11.11,0,0,0,0, 
11792,IRI,21,Salehi Arman ,L,0,0,0, ,0,0,0,0,0, ,0,0,0,0, ,0,0,0,0, ,11,0,10,21,52.38,5,5,10,0.00,0,0,6,6,0.00
11792,IRI,22,Esfandiar Amirhossein ,OH,0,0,0,0.00,0,0,0,0,0, ,0,0,0,0, ,0,0,1,1,0.00,0,0,0,0, ,0,0,0, ,0,0,0,0, 
11792,IRI,23,Saadat Bardia ,O,2,0,0,-28.57,2,2,2,0,4,0.00,0,1,0,1,-100.00,0,1,1,2,-50.00,0,0,0,0, ,0,0,0, ,0,0,0,0, 
11792,IRI,24,Karimisouchelmaei Javad ,S,0,0,0,0.00,0,0,0,0,0, ,0,0,0,0, ,0,0,1,1,0.00,0,0,0,0, ,0,1,1,-100.00,0,0,2,2,0.00
11792,SLO,1,Å tern TonÄek ,O,8,1,2,-10.20,11,8,7,9,24,4.17,1,5,1,7,-57.14,2,4,12,18,-11.11,0,0,0,0, ,3,1,4,50.00,0,0,1,1,0.00
11792,SLO,2,Pajenk Alen ,MB,8,1,0,6.25,9,8,1,3,12,58.33,1,2,1,4,-25.00,0,4,12,16,-25.00,2,0,0,2,100.00,4,0,4,100.00,0,0,4,4,0.00
11792,SLO,4,Kozamernik Jan ,MB,5,2,0,3.33,7,5,1,2,8,50.00,2,4,3,9,-22.22,0,1,12,13,-7.69,3,0,1,4,75.00,2,4,6,-33.33,0,0,1,1,0.00
11792,SLO,5,Å ket Alen ,O,0,0,0, ,0,0,0,0,0, ,0,0,0,0, ,0,0,0,0, ,0,0,0,0, ,0,0,0, ,0,0,0,0, 
11792,SLO,6,Gasparini Mitja ,O,2,0,0,16.67,2,2,0,1,3,66.67,0,1,0,1,-100.00,0,0,2,2,0.00,0,0,0,0, ,0,1,1,-100.00,0,0,0,0, 
11792,SLO,9,Vincic Dejan ,S,0,0,0, ,0,0,0,0,0, ,0,0,0,0, ,0,0,0,0, ,0,0,0,0, ,0,0,0, ,2,0,7,9,22.22
11792,SLO,11,Å tern Å½iga ,OH,0,0,0, ,0,0,0,0,0, ,0,0,0,0, ,0,0,0,0, ,0,0,0,0, ,0,0,0, ,0,0,0,0, 
11792,SLO,12,Klobucar Jan ,L,0,0,0, ,0,0,0,0,0, ,0,0,0,0, ,0,0,0,0, ,0,0,0,0, ,0,0,0, ,0,0,0,0, 
11792,SLO,13,KovaÄiÄ Jani ,L,0,0,0, ,0,0,0,0,0, ,0,0,0,0, ,0,0,0,0, ,11,3,7,21,38.10,8,7,15,6.67,0,1,3,4,-25.00
11792,SLO,15,VideÄnik Matic ,MB,0,0,0, ,0,0,0,0,0, ,0,0,0,0, ,0,0,0,0, ,0,0,0,0, ,0,0,0, ,0,0,0,0, 
11792,SLO,16,Ropret Gregor ,S,1,0,1,-11.76,2,1,0,1,2,50.00,0,2,0,2,-100.00,1,2,10,13,-7.69,0,0,0,0, ,7,3,10,40.00,26,0,57,83,31.33
11792,SLO,17,Urnaut Tine ,OH,16,1,0,18.00,17,16,3,8,27,48.15,1,2,0,3,-33.33,0,3,17,20,-15.00,14,0,14,28,50.00,3,6,9,-33.33,0,0,3,3,0.00
11792,SLO,18,Äebulj Klemen ,OH,20,1,0,20.83,21,20,5,9,34,44.12,1,0,0,1,100.00,0,6,7,13,-46.15,8,1,15,24,29.17,2,3,5,-20.00,0,0,4,4,0.00
11792,SLO,19,MoÅ¾iÄ Rok ,OH,0,0,0,-33.33,0,0,0,2,2,0.00,0,1,0,1,-100.00,0,0,0,0, ,0,0,3,3,0.00,0,0,0, ,0,0,0,0, 
11793,NED,2,Keemink Wessel ,S,1,0,2,4.00,3,1,0,0,1,100.00,0,2,3,5,-40.00,2,0,17,19,10.53,0,0,0,0, ,11,1,13,76.92,21,0,73,94,22.34
11793,NED,4,Ter Horst Thijs ,OH,17,1,0,5.26,18,17,7,16,40,25.00,1,4,1,6,-50.00,0,4,7,11,-36.36,11,4,23,38,18.42,8,5,13,23.08,0,0,1,1,0.00
11793,NED,5,van der Ent Luuc ,MB,2,0,0,-16.00,2,2,0,4,6,33.33,0,4,5,9,-44.44,0,2,8,10,-20.00,0,1,0,1,-100.00,2,0,2,100.00,0,0,1,1,0.00
11793,NED,6,Dronkers Just ,L,0,0,0, ,0,0,0,0,0, ,0,0,0,0, ,0,0,0,0, ,0,0,0,0, ,0,0,0, ,0,0,0,0, 
11793,NED,8,Plak Fabian ,MB,0,0,0,0.00,0,0,0,0,0, ,0,0,0,0, ,0,0,1,1,0.00,0,0,0,0, ,0,0,0, ,0,0,0,0, 
11793,NED,10,van Zeist Maikel ,MB,0,0,0, ,0,0,0,0,0, ,0,0,0,0, ,0,0,0,0, ,0,0,0,0, ,0,0,0, ,0,0,0,0, 
11793,NED,13,Ottevanger Steven ,L,0,0,0, ,0,0,0,0,0, ,0,0,0,0, ,0,0,0,0, ,5,4,21,30,3.33,5,5,10,0.00,0,0,6,6,0.00
11793,NED,15,van Solkema Gijs ,S,0,0,0,0.00,0,0,0,0,0, ,0,0,0,0, ,0,0,1,1,0.00,0,1,0,1,-100.00,0,0,0, ,0,0,4,4,0.00
11793,NED,17,Parkinson Michael ,MB,6,1,0,13.04,7,6,0,3,9,66.67,1,3,1,5,-40.00,0,1,8,9,-11.11,0,1,0,1,-100.00,3,0,3,100.00,0,0,0,0, 
11793,NED,18,Andringa Robbert ,L,10,1,1,6.98,12,10,2,13,25,32.00,1,1,1,3,0.00,1,6,8,15,-33.33,1,0,9,10,10.00,11,0,11,100.00,0,0,9,9,0.00
11793,NED,19,de Weijer Freek ,S,0,0,0, ,0,0,0,0,0, ,0,0,0,0, ,0,0,0,0, ,0,0,0,0, ,0,0,0, ,0,0,0,0, 
11793,NED,21,van Schie Stijn ,OH,0,0,0,-66.67,0,0,0,1,1,0.00,0,2,0,2,-100.00,0,0,0,0, ,0,0,1,1,0.00,0,0,0, ,0,0,0,0, 
11793,NED,22,Wiltenburg Twan ,MB,0,0,0,-25.00,0,0,0,0,0, ,0,0,1,1,0.00,0,2,5,7,-28.57,0,0,1,1,0.00,1,2,3,-33.33,0,0,0,0, 
11793,NED,25,van Tilburg Stijn ,OH,15,0,4,15.62,19,15,4,17,36,30.56,0,4,2,6,-66.67,4,1,17,22,13.64,1,1,2,4,0.00,4,2,6,33.33,0,0,2,2,0.00
11793,USA,1,Anderson Matthew ,O,17,2,0,3.39,19,17,4,7,28,46.43,2,7,7,16,-31.25,0,6,9,15,-40.00,1,0,3,4,25.00,5,4,10,10.00,0,1,2,3,-33.33
11793,USA,3,Sander Taylor ,OH,15,2,4,16.36,21,15,5,8,28,35.71,2,5,3,10,-30.00,4,2,11,17,11.76,8,2,16,26,23.08,4,3,7,14.29,0,0,8,8,0.00
11793,USA,4,Jendryk II Jeffrey ,MB,0,0,0, ,0,0,0,0,0, ,0,0,0,0, ,0,0,0,0, ,0,0,0,0, ,0,0,0, ,0,0,0,0, 
11793,USA,5,Ensing Kyle ,O,0,0,0, ,0,0,0,0,0, ,0,0,0,0, ,0,0,0,0, ,0,0,0,0, ,0,0,0, ,0,0,0,0, 
11793,USA,6,Stahl Mitchell ,MB,7,3,1,4.88,11,7,1,3,11,54.55,3,4,7,14,-7.14,1,4,11,16,-18.75,1,0,0,1,100.00,4,0,4,100.00,0,0,1,1,0.00
11793,USA,7,Shoji Kawika ,S,0,0,0, ,0,0,0,0,0, ,0,0,0,0, ,0,0,0,0, ,0,0,0,0, ,0,0,0, ,0,0,0,0, 
11793,USA,8,Defalco Torey ,OH,0,0,0, ,0,0,0,0,0, ,0,0,0,0, ,0,0,0,0, ,0,0,0,0, ,0,0,0, ,0,0,0,0, 
11793,USA,11,Christenson Micah ,S,3,0,3,14.29,6,3,0,1,4,75.00,0,0,3,3,0.00,3,2,16,21,4.76,0,0,0,0, ,6,1,9,55.56,28,0,63,91,30.77
11793,USA,12,Holt Maxwell ,MB,0,0,0, ,0,0,0,0,0, ,0,0,0,0, ,0,0,0,0, ,0,0,0,0, ,0,0,0, ,0,0,0,0, 
11793,USA,17,Jaeschke Thomas ,OH,0,0,0, ,0,0,0,0,0, ,0,0,0,0, ,0,0,0,0, ,0,0,0,0, ,0,0,0, ,0,0,0,0, 
11793,USA,18,Muagututia Garrett ,OH,17,1,3,20.69,21,17,3,10,30,46.67,1,2,3,6,-16.67,3,4,15,22,-4.55,13,3,12,28,35.71,7,1,8,75.00,0,0,0,0, 
11793,USA,20,Smith David ,MB,8,0,1,-5.00,9,8,1,1,10,70.00,0,6,6,12,-50.00,1,4,13,18,-16.67,1,0,1,2,50.00,4,0,5,80.00,0,0,3,3,0.00
11793,USA,21,Watten Dustin ,L,0,0,0, ,0,0,0,0,0, ,0,0,0,0, ,0,0,0,0, ,3,1,5,9,22.22,7,3,11,36.36,0,0,2,2,0.00
11793,USA,22,Shoji Erik ,L,0,0,0, ,0,0,0,0,0, ,0,0,0,0, ,0,0,0,0, ,5,1,3,9,44.44,7,0,7,100.00,0,0,3,3,0.00
11794,FRA,1,Chinenyeze BarthÃ©lÃ©my ,MB,2,2,1,7.69,5,2,1,5,8,12.50,2,1,2,5,20.00,1,1,11,13,0.00,0,0,1,1,0.00,1,0,1,100.00,0,0,0,0, 
11794,FRA,2,Grebennikov Jenia ,L,0,0,0, ,0,0,0,0,0, ,0,0,0,0, ,0,0,0,0, ,0,0,2,2,0.00,4,2,6,33.33,0,0,3,3,0.00
11794,FRA,4,Patry Jean ,O,0,0,0, ,0,0,0,0,0, ,0,0,0,0, ,0,0,0,0, ,0,0,0,0, ,0,0,0, ,0,0,0,0, 
11794,FRA,6,Toniutti Benjamin ,S,0,1,0,-10.00,1,0,0,0,0, ,1,1,0,2,0.00,0,1,7,8,-12.50,0,0,0,0, ,3,2,5,20.00,13,0,46,59,22.03
11794,FRA,7,Tillie Kevin ,OH,10,0,0,35.00,10,10,1,3,14,64.29,0,1,0,1,-100.00,0,1,4,5,-20.00,3,2,10,15,6.67,1,1,2,0.00,0,0,2,2,0.00
11794,FRA,11,Brizard Antoine ,S,0,1,0,-31.25,1,0,1,0,1,-100.00,1,2,0,3,-33.33,0,3,9,12,-25.00,0,0,0,0, ,3,0,3,100.00,9,0,46,55,16.36
11794,FRA,12,Boyer Stephen ,O,21,0,0,11.59,21,21,7,21,49,28.57,0,3,1,4,-75.00,0,3,13,16,-18.75,0,0,0,0, ,3,6,9,-33.33,0,0,1,1,0.00
11794,FRA,14,Le Goff Nicolas ,MB,0,0,0, ,0,0,0,0,0, ,0,0,0,0, ,0,0,0,0, ,0,0,0,0, ,0,0,0, ,0,0,0,0, 
11794,FRA,16,Bultor Daryl ,MB,10,1,2,23.53,13,10,1,3,14,64.29,1,0,3,4,25.00,2,4,10,16,-12.50,0,0,0,0, ,2,1,3,33.33,0,0,0,0, 
11794,FRA,17,Clevenot Trevor ,OH,5,1,0,13.64,6,5,1,4,10,40.00,1,1,0,2,0.00,0,1,9,10,-10.00,1,0,10,11,9.09,1,2,3,-33.33,0,0,1,1,0.00
11794,FRA,18,Rossard Thibault ,OH,8,0,0,11.54,8,8,4,2,14,28.57,0,0,0,0, ,0,1,11,12,-8.33,6,1,7,14,35.71,0,1,1,-100.00,0,0,1,1,0.00
11794,FRA,19,Louati Yacine ,OH,4,0,0,-12.50,4,4,2,10,16,12.50,0,2,0,2,-100.00,0,3,3,6,-50.00,4,2,24,30,6.67,5,6,11,-9.09,0,0,0,0, 
11794,FRA,20,Diez Benjamin ,L,0,0,0, ,0,0,0,0,0, ,0,0,0,0, ,0,0,0,0, ,10,1,8,19,47.37,6,6,12,0.00,0,0,4,4,0.00
11794,FRA,24,Gueye Mousse ,MB,5,2,0,23.53,7,5,0,2,7,71.43,2,3,1,6,-16.67,0,0,4,4,0.00,0,0,0,0, ,1,0,1,100.00,0,0,0,0, 
11794,ITA,1,Gardini Davide ,OH,0,0,0, ,0,0,0,0,0, ,0,0,0,0, ,0,0,0,0, ,0,0,0,0, ,0,0,0, ,0,0,0,0, 
11794,ITA,7,Balaso Fabio ,L,0,0,0, ,0,0,0,0,0, ,0,0,0,0, ,0,0,0,0, ,14,0,8,22,63.64,10,2,12,66.67,0,0,7,7,0.00
11794,ITA,15,Sbertoli Riccardo ,S,0,0,0, ,0,0,0,0,0, ,0,0,0,0, ,0,0,0,0, ,0,0,0,0, ,0,0,0, ,0,0,0,0, 
11794,ITA,18,Michieletto Alessandro ,OH,14,1,0,20.83,15,14,1,10,25,52.00,1,2,0,3,-33.33,0,2,18,20,-10.00,10,1,13,24,37.50,6,2,8,50.00,0,0,4,4,0.00
11794,ITA,20,Nelli Gabriele ,O,19,1,1,20.00,21,19,5,7,31,45.16,1,2,5,8,-12.50,1,3,12,16,-12.50,0,0,0,0, ,1,6,7,-71.43,0,1,2,3,-33.33
11794,ITA,21,Spirito Luca ,S,1,4,1,12.50,6,1,0,0,1,100.00,4,1,3,8,37.50,1,2,12,15,-6.67,0,0,0,0, ,4,3,7,14.29,20,0,85,105,19.05
11794,ITA,23,Pinali Giulio ,O,0,0,0,0.00,0,0,0,0,0, ,0,0,0,0, ,0,0,1,1,0.00,0,0,0,0, ,1,0,1,100.00,0,0,0,0, 
11794,ITA,24,Cavuto Oreste ,OH,0,0,0, ,0,0,0,0,0, ,0,0,0,0, ,0,0,0,0, ,0,0,0,0, ,0,0,0, ,0,0,0,0, 
11794,ITA,25,Vitelli Marco ,MB,2,0,0,-15.38,2,2,1,0,3,33.33,0,0,1,1,0.00,0,3,6,9,-33.33,1,0,1,2,50.00,1,1,2,0.00,0,0,1,1,0.00
11794,ITA,26,Cortesia Lorenzo ,MB,8,4,1,14.63,13,8,0,2,10,80.00,4,6,0,10,-20.00,1,1,19,21,0.00,0,0,0,0, ,2,0,2,100.00,0,0,0,0, 
11794,ITA,28,Recine Francesco ,OH,11,0,1,7.50,12,11,6,12,29,17.24,0,1,0,1,-100.00,1,2,7,10,-10.00,14,0,9,23,60.87,2,3,5,-20.00,0,0,0,0, 
11794,ITA,29,Bottolo Mattia ,OH,7,0,1,23.81,8,7,1,6,14,42.86,0,0,1,1,0.00,1,2,3,6,-16.67,1,2,7,10,-10.00,1,0,1,100.00,0,0,0,0, 
11794,ITA,30,Mosca Leandro Ausibio ,MB,2,1,1,0.00,4,2,2,3,7,0.00,1,2,1,4,-25.00,1,0,8,9,11.11,1,0,2,3,33.33,3,1,4,50.00,0,1,0,1,-100.00
11794,ITA,31,Federici Filippo ,L,0,0,0, ,0,0,0,0,0, ,0,0,0,0, ,0,0,0,0, ,0,0,0,0, ,0,0,0, ,0,0,0,0, 
11795,GER,1,Fromm Christian ,OH,11,0,0,0.00,11,11,5,11,27,22.22,0,3,1,4,-75.00,0,3,7,10,-30.00,4,0,12,16,25.00,4,1,5,60.00,0,0,3,3,0.00
11795,GER,3,Schott Ruben ,OH,0,0,0, ,0,0,0,0,0, ,0,0,0,0, ,0,0,0,0, ,0,0,0,0, ,0,0,0, ,0,0,0,0, 
11795,GER,5,Reichert Moritz ,OH,2,0,0,100.00,2,2,0,0,2,100.00,0,0,0,0, ,0,0,0,0, ,0,0,1,1,0.00,0,1,1,-100.00,0,0,0,0, 
11795,GER,6,Kaliberda Denys ,OH,0,0,0, ,0,0,0,0,0, ,0,0,0,0, ,0,0,0,0, ,0,0,0,0, ,0,0,0, ,0,0,0,0, 
11795,GER,7,Sossenheimer David ,OH,8,0,1,14.81,9,8,2,5,15,40.00,0,0,3,3,0.00,1,3,5,9,-22.22,4,0,19,23,17.39,6,3,9,33.33,0,0,3,3,0.00
11795,GER,8,BÃ¶hme Marcus ,MB,3,1,0,-19.23,4,3,2,1,6,16.67,1,6,2,9,-55.56,0,1,10,11,-9.09,0,0,1,1,0.00,1,1,2,0.00,0,0,0,0, 
11795,GER,10,Zenger Julian ,L,0,0,0, ,0,0,0,0,0, ,0,0,0,0, ,0,0,0,0, ,5,1,7,13,30.77,6,3,11,27.27,0,0,7,7,0.00
11795,GER,13,Hirsch Simon ,O,7,0,1,-2.38,8,7,4,12,23,13.04,0,3,3,6,-50.00,1,2,10,13,-7.69,0,1,0,1,-100.00,3,1,4,50.00,0,0,3,3,0.00
11795,GER,15,BaxpÃ¶hler Noah ,MB,3,0,0,0.00,3,3,0,0,3,100.00,0,2,1,3,-66.67,0,1,11,12,-8.33,0,0,1,1,0.00,1,1,2,0.00,0,1,0,1,-100.00
11795,GER,16,BurggrÃ¤f Eric ,S,0,0,0, ,0,0,0,0,0, ,0,0,0,0, ,0,0,0,0, ,0,0,0,0, ,0,1,2,-50.00,1,0,4,5,20.00
11795,GER,17,Zimmermann Jan ,S,0,1,0,-9.09,1,0,0,0,0, ,1,0,2,3,33.33,0,2,6,8,-25.00,0,0,1,1,0.00,5,2,8,37.50,14,1,41,56,23.21
11795,GER,19,RÃ¶hrs Erik ,OH,0,0,0, ,0,0,0,0,0, ,0,0,0,0, ,0,0,0,0, ,0,0,0,0, ,0,0,0, ,0,0,0,0, 
11795,GER,21,Krick Tobias ,MB,0,0,0, ,0,0,0,0,0, ,0,0,0,0, ,0,0,0,0, ,0,0,0,0, ,0,0,0, ,0,0,0,0, 
11795,GER,25,Maase Lukas ,O,0,0,0,0.00,0,0,0,1,1,0.00,0,0,1,1,0.00,0,0,0,0, ,0,0,0,0, ,0,0,0, ,0,0,0,0, 
11795,POL,1,Nowakowski Piotr ,MB,5,2,0,0.00,7,5,0,3,8,62.50,2,5,3,10,-30.00,0,2,6,8,-25.00,0,0,0,0, ,5,0,5,100.00,0,0,0,0, 
11795,POL,5,Kaczmarek Lukasz ,O,0,0,0, ,0,0,0,0,0, ,0,0,0,0, ,0,0,0,0, ,0,0,0,0, ,0,0,0, ,0,0,0,0, 
11795,POL,6,Kurek Bartosz ,O,14,2,0,23.26,16,14,3,9,26,42.31,2,2,2,6,0.00,0,1,10,11,-9.09,0,0,1,1,0.00,4,0,5,80.00,0,0,0,0, 
11795,POL,9,Leon Venero Wilfredo ,OH,11,1,1,10.53,13,11,1,9,21,47.62,1,2,2,5,-20.00,1,6,5,12,-41.67,4,1,12,17,17.65,2,1,3,33.33,0,0,2,2,0.00
11795,POL,11,Drzyzga Fabian ,S,1,1,0,13.33,2,1,0,0,1,100.00,1,0,2,3,33.33,0,0,11,11,0.00,0,0,0,0, ,5,2,8,37.50,28,0,42,70,40.00
11795,POL,12,Lomacz Grzegorz ,S,0,0,0, ,0,0,0,0,0, ,0,0,0,0, ,0,0,0,0, ,0,0,0,0, ,0,0,0, ,0,0,0,0, 
11795,POL,13,Kubiak Michal ,OH,10,0,1,13.51,11,10,1,6,17,52.94,0,2,1,3,-66.67,1,3,13,17,-11.76,3,0,17,20,15.00,6,5,12,8.33,0,0,4,4,0.00
11795,POL,14,Sliwka Aleksander ,OH,0,0,0, ,0,0,0,0,0, ,0,0,0,0, ,0,0,0,0, ,0,0,0,0, ,0,0,0, ,0,0,0,0, 
11795,POL,15,Kochanowski Jakub ,MB,5,1,0,-9.38,6,5,3,3,11,18.18,1,2,4,7,-14.29,0,4,10,14,-28.57,0,0,1,1,0.00,2,0,2,100.00,0,0,1,1,0.00
11795,POL,16,Semeniuk Kamil ,OH,0,0,0, ,0,0,0,0,0, ,0,0,0,0, ,0,0,0,0, ,0,0,0,0, ,0,0,0, ,0,0,0,0, 
11795,POL,17,Zatorski Pawel ,L,0,0,0, ,0,0,0,0,0, ,0,0,0,0, ,0,0,0,0, ,4,1,7,12,25.00,12,2,15,66.67,0,0,5,5,0.00
11795,POL,20,Bieniek Mateusz ,MB,0,0,0, ,0,0,0,0,0, ,0,0,0,0, ,0,0,0,0, ,0,0,0,0, ,0,0,0, ,0,0,0,0, 
11795,POL,22,Bednorz Bartosz ,OH,0,0,0, ,0,0,0,0,0, ,0,0,0,0, ,0,0,0,0, ,0,0,0,0, ,0,0,0, ,0,0,0,0, 
11795,POL,99,Huber Norbert ,MB,0,0,0, ,0,0,0,0,0, ,0,0,0,0, ,0,0,0,0, ,0,0,0,0, ,0,0,0, ,0,0,0,0, 
11926,GER,1,Bock Linda ,L,0,0,1,50.00,1,0,0,0,0, ,0,0,0,0, ,1,0,1,2,50.00,0,0,0,0, ,0,1,1,-100.00,0,0,0,0, 
11926,GER,2,KÃ¤stner Pia ,S,1,0,0,0.00,1,1,0,0,1,100.00,0,1,0,1,-100.00,0,0,3,3,0.00,0,0,0,0, ,2,2,4,0.00,5,0,24,29,17.24
11926,GER,4,Imoudu Denise ,S,1,1,0,22.22,2,1,0,0,1,100.00,1,0,0,1,100.00,0,0,7,7,0.00,0,0,0,0, ,2,1,3,33.33,13,0,43,56,23.21
11926,GER,5,Poll Jana Franziska ,OH,3,1,1,12.50,5,3,2,2,7,14.29,1,1,2,4,0.00,1,0,4,5,20.00,4,0,6,10,40.00,1,2,3,-33.33,0,0,1,1,0.00
11926,GER,8,Drewniok Kimberly ,O,0,0,0, ,0,0,0,0,0, ,0,0,0,0, ,0,0,0,0, ,0,0,0,0, ,0,0,0, ,0,0,0,0, 
11926,GER,9,Alsmeier Lina ,OH,11,0,0,21.43,11,11,3,8,22,36.36,0,0,1,1,0.00,0,2,3,5,-40.00,7,0,9,16,43.75,4,2,6,33.33,0,0,2,2,0.00
11926,GER,10,Stigrot Lena ,OH,7,0,2,16.22,9,7,2,9,18,27.78,0,1,1,2,-50.00,2,0,15,17,11.76,7,2,10,19,26.32,8,0,10,80.00,0,0,2,2,0.00
11926,GER,12,Orthmann Hanna ,OH,14,0,1,14.29,15,14,5,12,31,29.03,0,0,1,1,0.00,1,4,5,10,-30.00,0,0,0,0, ,8,3,11,45.45,0,0,1,1,0.00
11926,GER,14,SchÃ¶lzel Marie ,MB,9,1,0,27.27,10,9,3,2,14,42.86,1,0,0,1,100.00,0,1,6,7,-14.29,0,0,0,0, ,0,1,1,-100.00,0,0,2,2,0.00
11926,GER,17,Pogany Anna ,L,0,0,0, ,0,0,0,0,0, ,0,0,0,0, ,0,0,0,0, ,3,1,7,11,18.18,11,7,20,20.00,0,0,7,7,0.00
11926,GER,20,Bock Josepha ,MB,0,0,0, ,0,0,0,0,0, ,0,0,0,0, ,0,0,0,0, ,0,0,0,0, ,0,0,0, ,0,0,0,0, 
11926,GER,21,Weitzel Camilla ,MB,2,2,1,0.00,5,2,0,5,7,28.57,2,1,2,5,20.00,1,4,13,18,-16.67,0,0,0,0, ,4,1,5,60.00,0,0,1,1,0.00
11926,SRB,6,Uzelac Aleksandra ,OH,0,0,0,-100.00,0,0,1,0,1,-100.00,0,0,0,0, ,0,0,0,0, ,0,0,0,0, ,0,1,1,-100.00,0,0,0,0, 
11926,SRB,7,Jaksic Ana ,S,2,0,0,7.69,2,2,0,1,3,66.67,0,1,1,2,-50.00,0,0,8,8,0.00,0,0,0,0, ,5,3,9,22.22,2,0,50,52,3.85
11926,SRB,21,Kocic Jovana ,MB,1,3,0,-5.56,4,1,1,1,3,0.00,3,4,0,7,-14.29,0,0,8,8,0.00,0,0,0,0, ,1,1,2,0.00,0,0,0,0, 
11926,SRB,22,Lozo Sara ,O,8,1,1,18.18,10,8,3,10,21,23.81,1,0,0,1,100.00,1,1,9,11,0.00,9,1,11,21,38.10,8,4,12,33.33,0,0,5,5,0.00
11926,SRB,23,Djordjevic Mila ,S,0,1,0,-40.00,1,0,2,0,2,-100.00,1,0,0,1,100.00,0,1,1,2,-50.00,0,0,0,0, ,3,0,3,100.00,0,0,21,21,0.00
11926,SRB,24,Medic Sofija ,MB,0,0,1,-14.29,1,0,0,0,0, ,0,2,0,2,-100.00,1,0,4,5,20.00,0,0,1,1,0.00,0,0,0, ,0,0,0,0, 
11926,SRB,25,Markovic Bozica ,MB,1,0,0,-11.76,1,1,0,7,8,12.50,0,2,0,2,-100.00,0,1,6,7,-14.29,1,0,1,2,50.00,1,1,2,0.00,0,0,0,0, 
11926,SRB,26,Savic Vanja ,O,10,3,0,18.92,13,10,5,10,25,20.00,3,0,0,3,100.00,0,1,8,9,-11.11,0,0,0,0, ,1,3,4,-50.00,0,0,0,0, 
11926,SRB,27,Bukilic Vanja ,O,0,0,0,-50.00,0,0,0,1,1,0.00,0,0,0,0, ,0,1,0,1,-100.00,0,0,0,0, ,0,0,0, ,0,0,0,0, 
11926,SRB,28,Delic Jelena ,MB,0,1,1,14.29,2,0,0,1,1,0.00,1,1,0,2,0.00,1,0,3,4,25.00,0,0,0,0, ,0,0,0, ,0,0,0,0, 
11926,SRB,31,Djurdjevic Sanja ,L,0,0,0, ,0,0,0,0,0, ,0,0,0,0, ,0,0,0,0, ,2,1,8,11,9.09,12,6,20,30.00,0,0,6,6,0.00
11926,SRB,32,Gocanin Bojana ,L,0,0,0, ,0,0,0,0,0, ,0,0,0,0, ,0,0,0,0, ,0,0,0,0, ,0,0,0, ,0,0,0,0, 
11926,SRB,33,Cvetkovic Jovana ,OH,2,0,0,0.00,2,2,1,9,12,8.33,0,1,1,2,-50.00,0,0,3,3,0.00,4,3,5,12,8.33,3,2,5,20.00,0,0,7,7,0.00
11926,SRB,34,Mirosavljevic Jovana ,OH,7,0,0,16.67,7,7,2,11,20,25.00,0,1,0,1,-100.00,0,0,3,3,0.00,6,1,9,16,31.25,4,1,5,60.00,0,0,1,1,0.00
11927,JPN,1,Kurogo Ai ,OH,16,1,2,20.29,19,16,3,24,43,30.23,1,2,1,4,-25.00,2,0,20,22,9.09,1,0,1,2,50.00,27,1,29,89.66,0,0,6,6,0.00
11927,JPN,2,Koga Sarina ,OH,19,2,2,13.48,23,19,6,32,57,22.81,2,4,3,9,-22.22,2,1,20,23,4.35,20,0,14,34,58.82,13,9,24,16.67,0,0,3,3,0.00
11927,JPN,3,Shimamura Haruyo ,MB,9,4,0,10.34,13,9,1,12,22,36.36,4,6,15,25,-8.00,0,0,11,11,0.00,0,0,0,0, ,9,1,10,80.00,0,0,2,2,0.00
11927,JPN,5,Araki Erika ,MB,6,0,1,-6.82,7,6,3,6,15,20.00,0,5,6,11,-45.45,1,2,15,18,-5.56,0,0,1,1,0.00,4,1,5,60.00,0,0,4,4,0.00
11927,JPN,7,Ishii Yuki ,OH,0,0,0, ,0,0,0,0,0, ,0,0,0,0, ,0,0,0,0, ,0,0,0,0, ,0,0,0, ,0,0,0,0, 
11927,JPN,8,Ishikawa Mayu ,OH,23,1,0,28.99,24,23,2,27,52,40.38,1,1,3,5,0.00,0,1,11,12,-8.33,16,1,12,29,51.72,18,3,23,65.22,0,0,6,6,0.00
11927,JPN,9,Tashiro Kanami ,S,0,0,0,0.00,0,0,0,0,0, ,0,0,0,0, ,0,0,2,2,0.00,0,0,0,0, ,0,0,0, ,0,0,0,0, 
11927,JPN,11,Nabeya Yurie ,OH,0,0,0,0.00,0,0,0,0,0, ,0,0,0,0, ,0,0,3,3,0.00,0,0,0,0, ,0,1,1,-100.00,0,0,0,0, 
11927,JPN,13,Okumura Mai ,MB,0,0,0, ,0,0,0,0,0, ,0,0,0,0, ,0,0,0,0, ,0,0,0,0, ,0,0,0, ,0,0,0,0, 
11927,JPN,14,Kobata Mako ,L,0,0,0, ,0,0,0,0,0, ,0,0,0,0, ,0,0,0,0, ,13,0,10,23,56.52,6,2,8,50.00,0,0,8,8,0.00
11927,JPN,15,Inoue Kotoe ,L,0,0,0, ,0,0,0,0,0, ,0,0,0,0, ,0,0,0,0, ,0,0,0,0, ,10,4,17,35.29,0,0,3,3,0.00
11927,JPN,19,Yamada Nichika ,MB,0,0,0, ,0,0,0,0,0, ,0,0,0,0, ,0,0,0,0, ,0,0,0,0, ,0,0,0, ,0,0,0,0, 
11927,JPN,21,Hayashi Kotona ,OH,0,0,1,14.29,1,0,0,0,0, ,0,0,0,0, ,1,0,6,7,14.29,0,0,0,0, ,0,0,1,0.00,0,0,1,1,0.00
11927,JPN,24,Momii Aki ,S,0,2,0,-21.74,2,0,0,4,4,0.00,2,6,2,10,-40.00,0,1,8,9,-11.11,0,0,0,0, ,16,2,18,77.78,70,1,87,158,43.67
11927,DOM,3,Eve Mejia Lisvel Elisa ,U,1,1,0,-14.71,2,1,1,5,7,0.00,1,5,6,12,-33.33,0,1,14,15,-6.67,0,1,4,5,-20.00,4,2,9,22.22,0,0,0,0, 
11927,DOM,5,Castillo Brenda ,L,0,0,0, ,0,0,0,0,0, ,0,0,0,0, ,0,0,0,0, ,6,1,9,16,31.25,19,5,30,46.67,0,0,40,40,0.00
11927,DOM,6,Dominguez Martinez Camil Inmaculada ,S,0,0,0,-33.33,0,0,0,0,0, ,0,1,0,1,-100.00,0,0,2,2,0.00,0,0,0,0, ,3,0,3,100.00,0,0,6,6,0.00
11927,DOM,7,Marte Frica Niverka Dharlenis ,S,0,0,0,-28.57,0,0,0,0,0, ,0,6,2,8,-75.00,0,0,13,13,0.00,0,0,0,0, ,15,2,18,72.22,20,0,102,122,16.39
11927,DOM,11,Rodriguez Marifranchi ,MB,0,0,0,-18.18,0,0,0,2,2,0.00,0,1,1,2,-50.00,0,1,6,7,-14.29,0,0,0,0, ,3,0,3,100.00,0,0,1,1,0.00
11927,DOM,12,Perez Flores Yokaty ,S,0,0,0, ,0,0,0,0,0, ,0,0,0,0, ,0,0,0,0, ,0,0,0,0, ,0,0,0, ,0,0,0,0, 
11927,DOM,14,Rivera Brens Prisilla ,OH,12,1,0,5.77,13,12,3,14,29,31.03,1,6,3,10,-50.00,0,1,12,13,-7.69,2,2,26,30,0.00,12,1,14,78.57,0,0,3,3,0.00
11927,DOM,16,PeÃ±a Isabel Yonkaira Paola ,OH,2,0,0,12.50,2,2,0,3,5,40.00,0,0,0,0, ,0,1,2,3,-33.33,1,0,12,13,7.69,2,1,4,25.00,0,0,1,1,0.00
11927,DOM,17,Mambru Casilla Gina Altagracia ,O,0,0,0, ,0,0,0,0,0, ,0,0,0,0, ,0,0,0,0, ,0,0,0,0, ,0,0,0, ,0,0,0,0, 
11927,DOM,18,De La Cruz De PeÃ±a Bethania ,OH,26,0,0,29.58,26,26,2,22,50,48.00,0,2,2,4,-50.00,0,1,16,17,-5.88,3,2,29,34,2.94,18,3,22,68.18,0,0,6,6,0.00
11927,DOM,20,Martinez Brayelin Elizabeth ,OH,29,2,0,18.28,31,29,7,32,68,32.35,2,6,6,14,-28.57,0,1,10,11,-9.09,0,0,4,4,0.00,18,3,24,62.50,0,0,1,1,0.00
11927,DOM,21,Martinez Jineiry ,MB,5,3,1,2.33,9,5,1,8,14,28.57,3,3,6,12,0.00,1,4,12,17,-17.65,0,0,0,0, ,7,0,7,100.00,0,0,5,5,0.00
11927,DOM,23,Gonzalez Lopez Gaila Ceneida ,O,2,0,0,-13.33,2,2,2,6,10,0.00,0,2,2,4,-50.00,0,0,1,1,0.00,0,0,0,0, ,1,1,2,0.00,0,0,3,3,0.00
11927,DOM,25,Martinez Caro Larysmer ,OH,0,0,0, ,0,0,0,0,0, ,0,0,0,0, ,0,0,0,0, ,0,0,0,0, ,0,0,0, ,0,0,0,0, 
11928,THA,2,Pannoy Piyanut ,L,0,0,0, ,0,0,0,0,0, ,0,0,0,0, ,0,0,0,0, ,14,1,17,32,40.62,5,4,9,11.11,0,0,8,8,0.00
11928,THA,5,Thinkaow Pleumjit ,MB,12,1,0,10.87,13,12,2,15,29,34.48,1,2,1,4,-25.00,0,4,9,13,-30.77,0,0,0,0, ,3,1,4,50.00,0,0,3,3,0.00
11928,THA,6,Sittirak Onuma ,OH,11,0,1,3.51,12,11,8,22,41,7.32,0,2,1,3,-66.67,1,0,12,13,7.69,0,1,2,3,-33.33,7,6,14,7.14,0,0,6,6,0.00
11928,THA,9,Chuewulim Sutadta ,OH,12,0,0,27.50,12,12,1,13,26,42.31,0,0,0,0, ,0,0,14,14,0.00,6,1,20,27,18.52,4,5,9,-11.11,0,0,2,2,0.00
11928,THA,10,Apinyapong Wilavan ,L,1,0,0,0.00,1,1,1,2,4,0.00,0,0,0,0, ,0,0,3,3,0.00,2,0,3,5,40.00,2,2,5,0.00,0,0,0,0, 
11928,THA,11,Hyapha Amporn ,MB,0,0,0, ,0,0,0,0,0, ,0,0,0,0, ,0,0,0,0, ,0,0,0,0, ,0,0,0, ,0,0,0,0, 
11928,THA,12,Chaisri Tapaphaipun ,L,0,0,0, ,0,0,0,0,0, ,0,0,0,0, ,0,0,0,0, ,0,0,0,0, ,8,8,17,0.00,0,0,4,4,0.00
11928,THA,13,Tomkom Nootsara ,S,0,0,1,4.76,1,0,0,5,5,0.00,0,0,1,1,0.00,1,0,14,15,6.67,0,0,0,0, ,8,4,12,33.33,16,0,84,100,16.00
11928,THA,14,Juangjan Pattiya ,OH,0,0,0, ,0,0,0,0,0, ,0,0,0,0, ,0,0,0,0, ,0,0,0,0, ,0,0,0, ,0,0,0,0, 
11928,THA,15,Kanthong Malika ,O,16,0,0,24.00,16,16,2,13,31,45.16,0,2,1,3,-66.67,0,0,16,16,0.00,7,3,10,20,20.00,11,6,19,26.32,0,0,2,2,0.00
11928,THA,19,Krause Karina ,MB,10,1,0,38.46,11,10,1,5,16,56.25,1,0,1,2,50.00,0,0,8,8,0.00,0,0,0,0, ,1,3,4,-50.00,0,0,1,1,0.00
11928,THA,20,Phomla Soraya ,S,0,0,0,0.00,0,0,0,0,0, ,0,0,0,0, ,0,0,3,3,0.00,0,0,0,0, ,1,1,2,0.00,1,0,24,25,4.00
11928,THA,22,Nilapa Chatsuda ,OH,0,0,1,-20.00,1,0,2,0,2,-100.00,0,0,0,0, ,1,0,2,3,33.33,0,0,0,0, ,0,0,0, ,0,0,0,0, 
11928,THA,24,Nuanjam Watchareeya ,MB,0,0,0, ,0,0,0,0,0, ,0,0,0,0, ,0,0,0,0, ,0,0,0,0, ,0,0,0, ,0,0,1,1,0.00
11928,BEL,2,Van Sas Elise ,S,0,0,0, ,0,0,0,0,0, ,0,0,0,0, ,0,0,0,0, ,0,0,0,0, ,0,0,0, ,0,0,2,2,0.00
11928,BEL,3,Herbots Britt ,OH,31,1,1,32.00,33,31,5,22,58,44.83,1,1,0,2,0.00,1,3,11,15,-13.33,11,0,17,28,39.29,6,6,13,0.00,0,0,2,2,0.00
11928,BEL,4,Lemmens Nathalie ,MB,1,2,1,7.14,4,1,0,2,3,33.33,2,2,3,7,0.00,1,0,17,18,5.56,0,0,1,1,0.00,3,1,4,50.00,0,0,2,2,0.00
11928,BEL,5,Guilliams Jodie ,OH,1,0,0,0.00,1,1,1,1,3,0.00,0,0,0,0, ,0,0,0,0, ,1,0,1,2,50.00,0,0,0, ,0,0,0,0, 
11928,BEL,7,Van Gestel Celine ,OH,10,0,2,8.93,12,10,4,22,36,16.67,0,2,2,4,-50.00,2,1,13,16,6.25,16,1,14,31,48.39,6,3,9,33.33,0,0,1,1,0.00
11928,BEL,9,Demeyer Nel ,L,0,0,0, ,0,0,0,0,0, ,0,0,0,0, ,0,0,0,0, ,0,0,0,0, ,0,0,0, ,0,0,0,0, 
11928,BEL,10,Sobolska Dominika ,MB,0,0,0, ,0,0,0,0,0, ,0,0,0,0, ,0,0,0,0, ,0,0,0,0, ,0,0,0, ,0,0,0,0, 
11928,BEL,13,Janssens Marlies ,MB,7,2,2,11.63,11,7,0,12,19,36.84,2,3,2,7,-14.29,2,3,12,17,-5.88,0,0,0,0, ,2,4,6,-33.33,1,0,0,1,100.00
11928,BEL,14,De Valkeneer Lise ,OH,0,0,0, ,0,0,0,0,0, ,0,0,0,0, ,0,0,0,0, ,0,0,0,0, ,0,0,0, ,0,0,0,0, 
11928,BEL,15,Van De Vyver Jutta ,S,0,0,0, ,0,0,0,0,0, ,0,0,0,0, ,0,0,0,0, ,0,0,0,0, ,0,0,0, ,0,0,0,0, 
11928,BEL,17,Van De Vyver Ilka ,S,0,0,0,-14.81,0,0,0,3,3,0.00,0,3,1,4,-75.00,0,1,19,20,-5.00,0,0,0,0, ,9,5,14,28.57,24,1,110,135,17.04
11928,BEL,18,Rampelberg Britt ,L,0,0,0, ,0,0,0,0,0, ,0,0,0,0, ,0,0,0,0, ,14,2,6,22,54.55,20,14,35,17.14,0,0,8,8,0.00
11928,BEL,19,Van Avermaet Silke ,MB,20,1,0,41.46,21,20,0,11,31,64.52,1,1,0,2,0.00,0,3,5,8,-37.50,0,0,0,0, ,9,3,13,46.15,0,0,0,0, 
11928,BEL,21,Stragier Manon ,OH,0,0,0,0.00,0,0,0,0,0, ,0,0,0,0, ,0,0,4,4,0.00,0,0,0,0, ,0,0,0, ,0,0,1,1,0.00
11929,KOR,1,Lee Soyoung ,OH,2,0,0,-8.33,2,2,2,5,9,0.00,0,1,0,1,-100.00,0,0,2,2,0.00,7,0,11,18,38.89,3,1,5,40.00,0,0,1,1,0.00
11929,KOR,2,Lee Dahyeon ,MB,4,1,0,-8.70,5,4,2,3,9,22.22,1,5,2,8,-50.00,0,0,6,6,0.00,0,0,0,0, ,2,0,2,100.00,0,0,0,0, 
11929,KOR,3,Yeum Hye Seon ,S,0,0,2,8.33,2,0,0,0,0, ,0,0,0,0, ,2,1,9,12,8.33,0,0,0,0, ,5,2,10,30.00,31,2,47,80,36.25
11929,KOR,5,Han Dahye ,L,0,0,0, ,0,0,0,0,0, ,0,0,0,0, ,0,0,0,0, ,0,0,0,0, ,0,0,0, ,0,0,0,0, 
11929,KOR,6,Kim Dain ,S,0,0,0, ,0,0,0,0,0, ,0,0,0,0, ,0,0,0,0, ,0,0,0,0, ,1,1,2,0.00,2,0,10,12,16.67
11929,KOR,8,Park Eunjin ,MB,0,0,0,0.00,0,0,0,0,0, ,0,0,0,0, ,0,0,9,9,0.00,0,0,0,0, ,1,0,1,100.00,0,0,1,1,0.00
11929,KOR,9,Oh Jiyoung ,L,0,0,0, ,0,0,0,0,0, ,0,0,0,0, ,0,0,0,0, ,6,2,6,14,28.57,14,2,16,75.00,0,0,5,5,0.00
11929,KOR,10,Kim Yeon Koung ,OH,16,1,0,25.53,17,16,5,14,35,31.43,1,0,2,3,33.33,0,0,9,9,0.00,5,1,10,16,25.00,7,1,8,75.00,0,0,2,2,0.00
11929,KOR,12,Han Songyi ,MB,5,1,0,9.09,6,5,1,3,9,44.44,1,3,1,5,-40.00,0,0,8,8,0.00,0,0,0,0, ,0,0,0, ,0,0,3,3,0.00
11929,KOR,13,Park Jeongah ,OH,3,0,0,0.00,3,3,3,10,16,0.00,0,0,0,0, ,0,0,5,5,0.00,12,1,11,24,45.83,6,6,13,0.00,0,0,3,3,0.00
11929,KOR,14,Yang Hyo Jin ,MB,0,0,0, ,0,0,0,0,0, ,0,0,0,0, ,0,0,0,0, ,0,0,0,0, ,0,0,0, ,0,0,0,0, 
11929,KOR,15,Yuk Seoyoung ,OH,0,0,0, ,0,0,0,0,0, ,0,0,0,0, ,0,0,0,0, ,0,0,0,0, ,0,0,0, ,0,0,0,0, 
11929,KOR,16,Jeong Jiyun ,O,12,1,0,16.67,13,12,5,10,27,25.93,1,0,0,1,100.00,0,2,6,8,-25.00,0,0,0,0, ,7,2,12,41.67,0,0,4,4,0.00
11929,KOR,19,Pyo Seungju ,OH,0,0,0,-40.00,0,0,1,2,3,-33.33,0,1,0,1,-100.00,0,0,1,1,0.00,0,0,0,0, ,2,0,2,100.00,0,0,0,0, 
11929,BRA,2,De Oliveira Saad Gattaz Caroline ,MB,5,1,2,24.00,8,5,1,2,8,50.00,1,1,2,4,0.00,2,0,11,13,15.38,0,0,2,2,0.00,5,3,8,25.00,0,1,1,2,-50.00
11929,BRA,3,Rodrigues Lins Dos Santos Danielle ,S,0,0,0,0.00,0,0,0,0,0, ,0,0,0,0, ,0,0,1,1,0.00,0,0,0,0, ,0,0,0, ,1,0,3,4,25.00
11929,BRA,5,Da Silva Adenizia ,MB,2,1,0,-16.67,3,2,0,2,4,50.00,1,5,0,6,-66.67,0,0,2,2,0.00,0,0,0,0, ,1,1,2,0.00,0,0,0,0, 
11929,BRA,6,Alexandre Costa Nunes Nyeme Victoria ,L,0,0,0, ,0,0,0,0,0, ,0,0,0,0, ,0,0,0,0, ,0,0,0,0, ,0,0,0, ,0,0,0,0, 
11929,BRA,7,Montibeller Rosamaria ,OH,1,0,0,50.00,1,1,0,0,1,100.00,0,0,0,0, ,0,0,1,1,0.00,0,0,0,0, ,0,1,1,-100.00,0,0,0,0, 
11929,BRA,8,Silva Carneiro Macris Fernanda ,S,0,0,1,-11.76,1,0,0,1,1,0.00,0,3,2,5,-60.00,1,0,10,11,9.09,0,0,0,0, ,5,2,8,37.50,26,0,55,81,32.10
11929,BRA,10,Braga Guimaraes Gabriela ,OH,8,1,0,8.33,9,8,3,15,26,19.23,1,2,3,6,-16.67,0,0,16,16,0.00,3,0,12,15,20.00,9,1,11,72.73,0,0,0,0, 
11929,BRA,11,Caixeta Tandara ,OH,13,0,0,17.50,13,13,3,11,27,37.04,0,2,3,5,-40.00,0,1,7,8,-12.50,0,0,0,0, ,7,0,8,87.50,0,0,2,2,0.00
11929,BRA,13,Castro De Paula Blassioli Sheilla ,O,0,0,0, ,0,0,0,0,0, ,0,0,0,0, ,0,0,0,0, ,0,0,0,0, ,0,0,0, ,0,0,0,0, 
11929,BRA,16,Rodrigues Fernanda ,OH,10,2,1,27.03,13,10,2,9,21,38.10,2,0,0,2,100.00,1,1,12,14,0.00,4,1,17,22,13.64,6,3,11,27.27,0,0,2,2,0.00
11929,BRA,17,Menezes Oliveira de Souza Ana Cristina ,OH,0,0,0,0.00,0,0,0,0,0, ,0,0,0,0, ,0,0,2,2,0.00,0,0,0,0, ,0,1,1,-100.00,0,0,0,0, 
11929,BRA,18,Brait Camila ,L,0,0,0, ,0,0,0,0,0, ,0,0,0,0, ,0,0,0,0, ,6,1,11,18,27.78,12,1,14,78.57,0,0,3,3,0.00
11929,BRA,20,Correa Ana Beatriz ,MB,5,3,0,12.50,8,5,3,4,12,16.67,3,2,1,6,16.67,0,0,6,6,0.00,0,0,0,0, ,2,0,2,100.00,0,0,2,2,0.00
11929,BRA,28,Araujo De Souza Mayany Cristina ,MB,0,0,0, ,0,0,0,0,0, ,0,0,0,0, ,0,0,0,0, ,0,0,0,0, ,0,0,0, ,0,0,0,0, 
11930,CHN,1,Yuan Xinyue ,MB,4,2,0,0.00,6,4,0,6,10,40.00,2,6,3,11,-36.36,0,0,17,17,0.00,3,0,5,8,37.50,2,2,4,0.00,0,0,7,7,0.00
11930,CHN,2,Zhu Ting ,OH,14,1,0,30.23,15,14,0,15,29,48.28,1,2,1,4,-25.00,0,0,10,10,0.00,3,1,6,10,20.00,4,2,7,28.57,0,1,6,7,-14.29
11930,CHN,4,Yang Hanyu ,MB,0,0,0, ,0,0,0,0,0, ,0,0,0,0, ,0,0,0,0, ,0,0,0,0, ,0,0,0, ,0,0,0,0, 
11930,CHN,6,Gong Xiangyu ,O,11,2,0,32.35,13,11,0,6,17,64.71,2,2,3,7,0.00,0,0,10,10,0.00,1,0,6,7,14.29,12,2,18,55.56,0,1,2,3,-33.33
11930,CHN,7,Wang Yuanyuan ,MB,0,0,0, ,0,0,0,0,0, ,0,0,0,0, ,0,0,0,0, ,0,0,0,0, ,0,0,0, ,0,0,0,0, 
11930,CHN,9,Zhang Changning ,OH,0,0,0, ,0,0,0,0,0, ,0,0,0,0, ,0,0,0,0, ,0,0,0,0, ,0,0,0, ,0,0,0,0, 
11930,CHN,10,Liu Xiaotong ,OH,0,0,0, ,0,0,0,0,0, ,0,0,0,0, ,0,0,0,0, ,0,0,0,0, ,0,0,0, ,0,0,0,0, 
11930,CHN,11,Yao Di ,S,0,0,0, ,0,0,0,0,0, ,0,0,0,0, ,0,0,0,0, ,0,0,0,0, ,3,0,3,100.00,8,0,6,14,57.14
11930,CHN,12,Li Yingying ,OH,18,0,1,22.64,19,18,5,8,31,41.94,0,1,4,5,-20.00,1,1,15,17,0.00,2,2,7,11,0.00,7,1,10,60.00,0,0,3,3,0.00
11930,CHN,15,Lin Li ,L,0,0,0, ,0,0,0,0,0, ,0,0,0,0, ,0,0,0,0, ,0,0,0,0, ,0,0,0, ,0,0,0,0, 
11930,CHN,16,Ding Xia ,S,0,1,0,-37.50,1,0,2,1,3,-66.67,1,4,3,8,-37.50,0,1,4,5,-20.00,0,0,0,0, ,3,1,5,40.00,22,1,40,63,33.33
11930,CHN,17,Yan Ni ,MB,4,4,0,8.57,8,4,1,4,9,33.33,4,4,6,14,0.00,0,0,12,12,0.00,2,0,2,4,50.00,4,0,4,100.00,0,0,3,3,0.00
11930,CHN,18,Wang Mengjie ,L,0,0,0, ,0,0,0,0,0, ,0,0,0,0, ,0,0,0,0, ,6,1,7,14,35.71,12,1,14,78.57,0,0,0,0, 
11930,CHN,19,Liu Yanhan ,OH,0,1,0,0.00,1,0,0,3,3,0.00,1,1,3,5,0.00,0,0,2,2,0.00,0,0,0,0, ,0,0,0, ,0,0,0,0, 
11930,RUS,4,Pilipenko Daria ,L,0,0,0, ,0,0,0,0,0, ,0,0,0,0, ,0,0,0,0, ,0,0,0,0, ,0,0,0, ,0,0,0,0, 
11930,RUS,5,Fedorovtseva Arina ,OH,8,0,1,10.71,9,8,5,8,21,14.29,0,0,0,0, ,1,1,5,7,0.00,1,1,13,15,0.00,0,3,4,-75.00,0,0,0,0, 
11930,RUS,6,Koroleva Irina ,MB,3,1,1,-3.85,5,3,3,2,8,0.00,1,3,4,8,-25.00,1,0,9,10,10.00,0,0,1,1,0.00,2,1,9,11.11,0,0,1,1,0.00
11930,RUS,8,Goncharova Nataliya ,O,13,0,1,25.58,14,13,2,15,30,36.67,0,1,2,3,-33.33,1,0,9,10,10.00,0,0,0,0, ,8,2,12,50.00,0,0,7,7,0.00
11930,RUS,10,Matveeva Polina ,S,0,0,0,-75.00,0,0,0,0,0, ,0,2,0,2,-100.00,0,1,1,2,-50.00,0,0,0,0, ,0,0,0, ,0,0,23,23,0.00
11930,RUS,11,Brovkina Yulia ,MB,0,0,0, ,0,0,0,0,0, ,0,0,0,0, ,0,0,0,0, ,0,0,0,0, ,0,0,0, ,0,0,0,0, 
11930,RUS,12,Lazareva Anna ,O,1,0,0,-33.33,1,1,1,0,2,0.00,0,1,0,1,-100.00,0,0,0,0, ,0,0,0,0, ,0,0,0, ,0,0,0,0, 
11930,RUS,13,Startseva Evgeniya ,S,0,0,0,-14.29,0,0,0,0,0, ,0,1,2,3,-33.33,0,0,4,4,0.00,0,0,0,0, ,3,0,6,50.00,6,0,61,67,8.96
11930,RUS,14,Fetisova Irina ,MB,0,1,0,-14.29,1,0,1,1,2,-50.00,1,2,6,9,-11.11,0,1,9,10,-10.00,0,0,3,3,0.00,1,2,3,-33.33,0,0,0,0, 
11930,RUS,15,Kosheleva Tatyana ,OH,3,0,0,-10.53,3,3,3,8,14,0.00,0,2,0,2,-100.00,0,0,3,3,0.00,1,0,6,7,14.29,1,2,3,-33.33,0,0,0,0, 
11930,RUS,16,Voronkova Irina ,OH,12,0,1,21.43,13,12,3,14,29,31.03,0,1,4,5,-20.00,1,0,7,8,12.50,7,0,21,28,25.00,8,4,13,30.77,0,0,1,1,0.00
11930,RUS,19,Podkopaeva Anna ,L,0,0,0, ,0,0,0,0,0, ,0,0,0,0, ,0,0,0,0, ,1,0,16,17,5.88,14,3,19,57.89,0,0,6,6,0.00
11930,RUS,24,Pipunyrova Ekaterina ,OH,0,0,0,-100.00,0,0,0,0,0, ,0,0,0,0, ,0,1,0,1,-100.00,0,0,0,0, ,0,0,0, ,0,0,0,0, 
11930,RUS,25,Smirnova Kseniia ,OH,0,0,0,0.00,0,0,0,0,0, ,0,0,0,0, ,0,0,3,3,0.00,0,0,0,0, ,0,0,0, ,0,0,0,0, 
11931,POL,1,Nowicka Julia ,S,0,0,0,-33.33,0,0,0,0,0, ,0,0,0,0, ,0,1,2,3,-33.33,0,0,0,0, ,3,1,4,50.00,1,0,15,16,6.25
11931,POL,3,Alagierska Klaudia ,MB,6,0,1,23.08,7,6,1,1,8,62.50,0,0,5,5,0.00,1,0,12,13,7.69,0,0,1,1,0.00,4,0,4,100.00,0,0,0,0, 
11931,POL,5,Kakolewska Agnieszka ,MB,0,0,0,0.00,0,0,0,0,0, ,0,0,0,0, ,0,0,1,1,0.00,0,0,0,0, ,0,0,0, ,0,0,1,1,0.00
11931,POL,8,Stenzel Maria ,L,0,0,0, ,0,0,0,0,0, ,0,0,0,0, ,0,0,0,0, ,8,1,5,14,50.00,6,3,9,33.33,0,0,11,11,0.00
11931,POL,9,Stysiak Magdalena ,O,15,1,1,4.92,17,15,10,14,39,12.82,1,1,3,5,0.00,1,3,13,17,-11.76,5,3,10,18,11.11,6,3,11,27.27,0,0,1,1,0.00
11931,POL,10,Efimienko-Mlotkowska Zuzanna ,MB,5,1,0,-3.70,6,5,1,6,12,33.33,1,5,2,8,-50.00,0,1,6,7,-14.29,0,0,0,0, ,1,1,2,0.00,0,0,0,0, 
11931,POL,11,Lukasik Martyna ,O,6,1,0,-9.09,7,6,6,16,28,0.00,1,4,1,6,-50.00,0,1,9,10,-10.00,11,1,24,36,27.78,6,3,10,30.00,0,1,1,2,-50.00
11931,POL,13,Jagla Monika ,L,0,0,0, ,0,0,0,0,0, ,0,0,0,0, ,0,0,0,0, ,0,0,0,0, ,3,1,5,40.00,0,0,6,6,0.00
11931,POL,17,Smarzek Malwina ,O,7,1,0,0.00,8,7,4,7,18,16.67,1,3,5,9,-22.22,0,1,4,5,-20.00,1,0,2,3,33.33,8,1,10,70.00,0,0,3,3,0.00
11931,POL,19,Fedusio Monika ,OH,0,0,0, ,0,0,0,0,0, ,0,0,0,0, ,0,0,0,0, ,0,0,0,0, ,0,0,0, ,0,0,0,0, 
11931,POL,20,Czyrnianska Martyna ,OH,3,0,0,22.22,3,3,0,5,8,37.50,0,1,0,1,-100.00,0,0,0,0, ,0,0,1,1,0.00,1,0,1,100.00,0,0,1,1,0.00
11931,POL,26,Wenerska Katarzyna ,S,1,1,1,10.53,3,1,0,1,2,50.00,1,0,3,4,25.00,1,1,11,13,0.00,0,0,0,0, ,7,4,13,23.08,10,0,63,73,13.70
11931,POL,78,Gryka Aleksandra ,MB,0,0,0, ,0,0,0,0,0, ,0,0,0,0, ,0,0,0,0, ,0,0,0,0, ,0,0,0, ,0,0,0,0, 
11931,POL,88,Gorecka Zuzanna ,OH,0,0,0, ,0,0,0,0,0, ,0,0,0,0, ,0,0,0,0, ,0,0,0,0, ,0,0,0, ,0,0,0,0, 
11931,USA,1,Hancock Micha ,S,1,1,4,-9.09,6,1,0,1,2,50.00,1,3,1,5,-40.00,4,5,6,15,-6.67,0,0,1,1,0.00,8,0,9,88.89,14,0,77,91,15.38
11931,USA,2,Poulter Jordyn ,S,0,0,0, ,0,0,0,0,0, ,0,0,0,0, ,0,0,0,0, ,0,0,0,0, ,0,0,0, ,0,0,0,0, 
11931,USA,4,Wong-Orantes Justine ,L,0,0,0, ,0,0,0,0,0, ,0,0,0,0, ,0,0,0,0, ,5,1,11,17,23.53,17,3,21,66.67,0,0,9,9,0.00
11931,USA,6,Dixon Tetori ,MB,3,3,0,-3.70,6,3,2,4,9,11.11,3,3,2,8,0.00,0,2,8,10,-20.00,0,0,0,0, ,2,0,3,66.67,0,1,0,1,-100.00
11931,USA,10,Larson Jordan ,OH,0,0,0, ,0,0,0,0,0, ,0,0,0,0, ,0,0,0,0, ,0,0,0,0, ,0,0,0, ,0,0,0,0, 
11931,USA,11,Drews Andrea ,O,0,0,0, ,0,0,0,0,0, ,0,0,0,0, ,0,0,0,0, ,0,0,0,0, ,0,0,0, ,0,0,0,0, 
11931,USA,12,Thompson Jordan ,O,14,3,0,20.75,17,14,1,15,30,43.33,3,4,3,10,-10.00,0,1,12,13,-7.69,0,0,0,0, ,6,2,10,40.00,0,0,1,1,0.00
11931,USA,13,Wilhite Sarah ,OH,0,0,0, ,0,0,0,0,0, ,0,0,0,0, ,0,0,0,0, ,0,0,0,0, ,0,0,0, ,0,0,0,0, 
11931,USA,14,Bartsch-Hackley Michelle ,OH,14,2,1,21.43,17,14,3,16,33,33.33,2,2,2,6,0.00,1,0,16,17,5.88,11,1,17,29,34.48,10,1,12,75.00,0,0,3,3,0.00
11931,USA,15,Hill Kimberly ,OH,8,5,0,9.80,13,8,3,13,24,20.83,5,4,2,11,9.09,0,1,15,16,-6.25,3,1,10,14,14.29,9,2,14,50.00,0,0,2,2,0.00
11931,USA,16,Akinradewo Foluke ,MB,5,0,0,-6.25,5,5,1,5,11,36.36,0,6,4,10,-60.00,0,0,11,11,0.00,0,0,0,0, ,1,0,1,100.00,0,0,1,1,0.00
11931,USA,22,Washington Haleigh ,MB,0,0,0, ,0,0,0,0,0, ,0,0,0,0, ,0,0,0,0, ,0,0,0,0, ,0,0,0, ,0,0,0,0, 
11931,USA,23,Robinson Kelsey ,OH,0,0,0, ,0,0,0,0,0, ,0,0,0,0, ,0,0,0,0, ,0,0,0,0, ,0,0,0, ,0,0,0,0, 
11931,USA,24,Ogbogu Chiaka ,MB,0,0,0, ,0,0,0,0,0, ,0,0,0,0, ,0,0,0,0, ,0,0,0,0, ,0,0,0, ,0,0,0,0, 
11932,CAN,1,Bujan Cassandra ,L,0,0,0, ,0,0,0,0,0, ,0,0,0,0, ,0,0,0,0, ,2,1,13,16,6.25,10,4,15,40.00,0,0,8,8,0.00
11932,CAN,3,Van Ryk Kiera ,OH,12,2,0,7.41,14,12,8,16,36,11.11,2,1,3,6,16.67,0,1,11,12,-8.33,1,0,9,10,10.00,4,4,14,0.00,0,0,2,2,0.00
11932,CAN,5,Smith Danielle ,S,0,0,0, ,0,0,0,0,0, ,0,0,0,0, ,0,0,0,0, ,0,0,0,0, ,0,0,0, ,0,0,0,0, 
11932,CAN,6,White Jazmine  Ruth ,MB,0,0,0, ,0,0,0,0,0, ,0,0,0,0, ,0,0,0,0, ,0,0,0,0, ,0,0,0, ,0,0,0,0, 
11932,CAN,8,Ogoms Alicia ,MB,1,1,0,0.00,2,1,0,0,1,100.00,1,2,4,7,-14.29,0,0,6,6,0.00,0,0,1,1,0.00,2,2,4,0.00,0,0,0,0, 
11932,CAN,9,Gray Alexa ,OH,0,0,0, ,0,0,0,0,0, ,0,0,0,0, ,0,0,0,0, ,0,0,0,0, ,0,0,0, ,0,0,0,0, 
11932,CAN,11,Mitrovic Andrea ,OH,12,0,0,17.95,12,12,0,11,23,52.17,0,5,1,6,-83.33,0,0,10,10,0.00,1,1,15,17,0.00,4,2,8,25.00,0,0,4,4,0.00
11932,CAN,12,Cross Jennifer ,MB,5,1,0,-7.50,6,5,0,6,11,45.45,1,9,8,18,-44.44,0,0,11,11,0.00,0,0,2,2,0.00,2,1,4,25.00,0,0,2,2,0.00
11932,CAN,13,King Brie ,S,1,1,0,-12.50,2,1,0,1,2,50.00,1,4,1,6,-50.00,0,0,8,8,0.00,0,0,1,1,0.00,4,0,9,44.44,16,0,63,79,20.25
11932,CAN,14,Howe Hilary ,OH,1,0,1,-35.29,2,1,6,4,11,-45.45,0,1,0,1,-100.00,1,1,3,5,0.00,3,2,12,17,5.88,3,1,5,40.00,0,0,0,0, 
11932,CAN,15,Joseph Shainah ,O,6,0,0,28.57,6,6,0,3,9,66.67,0,2,1,3,-66.67,0,0,2,2,0.00,0,0,0,0, ,2,2,5,0.00,0,0,0,0, 
11932,CAN,16,Livingston Caroline ,OH,0,0,0,0.00,0,0,0,0,0, ,0,0,0,0, ,0,0,2,2,0.00,0,0,4,4,0.00,1,1,2,0.00,0,0,0,0, 
11932,CAN,19,Maglio Emily ,MB,3,0,0,-20.00,3,3,3,0,6,0.00,0,2,4,6,-33.33,0,1,2,3,-33.33,0,0,0,0, ,0,0,0, ,0,0,0,0, 
11932,CAN,22,Snape Kennedy Brooklyn ,L,0,0,0, ,0,0,0,0,0, ,0,0,0,0, ,0,0,0,0, ,0,0,0,0, ,0,0,0, ,0,0,0,0, 
11932,ITA,2,Bosio Francesca ,S,1,1,0,-4.00,2,1,0,0,1,100.00,1,3,2,6,-33.33,0,0,18,18,0.00,0,0,0,0, ,6,0,6,100.00,23,0,58,81,28.40
11932,ITA,4,Bonifacio Sara ,MB,5,1,1,0.00,7,5,1,6,12,33.33,1,5,6,12,-33.33,1,1,12,14,0.00,0,0,0,0, ,3,1,4,50.00,0,0,0,0, 
11932,ITA,12,Guerra Anastasia ,OH,0,0,0,-100.00,0,0,1,0,1,-100.00,0,0,0,0, ,0,0,0,0, ,2,0,0,2,100.00,1,0,1,100.00,0,0,0,0, 
11932,ITA,15,Nwakalor Sylvia Chinelo ,O,18,0,0,20.93,18,18,3,10,31,48.39,0,3,3,6,-50.00,0,3,3,6,-50.00,0,0,0,0, ,5,2,8,37.50,0,0,0,0, 
11932,ITA,19,Mingardi Camilla ,OH,0,0,0,-100.00,0,0,0,0,0, ,0,0,0,0, ,0,1,0,1,-100.00,0,0,0,0, ,0,0,0, ,0,0,0,0, 
11932,ITA,21,Lubian Marina ,MB,0,0,0, ,0,0,0,0,0, ,0,0,0,0, ,0,0,0,0, ,0,0,0,0, ,0,0,0, ,0,0,0,0, 
11932,ITA,23,De Bortoli Chiara ,L,0,0,0, ,0,0,0,0,0, ,0,0,0,0, ,0,0,0,0, ,0,0,0,0, ,0,0,0, ,0,0,0,0, 
11932,ITA,24,Mazzaro Alessia ,MB,4,2,0,10.71,6,4,1,5,10,30.00,2,2,5,9,0.00,0,0,9,9,0.00,0,0,0,0, ,2,1,4,25.00,0,0,0,0, 
11932,ITA,25,Piva Rebecca ,OH,0,0,0, ,0,0,0,0,0, ,0,0,0,0, ,0,0,0,0, ,1,0,2,3,33.33,0,0,0, ,0,0,0,0, 
11932,ITA,26,Battistoni Ilaria ,S,0,0,0, ,0,0,0,0,0, ,0,0,0,0, ,0,0,0,0, ,0,0,0,0, ,0,0,0, ,0,0,0,0, 
11932,ITA,28,Melli Giulia ,OH,9,2,0,34.48,11,9,1,8,18,44.44,2,0,0,2,100.00,0,0,9,9,0.00,4,1,20,25,12.00,7,2,10,50.00,0,0,1,1,0.00
11932,ITA,29,D'Odorico Sofia ,OH,10,0,3,13.33,13,10,2,9,21,38.10,0,4,3,7,-57.14,3,1,13,17,11.76,4,0,8,12,33.33,9,1,12,66.67,0,0,3,3,0.00
11932,ITA,31,Fersino Eleonora ,L,0,0,0, ,0,0,0,0,0, ,0,0,0,0, ,0,0,0,0, ,4,0,10,14,28.57,11,0,14,78.57,0,0,7,7,0.00
11932,ITA,32,Omoruyi Oghosasere Loveth ,OH,0,0,0, ,0,0,0,0,0, ,0,0,0,0, ,0,0,0,0, ,0,0,0,0, ,0,0,0, ,0,0,0,0, 
11933,TUR,2,Akoz Simge Sebnem ,L,0,0,0, ,0,0,0,0,0, ,0,0,0,0, ,0,0,0,0, ,6,1,3,10,50.00,19,3,23,69.57,0,0,8,8,0.00
11933,TUR,3,Ãzbay Cansu ,S,1,0,0,-12.50,1,1,0,4,5,20.00,0,1,4,5,-20.00,0,3,11,14,-21.43,0,0,0,0, ,7,2,9,55.56,8,1,83,92,7.61
11933,TUR,4,Senoglu Tugba ,OH,0,0,0, ,0,0,0,0,0, ,0,0,0,0, ,0,0,0,0, ,0,0,0,0, ,0,0,0, ,0,0,0,0, 
11933,TUR,5,Ercan Seyma ,OH,1,0,0,20.00,1,1,0,2,3,33.33,0,0,0,0, ,0,0,2,2,0.00,2,0,0,2,100.00,0,0,0, ,0,0,0,0, 
11933,TUR,6,Caliskan Kubra ,MB,0,0,0, ,0,0,0,0,0, ,0,0,0,0, ,0,0,0,0, ,0,0,0,0, ,0,0,0, ,0,0,0,0, 
11933,TUR,7,Baladin Hande ,OH,14,2,0,24.44,16,14,4,11,29,34.48,2,0,1,3,66.67,0,1,12,13,-7.69,6,1,9,16,31.25,6,2,8,50.00,0,0,2,2,0.00
11933,TUR,9,Ismailoglu Meliha ,OH,0,2,0,-4.17,2,0,1,9,10,-10.00,2,1,1,4,25.00,0,1,9,10,-10.00,10,2,18,30,26.67,10,0,12,83.33,0,0,0,0, 
11933,TUR,12,Unal Buse ,S,0,0,0,0.00,0,0,0,0,0, ,0,0,0,0, ,0,0,2,2,0.00,0,0,0,0, ,0,0,0, ,0,0,2,2,0.00
11933,TUR,13,Boz Meryem ,O,0,0,0, ,0,0,0,0,0, ,0,0,0,0, ,0,0,0,0, ,0,0,0,0, ,0,0,0, ,0,0,0,0, 
11933,TUR,14,Erdem DÃ¼ndar Eda ,MB,6,5,2,13.51,13,6,5,2,13,7.69,5,1,4,10,40.00,2,2,10,14,0.00,0,0,0,0, ,5,3,9,22.22,0,0,0,0, 
11933,TUR,16,Sahin Saliha ,OH,0,0,0, ,0,0,0,0,0, ,0,0,0,0, ,0,0,0,0, ,0,0,0,0, ,0,0,0, ,0,0,0,0, 
11933,TUR,18,Gunes Zehra ,MB,8,2,1,11.11,11,8,1,6,15,46.67,2,6,3,11,-36.36,1,0,9,10,10.00,0,0,0,0, ,4,1,5,60.00,0,0,1,1,0.00
11933,TUR,20,Cebecioglu Derya ,OH,0,0,0, ,0,0,0,0,0, ,0,0,0,0, ,0,0,0,0, ,0,0,0,0, ,0,0,0, ,0,0,0,0, 
11933,TUR,99,Karakurt Ebrar ,OH,20,0,1,30.77,21,20,4,15,39,41.03,0,1,2,3,-33.33,1,0,9,10,10.00,0,0,0,0, ,4,3,7,14.29,0,0,1,1,0.00
11933,NED,1,Knip Kirsten ,L,0,0,0, ,0,0,0,0,0, ,0,0,0,0, ,0,0,0,0, ,0,0,0,0, ,0,0,0, ,0,0,0,0, 
11933,NED,2,Savelkoel Fleur ,OH,0,0,0, ,0,0,0,0,0, ,0,0,0,0, ,0,0,0,0, ,0,0,0,0, ,0,0,0, ,0,0,0,0, 
11933,NED,4,Plak Celeste ,OH,2,0,0,-38.46,2,2,5,2,9,-33.33,0,1,0,1,-100.00,0,1,2,3,-33.33,0,0,0,0, ,2,0,2,100.00,0,0,0,0, 
11933,NED,7,Lohuis Juliet ,MB,5,0,1,11.54,6,5,0,3,8,62.50,0,2,3,5,-40.00,1,1,11,13,0.00,0,0,0,0, ,2,0,4,50.00,0,0,1,1,0.00
11933,NED,8,Korevaar Demi ,MB,0,0,0, ,0,0,0,0,0, ,0,0,0,0, ,0,0,0,0, ,0,0,0,0, ,0,0,0, ,0,0,0,0, 
11933,NED,9,Schoot Myrthe ,L,0,0,0, ,0,0,0,0,0, ,0,0,0,0, ,0,0,0,0, ,3,1,5,9,22.22,12,2,16,62.50,0,0,5,5,0.00
11933,NED,10,van Aalen Sarah ,S,0,0,0, ,0,0,0,0,0, ,0,0,0,0, ,0,0,0,0, ,0,0,0,0, ,0,0,0, ,0,0,0,0, 
11933,NED,11,Buijs Anne ,OH,2,0,1,7.14,3,2,1,5,8,12.50,0,0,0,0, ,1,1,4,6,0.00,3,0,14,17,17.65,1,1,2,0.00,0,0,0,0, 
11933,NED,12,Bongaerts Britt ,S,2,0,0,-10.53,2,2,0,0,2,100.00,0,2,3,5,-40.00,0,2,10,12,-16.67,0,0,0,0, ,5,5,10,0.00,10,0,75,85,11.76
11933,NED,17,Oude Luttikhuis Nicole ,OH,0,0,0,-100.00,0,0,0,0,0, ,0,0,0,0, ,0,1,0,1,-100.00,0,0,0,0, ,0,0,0, ,0,0,0,0, 
11933,NED,18,Jasper Marrit ,OH,8,0,0,6.06,8,8,2,11,21,28.57,0,4,2,6,-66.67,0,0,6,6,0.00,4,0,9,13,30.77,6,1,7,71.43,0,0,2,2,0.00
11933,NED,19,Daalderop Nika ,OH,7,1,1,5.56,9,7,4,8,19,15.79,1,2,3,6,-16.67,1,1,9,11,0.00,9,3,16,28,21.43,9,3,12,50.00,0,0,2,2,0.00
11933,NED,23,Timmerman Eline ,MB,7,2,0,12.50,9,7,0,8,15,46.67,2,4,4,10,-20.00,0,1,6,7,-14.29,1,0,0,1,100.00,2,0,3,66.67,0,0,2,2,0.00
11933,NED,27,Scholten Iris ,O,4,2,1,6.67,7,4,2,12,18,11.11,2,2,0,4,0.00,1,1,6,8,0.00,0,0,0,0, ,3,1,5,40.00,0,0,2,2,0.00
11934,DOM,3,Eve Mejia Lisvel Elisa ,U,0,0,0, ,0,0,0,0,0, ,0,0,0,0, ,0,0,0,0, ,0,0,0,0, ,0,0,0, ,0,0,0,0, 
11934,DOM,5,Castillo Brenda ,L,0,0,0, ,0,0,0,0,0, ,0,0,0,0, ,0,0,0,0, ,3,0,9,12,25.00,14,5,20,45.00,0,0,5,5,0.00
11934,DOM,6,Dominguez Martinez Camil Inmaculada ,S,0,0,0, ,0,0,0,0,0, ,0,0,0,0, ,0,0,0,0, ,0,0,0,0, ,0,0,0, ,1,0,6,7,14.29
11934,DOM,7,Marte Frica Niverka Dharlenis ,S,2,0,0,0.00,2,2,0,1,3,66.67,0,2,4,6,-33.33,0,0,6,6,0.00,0,0,0,0, ,2,0,3,66.67,14,0,46,60,23.33
11934,DOM,11,Rodriguez Marifranchi ,MB,3,1,0,-5.26,4,3,2,1,6,16.67,1,3,1,5,-40.00,0,0,8,8,0.00,0,0,0,0, ,2,2,4,0.00,0,0,0,0, 
11934,DOM,12,Perez Flores Yokaty ,S,0,0,0, ,0,0,0,0,0, ,0,0,0,0, ,0,0,0,0, ,0,0,0,0, ,0,0,0, ,0,0,0,0, 
11934,DOM,14,Rivera Brens Prisilla ,OH,11,1,0,27.78,12,11,1,5,17,58.82,1,1,0,2,0.00,0,0,17,17,0.00,0,0,8,8,0.00,7,2,10,50.00,0,0,2,2,0.00
11934,DOM,16,PeÃ±a Isabel Yonkaira Paola ,OH,11,1,0,15.15,12,11,7,6,24,16.67,1,0,0,1,100.00,0,0,8,8,0.00,12,0,9,21,57.14,3,2,7,14.29,0,0,3,3,0.00
11934,DOM,17,Mambru Casilla Gina Altagracia ,O,2,0,0,16.67,2,2,1,1,4,25.00,0,0,0,0, ,0,0,2,2,0.00,0,0,0,0, ,0,0,0, ,0,0,0,0, 
11934,DOM,18,De La Cruz De PeÃ±a Bethania ,OH,0,0,0, ,0,0,0,0,0, ,0,0,0,0, ,0,0,0,0, ,0,0,0,0, ,0,0,0, ,0,0,0,0, 
11934,DOM,20,Martinez Brayelin Elizabeth ,OH,0,0,0, ,0,0,0,0,0, ,0,0,0,0, ,0,0,0,0, ,0,0,0,0, ,0,0,0, ,0,0,0,0, 
11934,DOM,21,Martinez Jineiry ,MB,8,2,0,7.50,10,8,0,2,10,80.00,2,7,6,15,-33.33,0,0,15,15,0.00,0,0,1,1,0.00,6,1,7,71.43,0,0,2,2,0.00
11934,DOM,23,Gonzalez Lopez Gaila Ceneida ,O,8,0,4,18.42,12,8,4,8,20,20.00,0,0,1,1,0.00,4,1,12,17,17.65,0,0,0,0, ,7,2,10,50.00,0,0,0,0, 
11934,DOM,25,Martinez Caro Larysmer ,OH,0,0,0, ,0,0,0,0,0, ,0,0,0,0, ,0,0,0,0, ,0,0,0,0, ,0,0,0, ,0,0,0,0, 
11934,SRB,6,Uzelac Aleksandra ,OH,14,2,0,33.33,16,14,0,8,22,63.64,2,1,0,3,33.33,0,3,8,11,-27.27,11,2,18,31,29.03,4,1,5,60.00,0,0,4,4,0.00
11934,SRB,7,Jaksic Ana ,S,1,0,0,-11.11,1,1,0,1,2,50.00,0,1,0,1,-100.00,0,1,5,6,-16.67,0,0,0,0, ,4,3,7,14.29,11,1,36,48,20.83
11934,SRB,21,Kocic Jovana ,MB,1,2,0,-25.00,3,1,2,2,5,-20.00,2,5,4,11,-27.27,0,1,3,4,-25.00,0,0,0,0, ,1,0,1,100.00,0,0,1,1,0.00
11934,SRB,22,Lozo Sara ,O,0,0,0, ,0,0,0,0,0, ,0,0,0,0, ,0,0,0,0, ,0,0,0,0, ,0,0,0, ,0,0,0,0, 
11934,SRB,23,Djordjevic Mila ,S,1,0,0,-50.00,1,1,0,0,1,100.00,0,1,0,1,-100.00,0,2,0,2,-100.00,0,0,0,0, ,2,3,5,-20.00,4,0,22,26,15.38
11934,SRB,24,Medic Sofija ,MB,0,0,0, ,0,0,0,0,0, ,0,0,0,0, ,0,0,0,0, ,0,0,0,0, ,0,0,0, ,0,0,0,0, 
11934,SRB,25,Markovic Bozica ,MB,0,0,0,-33.33,0,0,1,2,3,-33.33,0,1,0,1,-100.00,0,0,2,2,0.00,0,0,0,0, ,1,0,1,100.00,0,0,0,0, 
11934,SRB,26,Savic Vanja ,O,9,0,0,10.00,9,9,2,7,18,38.89,0,2,1,3,-66.67,0,2,7,9,-22.22,0,0,0,0, ,3,1,4,50.00,0,0,1,1,0.00
11934,SRB,27,Bukilic Vanja ,O,3,0,0,0.00,3,3,2,4,9,11.11,0,0,0,0, ,0,1,2,3,-33.33,0,0,0,0, ,1,3,4,-50.00,0,0,0,0, 
11934,SRB,28,Delic Jelena ,MB,0,3,0,-6.67,3,0,2,1,3,-66.67,3,2,1,6,16.67,0,0,6,6,0.00,0,0,0,0, ,4,0,5,80.00,0,0,0,0, 
11934,SRB,31,Djurdjevic Sanja ,L,0,0,0, ,0,0,0,0,0, ,0,0,0,0, ,0,0,0,0, ,0,2,0,2,-100.00,0,0,0, ,0,0,0,0, 
11934,SRB,32,Gocanin Bojana ,L,0,0,0, ,0,0,0,0,0, ,0,0,0,0, ,0,0,0,0, ,6,0,11,17,35.29,7,4,11,27.27,0,0,5,5,0.00
11934,SRB,33,Cvetkovic Jovana ,OH,0,0,0,-20.00,0,0,0,3,3,0.00,0,0,0,0, ,0,1,1,2,-50.00,1,0,2,3,33.33,0,0,0, ,0,0,0,0, 
11934,SRB,34,Mirosavljevic Jovana ,OH,5,0,0,-2.86,5,5,4,13,22,4.55,0,1,3,4,-25.00,0,1,8,9,-11.11,5,0,14,19,26.32,3,0,3,100.00,0,0,3,3,0.00
11935,USA,1,Hancock Micha ,S,0,0,0, ,0,0,0,0,0, ,0,0,0,0, ,0,0,0,0, ,0,0,0,0, ,0,0,0, ,0,0,0,0, 
11935,USA,2,Poulter Jordyn ,S,1,0,1,0.00,2,1,0,3,4,25.00,0,2,5,7,-28.57,1,0,15,16,6.25,0,0,0,0, ,6,1,10,50.00,39,2,62,103,35.92
11935,USA,4,Wong-Orantes Justine ,L,0,0,0, ,0,0,0,0,0, ,0,0,0,0, ,0,0,0,0, ,0,0,0,0, ,0,0,0, ,0,0,0,0, 
11935,USA,6,Dixon Tetori ,MB,0,0,0, ,0,0,0,0,0, ,0,0,0,0, ,0,0,0,0, ,0,0,0,0, ,0,0,0, ,0,0,0,0, 
11935,USA,8,Tapp Hannah ,MB,0,0,0, ,0,0,0,0,0, ,0,0,0,0, ,0,0,0,0, ,0,0,0,0, ,0,0,0, ,0,0,0,0, 
11935,USA,10,Larson Jordan ,OH,15,0,4,28.57,19,15,3,13,31,38.71,0,2,1,3,-66.67,4,0,11,15,26.67,7,1,15,23,26.09,12,1,14,78.57,0,0,2,2,0.00
11935,USA,11,Drews Andrea ,O,13,1,3,4.84,17,13,5,14,32,25.00,1,7,4,12,-50.00,3,2,13,18,5.56,0,0,0,0, ,7,4,14,21.43,0,0,2,2,0.00
11935,USA,12,Thompson Jordan ,O,0,0,0, ,0,0,0,0,0, ,0,0,0,0, ,0,0,0,0, ,0,0,0,0, ,0,0,0, ,0,0,0,0, 
11935,USA,13,Wilhite Sarah ,OH,0,0,0, ,0,0,0,0,0, ,0,0,0,0, ,0,0,0,0, ,0,0,0,0, ,0,0,0, ,0,0,0,0, 
11935,USA,14,Bartsch-Hackley Michelle ,OH,0,0,0, ,0,0,0,0,0, ,0,0,0,0, ,0,0,0,0, ,0,0,0,0, ,0,0,0, ,0,0,0,0, 
11935,USA,15,Hill Kimberly ,OH,0,0,0, ,0,0,0,0,0, ,0,0,0,0, ,0,0,0,0, ,8,2,20,30,20.00,11,6,20,25.00,0,0,3,3,0.00
11935,USA,22,Washington Haleigh ,MB,13,4,1,20.75,18,13,1,6,20,60.00,4,5,9,18,-5.56,1,1,13,15,0.00,0,0,0,0, ,0,1,3,-33.33,0,0,1,1,0.00
11935,USA,23,Robinson Kelsey ,OH,11,3,2,15.52,16,11,3,17,31,25.81,3,3,3,9,0.00,2,1,15,18,5.56,13,0,10,23,56.52,10,2,16,50.00,0,0,9,9,0.00
11935,USA,24,Ogbogu Chiaka ,MB,7,2,2,-2.50,11,7,0,1,8,87.50,2,7,6,15,-33.33,2,5,10,17,-17.65,0,0,1,1,0.00,0,0,1,0.00,0,0,0,0, 
11935,RUS,4,Pilipenko Daria ,L,0,0,0, ,0,0,0,0,0, ,0,0,0,0, ,0,0,0,0, ,2,1,5,8,12.50,3,2,7,14.29,0,0,5,5,0.00
11935,RUS,5,Fedorovtseva Arina ,OH,13,0,1,13.73,14,13,3,17,33,30.30,0,1,2,3,-33.33,1,3,11,15,-13.33,9,7,19,35,5.71,6,1,8,62.50,0,0,2,2,0.00
11935,RUS,6,Koroleva Irina ,MB,7,3,0,13.89,10,7,0,2,9,77.78,3,5,9,17,-11.76,0,0,10,10,0.00,0,0,1,1,0.00,1,3,6,-33.33,0,1,0,1,-100.00
11935,RUS,8,Goncharova Nataliya ,O,12,1,0,12.77,13,12,5,14,31,22.58,1,2,4,7,-14.29,0,0,9,9,0.00,0,0,1,1,0.00,6,3,12,25.00,0,0,0,0, 
11935,RUS,10,Matveeva Polina ,S,0,0,0,-66.67,0,0,0,0,0, ,0,0,0,0, ,0,2,1,3,-66.67,0,0,1,1,0.00,0,0,0, ,0,0,12,12,0.00
11935,RUS,11,Brovkina Yulia ,MB,1,2,1,13.33,4,1,0,1,2,50.00,2,2,1,5,0.00,1,0,7,8,12.50,0,0,0,0, ,2,1,4,25.00,0,0,1,1,0.00
11935,RUS,12,Lazareva Anna ,O,1,0,0,-16.67,1,1,1,3,5,0.00,0,1,1,2,-50.00,0,1,4,5,-20.00,0,0,0,0, ,0,0,0, ,0,0,0,0, 
11935,RUS,13,Startseva Evgeniya ,S,3,1,0,9.52,4,3,1,1,5,40.00,1,1,2,4,0.00,0,0,12,12,0.00,0,0,1,1,0.00,9,5,16,25.00,12,1,73,86,12.79
11935,RUS,14,Fetisova Irina ,MB,3,1,0,4.55,4,3,0,4,7,42.86,1,3,2,6,-33.33,0,0,9,9,0.00,0,0,0,0, ,6,2,8,50.00,0,0,3,3,0.00
11935,RUS,15,Kosheleva Tatyana ,OH,2,1,0,10.00,3,2,1,3,6,16.67,1,1,0,2,0.00,0,0,2,2,0.00,1,0,6,7,14.29,0,0,0, ,0,0,0,0, 
11935,RUS,16,Voronkova Irina ,OH,12,0,1,12.82,13,12,2,10,24,41.67,0,3,2,5,-60.00,1,3,6,10,-20.00,4,1,13,18,16.67,8,3,14,35.71,0,0,5,5,0.00
11935,RUS,19,Podkopaeva Anna ,L,0,0,0, ,0,0,0,0,0, ,0,0,0,0, ,0,0,0,0, ,0,1,10,11,-9.09,6,3,10,30.00,0,0,4,4,0.00
11935,RUS,24,Pipunyrova Ekaterina ,OH,0,0,0, ,0,0,0,0,0, ,0,0,0,0, ,0,0,0,0, ,0,0,0,0, ,0,0,0, ,0,0,0,0, 
11935,RUS,25,Smirnova Kseniia ,OH,2,0,0,-10.00,2,2,0,2,4,50.00,0,2,0,2,-100.00,0,1,3,4,-25.00,1,3,3,7,-28.57,0,0,1,0.00,0,0,0,0, 
11936,JPN,1,Kurogo Ai ,OH,12,1,0,5.36,13,12,6,17,35,17.14,1,3,2,6,-33.33,0,1,14,15,-6.67,0,0,2,2,0.00,14,4,20,50.00,0,1,1,2,-50.00
11936,JPN,2,Koga Sarina ,OH,11,1,4,18.97,16,11,2,19,32,28.12,1,3,3,7,-28.57,4,0,15,19,21.05,4,2,15,21,9.52,9,2,12,58.33,0,0,2,2,0.00
11936,JPN,3,Shimamura Haruyo ,MB,12,0,1,25.71,13,12,1,9,22,50.00,0,3,3,6,-50.00,1,0,6,7,14.29,1,0,1,2,50.00,4,1,5,60.00,0,0,1,1,0.00
11936,JPN,5,Araki Erika ,MB,0,0,0, ,0,0,0,0,0, ,0,0,0,0, ,0,0,0,0, ,0,0,0,0, ,0,0,0, ,0,0,0,0, 
11936,JPN,7,Ishii Yuki ,OH,0,0,0,0.00,0,0,0,0,0, ,0,0,0,0, ,0,0,1,1,0.00,0,2,0,2,-100.00,0,0,0, ,0,0,0,0, 
11936,JPN,8,Ishikawa Mayu ,OH,16,1,0,19.61,17,16,5,16,37,29.73,1,2,1,4,-25.00,0,0,10,10,0.00,8,3,23,34,14.71,11,3,15,53.33,0,0,4,4,0.00
11936,JPN,9,Tashiro Kanami ,S,0,0,0,-14.29,0,0,0,0,0, ,0,0,0,0, ,0,1,6,7,-14.29,0,0,0,0, ,0,0,0, ,0,0,8,8,0.00
11936,JPN,11,Nabeya Yurie ,OH,0,0,0, ,0,0,0,0,0, ,0,0,0,0, ,0,0,0,0, ,0,0,0,0, ,0,0,0, ,0,0,0,0, 
11936,JPN,13,Okumura Mai ,MB,0,0,0, ,0,0,0,0,0, ,0,0,0,0, ,0,0,0,0, ,0,0,0,0, ,0,0,0, ,0,0,0,0, 
11936,JPN,14,Kobata Mako ,L,0,0,0, ,0,0,0,0,0, ,0,0,0,0, ,0,0,0,0, ,5,0,7,12,41.67,4,2,6,33.33,0,0,6,6,0.00
11936,JPN,15,Inoue Kotoe ,L,0,0,0, ,0,0,0,0,0, ,0,0,0,0, ,0,0,0,0, ,0,0,0,0, ,16,2,23,60.87,0,0,6,6,0.00
11936,JPN,19,Yamada Nichika ,MB,5,0,1,-5.71,6,5,2,3,10,30.00,0,6,2,8,-75.00,1,0,16,17,5.88,0,0,2,2,0.00,4,1,7,42.86,0,0,1,1,0.00
11936,JPN,21,Hayashi Kotona ,OH,0,0,0,0.00,0,0,0,0,0, ,0,0,0,0, ,0,0,8,8,0.00,0,0,0,0, ,1,0,1,100.00,0,0,0,0, 
11936,JPN,24,Momii Aki ,S,1,0,0,-16.67,1,1,0,2,3,33.33,0,3,2,5,-60.00,0,1,9,10,-10.00,0,0,0,0, ,12,5,18,38.89,14,2,86,102,11.76
11936,GER,1,Bock Linda ,L,0,0,0,-100.00,0,0,0,0,0, ,0,0,0,0, ,0,1,0,1,-100.00,3,0,1,4,75.00,0,0,0, ,0,0,0,0, 
11936,GER,2,KÃ¤stner Pia ,S,0,0,0,-40.00,0,0,0,1,1,0.00,0,2,1,3,-66.67,0,0,1,1,0.00,0,0,0,0, ,1,0,1,100.00,3,0,9,12,25.00
11936,GER,4,Imoudu Denise ,S,2,2,0,-12.00,4,2,1,0,3,33.33,2,4,5,11,-18.18,0,2,9,11,-18.18,0,0,0,0, ,11,1,13,76.92,39,0,66,105,37.14
11936,GER,5,Poll Jana Franziska ,OH,7,1,3,9.26,11,7,2,13,22,22.73,1,3,4,8,-25.00,3,1,20,24,8.33,10,1,15,26,34.62,12,0,12,100.00,0,0,2,2,0.00
11936,GER,8,Drewniok Kimberly ,O,1,0,0,-12.50,1,1,0,4,5,20.00,0,2,0,2,-100.00,0,0,1,1,0.00,0,0,0,0, ,2,0,2,100.00,0,0,0,0, 
11936,GER,9,Alsmeier Lina ,OH,11,0,0,13.04,11,11,1,18,30,33.33,0,1,3,4,-25.00,0,3,9,12,-25.00,19,4,22,45,33.33,8,2,12,50.00,0,0,1,1,0.00
11936,GER,10,Stigrot Lena ,OH,1,0,0,-33.33,1,1,2,3,6,-16.67,0,2,0,2,-100.00,0,0,1,1,0.00,0,0,3,3,0.00,4,1,5,60.00,0,0,3,3,0.00
11936,GER,12,Orthmann Hanna ,OH,17,2,1,9.23,20,17,6,19,42,26.19,2,5,3,10,-30.00,1,3,9,13,-15.38,0,0,0,0, ,4,2,9,22.22,0,0,1,1,0.00
11936,GER,14,SchÃ¶lzel Marie ,MB,9,5,1,18.18,15,9,1,9,19,42.11,5,6,4,15,-6.67,1,0,9,10,10.00,0,0,0,0, ,1,1,2,0.00,0,0,0,0, 
11936,GER,17,Pogany Anna ,L,0,0,0, ,0,0,0,0,0, ,0,0,0,0, ,0,0,0,0, ,6,1,5,12,41.67,18,3,23,65.22,0,0,14,14,0.00
11936,GER,20,Bock Josepha ,MB,1,1,0,100.00,2,1,0,0,1,100.00,1,0,0,1,100.00,0,0,0,0, ,0,0,0,0, ,0,0,0, ,0,0,0,0, 
11936,GER,21,Weitzel Camilla ,MB,7,2,2,5.41,11,7,1,5,13,46.15,2,5,3,10,-30.00,2,3,9,14,-7.14,0,0,1,1,0.00,0,0,0, ,0,0,0,0, 
11937,THA,2,Pannoy Piyanut ,L,0,0,0, ,0,0,0,0,0, ,0,0,0,0, ,0,0,0,0, ,10,1,4,15,60.00,6,0,9,66.67,0,0,5,5,0.00
11937,THA,3,ManaKij Sirima ,S,0,0,0, ,0,0,0,0,0, ,0,0,0,0, ,0,0,0,0, ,0,0,0,0, ,0,0,0, ,0,0,0,0, 
11937,THA,5,Thinkaow Pleumjit ,MB,10,1,2,15.22,13,10,1,11,22,40.91,1,4,7,12,-25.00,2,1,9,12,8.33,0,0,0,0, ,2,0,3,66.67,0,0,3,3,0.00
11937,THA,6,Sittirak Onuma ,OH,10,0,0,21.43,10,10,2,6,18,44.44,0,1,1,2,-50.00,0,1,7,8,-12.50,0,0,5,5,0.00,5,1,6,66.67,0,0,0,0, 
11937,THA,9,Chuewulim Sutadta ,OH,8,0,0,2.78,8,8,4,10,22,18.18,0,2,2,4,-50.00,0,1,9,10,-10.00,4,0,7,11,36.36,12,1,14,78.57,0,0,2,2,0.00
11937,THA,10,Apinyapong Wilavan ,L,0,0,0,0.00,0,0,0,0,0, ,0,0,0,0, ,0,0,3,3,0.00,0,0,4,4,0.00,4,0,4,100.00,0,0,2,2,0.00
11937,THA,11,Hyapha Amporn ,MB,0,0,0, ,0,0,0,0,0, ,0,0,0,0, ,0,0,0,0, ,0,0,0,0, ,0,0,0, ,0,0,0,0, 
11937,THA,12,Chaisri Tapaphaipun ,L,0,0,0, ,0,0,0,0,0, ,0,0,0,0, ,0,0,0,0, ,0,0,0,0, ,3,1,4,50.00,0,0,2,2,0.00
11937,THA,13,Tomkom Nootsara ,S,0,0,1,-13.33,1,0,0,1,1,0.00,0,2,3,5,-40.00,1,1,7,9,0.00,0,0,0,0, ,4,0,5,80.00,8,0,68,76,10.53
11937,THA,14,Juangjan Pattiya ,OH,0,0,0, ,0,0,0,0,0, ,0,0,0,0, ,0,0,0,0, ,0,0,0,0, ,0,0,0, ,0,0,0,0, 
11937,THA,15,Kanthong Malika ,O,13,1,2,21.15,16,13,1,6,20,60.00,1,4,6,11,-27.27,2,0,19,21,9.52,5,0,1,6,83.33,11,1,14,71.43,0,0,1,1,0.00
11937,THA,19,Krause Karina ,MB,5,0,0,12.50,5,5,0,5,10,50.00,0,1,2,3,-33.33,0,1,10,11,-9.09,0,0,1,1,0.00,2,0,2,100.00,0,0,0,0, 
11937,THA,22,Nilapa Chatsuda ,OH,0,0,0, ,0,0,0,0,0, ,0,0,0,0, ,0,0,0,0, ,0,0,0,0, ,0,0,0, ,0,0,0,0, 
11937,THA,24,Nuanjam Watchareeya ,MB,0,0,0, ,0,0,0,0,0, ,0,0,0,0, ,0,0,0,0, ,0,0,0,0, ,0,0,0, ,0,0,0,0, 
11937,CAN,1,Bujan Cassandra ,L,0,0,0, ,0,0,0,0,0, ,0,0,0,0, ,0,0,0,0, ,2,1,16,19,5.26,8,3,12,41.67,0,0,4,4,0.00
11937,CAN,3,Van Ryk Kiera ,OH,8,0,0,8.57,8,8,1,14,23,30.43,0,2,3,5,-40.00,0,2,5,7,-28.57,2,1,5,8,12.50,5,1,7,57.14,0,0,3,3,0.00
11937,CAN,7,Van Buskirk Layne ,MB,0,0,0, ,0,0,0,0,0, ,0,0,0,0, ,0,0,0,0, ,0,0,0,0, ,0,0,0, ,0,0,0,0, 
11937,CAN,8,Ogoms Alicia ,MB,0,0,0, ,0,0,0,0,0, ,0,0,0,0, ,0,0,0,0, ,0,0,0,0, ,0,0,0, ,0,0,0,0, 
11937,CAN,9,Gray Alexa ,OH,0,0,0, ,0,0,0,0,0, ,0,0,0,0, ,0,0,0,0, ,1,0,0,1,100.00,0,0,0, ,0,0,0,0, 
11937,CAN,11,Mitrovic Andrea ,OH,2,0,0,-4.76,2,2,2,8,12,0.00,0,1,0,1,-100.00,0,0,8,8,0.00,1,1,7,9,0.00,2,1,3,33.33,0,0,1,1,0.00
11937,CAN,12,Cross Jennifer ,MB,6,0,0,16.00,6,6,1,0,7,71.43,0,1,9,10,-10.00,0,0,8,8,0.00,0,0,0,0, ,2,1,3,33.33,0,0,0,0, 
11937,CAN,13,King Brie ,S,0,0,0,-50.00,0,0,1,0,1,-100.00,0,2,2,4,-50.00,0,1,2,3,-33.33,0,0,0,0, ,2,0,4,50.00,12,0,52,64,18.75
11937,CAN,14,Howe Hilary ,OH,8,1,0,-2.94,9,8,6,9,23,8.70,1,1,1,3,0.00,0,3,5,8,-37.50,1,1,19,21,0.00,4,5,11,-9.09,0,0,1,1,0.00
11937,CAN,15,Joseph Shainah ,O,1,1,0,-5.88,2,1,1,6,8,0.00,1,1,1,3,0.00,0,1,5,6,-16.67,0,0,0,0, ,2,0,2,100.00,0,0,0,0, 
11937,CAN,16,Livingston Caroline ,OH,0,0,1,0.00,1,0,0,0,0, ,0,0,0,0, ,1,1,2,4,0.00,2,0,3,5,40.00,1,1,2,0.00,0,0,0,0, 
11937,CAN,18,Robitaille Kim ,S,0,1,0,0.00,1,0,0,0,0, ,1,0,0,1,100.00,0,1,0,1,-100.00,0,0,0,0, ,0,1,1,-100.00,2,0,11,13,15.38
11937,CAN,19,Maglio Emily ,MB,11,2,0,4.65,13,11,0,7,18,61.11,2,11,6,19,-47.37,0,0,6,6,0.00,0,0,1,1,0.00,4,2,9,22.22,0,0,1,1,0.00
11937,CAN,22,Snape Kennedy Brooklyn ,L,0,0,0, ,0,0,0,0,0, ,0,0,0,0, ,0,0,0,0, ,1,1,3,5,0.00,2,0,3,66.67,0,0,2,2,0.00
11938,CHN,1,Yuan Xinyue ,MB,8,2,2,17.65,12,8,0,3,11,72.73,2,5,7,14,-21.43,2,1,6,9,11.11,0,0,0,0, ,2,2,5,0.00,0,0,0,0, 
11938,CHN,2,Zhu Ting ,OH,0,0,0, ,0,0,0,0,0, ,0,0,0,0, ,0,0,0,0, ,0,0,0,0, ,0,0,0, ,0,0,0,0, 
11938,CHN,4,Yang Hanyu ,MB,0,0,0, ,0,0,0,0,0, ,0,0,0,0, ,0,0,0,0, ,0,0,0,0, ,0,0,0, ,0,0,0,0, 
11938,CHN,6,Gong Xiangyu ,O,10,1,0,12.82,11,10,2,7,19,42.11,1,3,1,5,-40.00,0,1,14,15,-6.67,2,1,5,8,12.50,9,2,11,63.64,0,0,1,1,0.00
11938,CHN,7,Wang Yuanyuan ,MB,3,2,1,12.90,6,3,0,3,6,50.00,2,2,8,12,0.00,1,0,12,13,7.69,0,0,0,0, ,0,1,2,-50.00,0,0,2,2,0.00
11938,CHN,8,Li Yao ,OH,1,0,0,0.00,1,1,0,2,3,33.33,0,0,0,0, ,0,1,0,1,-100.00,0,0,2,2,0.00,0,0,0, ,0,0,0,0, 
11938,CHN,9,Zhang Changning ,OH,18,3,0,33.33,21,18,2,4,24,66.67,3,3,4,10,0.00,0,0,14,14,0.00,6,0,9,15,40.00,5,2,7,42.86,0,0,2,2,0.00
11938,CHN,10,Liu Xiaotong ,OH,0,0,0, ,0,0,0,0,0, ,0,0,0,0, ,0,0,0,0, ,0,0,0,0, ,0,0,0, ,0,0,0,0, 
11938,CHN,11,Yao Di ,S,0,0,0,-14.29,0,0,0,0,0, ,0,2,4,6,-33.33,0,0,8,8,0.00,0,0,0,0, ,4,1,5,60.00,18,1,39,58,29.31
11938,CHN,12,Li Yingying ,OH,17,0,1,44.44,18,17,1,5,23,69.57,0,0,1,1,0.00,1,1,10,12,0.00,7,1,14,22,27.27,4,2,7,28.57,0,0,4,4,0.00
11938,CHN,15,Lin Li ,L,0,0,0, ,0,0,0,0,0, ,0,0,0,0, ,0,0,0,0, ,1,1,6,8,0.00,3,2,5,20.00,0,0,5,5,0.00
11938,CHN,16,Ding Xia ,S,0,0,0,0.00,0,0,0,0,0, ,0,0,0,0, ,0,0,2,2,0.00,0,0,0,0, ,1,0,1,100.00,1,0,10,11,9.09
11938,CHN,18,Wang Mengjie ,L,0,0,0, ,0,0,0,0,0, ,0,0,0,0, ,0,0,0,0, ,1,0,3,4,25.00,5,2,8,37.50,0,0,5,5,0.00
11938,CHN,19,Liu Yanhan ,OH,0,0,0,0.00,0,0,0,0,0, ,0,0,0,0, ,0,0,1,1,0.00,0,0,0,0, ,0,0,0, ,0,0,0,0, 
11938,POL,1,Nowicka Julia ,S,0,0,0, ,0,0,0,0,0, ,0,0,0,0, ,0,0,0,0, ,0,0,0,0, ,1,0,1,100.00,2,0,2,4,50.00
11938,POL,3,Alagierska Klaudia ,MB,4,1,0,-6.25,5,4,3,0,7,14.29,1,2,0,3,-33.33,0,1,5,6,-16.67,0,0,1,1,0.00,2,0,2,100.00,0,0,0,0, 
11938,POL,5,Kakolewska Agnieszka ,MB,2,0,0,40.00,2,2,0,0,2,100.00,0,0,1,1,0.00,0,0,2,2,0.00,0,0,0,0, ,1,1,2,0.00,0,0,0,0, 
11938,POL,8,Stenzel Maria ,L,0,0,0, ,0,0,0,0,0, ,0,0,0,0, ,0,0,0,0, ,10,1,6,17,52.94,3,0,3,100.00,0,0,8,8,0.00
11938,POL,9,Stysiak Magdalena ,O,15,1,0,9.09,16,15,4,10,29,37.93,1,6,1,8,-62.50,0,2,5,7,-28.57,0,0,0,0, ,4,1,5,60.00,0,0,1,1,0.00
11938,POL,10,Efimienko-Mlotkowska Zuzanna ,MB,2,0,0,0.00,2,2,0,1,3,66.67,0,2,0,2,-100.00,0,0,7,7,0.00,0,0,3,3,0.00,1,0,1,100.00,0,0,2,2,0.00
11938,POL,11,Lukasik Martyna ,O,14,0,3,20.00,17,14,3,11,28,39.29,0,4,1,5,-80.00,3,0,14,17,17.65,2,1,11,14,7.14,3,4,7,-14.29,0,0,0,0, 
11938,POL,13,Jagla Monika ,L,0,0,0, ,0,0,0,0,0, ,0,0,0,0, ,0,0,0,0, ,0,0,0,0, ,9,0,10,90.00,0,0,1,1,0.00
11938,POL,19,Fedusio Monika ,OH,0,0,0, ,0,0,0,0,0, ,0,0,0,0, ,0,0,0,0, ,0,0,0,0, ,0,0,0, ,0,0,0,0, 
11938,POL,20,Czyrnianska Martyna ,OH,2,0,0,66.67,2,2,0,1,3,66.67,0,0,0,0, ,0,0,0,0, ,0,0,0,0, ,0,0,0, ,0,0,0,0, 
11938,POL,21,Druzkowska Karolina ,O,0,0,0, ,0,0,0,0,0, ,0,0,0,0, ,0,0,0,0, ,0,0,0,0, ,0,0,0, ,0,0,0,0, 
11938,POL,26,Wenerska Katarzyna ,S,0,0,0,-5.56,0,0,0,2,2,0.00,0,1,0,1,-100.00,0,0,15,15,0.00,0,0,0,0, ,4,0,4,100.00,11,0,64,75,14.67
11938,POL,30,Rozanski Olivia ,OH,0,0,0,0.00,0,0,0,2,2,0.00,0,0,1,1,0.00,0,0,0,0, ,0,0,1,1,0.00,0,0,1,0.00,0,0,0,0, 
11938,POL,88,Gorecka Zuzanna ,OH,8,0,0,5.71,8,8,1,13,22,31.82,0,4,0,4,-100.00,0,1,8,9,-11.11,14,2,19,35,34.29,4,4,9,0.00,0,0,2,2,0.00
11939,KOR,1,Lee Soyoung ,OH,9,0,0,14.71,9,9,2,11,22,31.82,0,2,1,3,-66.67,0,0,9,9,0.00,3,1,8,12,16.67,6,1,7,71.43,0,0,3,3,0.00
11939,KOR,2,Lee Dahyeon ,MB,2,1,0,50.00,3,2,0,1,3,66.67,1,0,0,1,100.00,0,0,2,2,0.00,0,0,0,0, ,0,0,0, ,0,0,1,1,0.00
11939,KOR,3,Yeum Hye Seon ,S,1,0,3,5.56,4,1,0,0,1,100.00,0,0,0,0, ,3,3,11,17,0.00,0,0,1,1,0.00,4,7,11,-27.27,5,0,89,94,5.32
11939,KOR,5,Han Dahye ,L,0,0,0, ,0,0,0,0,0, ,0,0,0,0, ,0,0,0,0, ,3,0,9,12,25.00,4,2,6,33.33,0,0,1,1,0.00
11939,KOR,6,Kim Dain ,S,0,0,0,0.00,0,0,0,0,0, ,0,0,0,0, ,0,0,1,1,0.00,0,0,0,0, ,0,0,0, ,2,0,6,8,25.00
11939,KOR,7,An Hyejin ,S,0,0,0, ,0,0,0,0,0, ,0,0,0,0, ,0,0,0,0, ,0,0,0,0, ,0,0,0, ,0,0,0,0, 
11939,KOR,8,Park Eunjin ,MB,4,1,1,0.00,6,4,2,4,10,20.00,1,2,0,3,-33.33,1,2,10,13,-7.69,0,0,0,0, ,2,0,2,100.00,0,0,2,2,0.00
11939,KOR,9,Oh Jiyoung ,L,0,0,0, ,0,0,0,0,0, ,0,0,0,0, ,0,0,0,0, ,9,4,20,33,15.15,9,7,17,11.76,0,0,5,5,0.00
11939,KOR,10,Kim Yeon Koung ,OH,10,1,1,25.71,12,10,3,8,21,33.33,1,0,0,1,100.00,1,0,12,13,7.69,3,0,3,6,50.00,3,3,6,0.00,0,0,6,6,0.00
11939,KOR,12,Han Songyi ,MB,2,0,0,-8.33,2,2,1,5,8,12.50,0,2,0,2,-100.00,0,0,2,2,0.00,1,0,0,1,100.00,2,1,3,33.33,0,0,0,0, 
11939,KOR,13,Park Jeongah ,OH,11,1,0,13.95,12,11,3,18,32,25.00,1,2,0,3,-33.33,0,1,7,8,-12.50,1,1,14,16,0.00,6,6,12,0.00,0,0,1,1,0.00
11939,KOR,14,Yang Hyo Jin ,MB,1,4,0,3.33,5,1,1,8,10,0.00,4,3,1,8,12.50,0,0,12,12,0.00,0,0,0,0, ,1,1,3,0.00,0,0,1,1,0.00
11939,KOR,16,Jeong Jiyun ,O,5,0,0,0.00,5,5,5,4,14,0.00,0,0,0,0, ,0,0,3,3,0.00,0,0,0,0, ,3,0,3,100.00,0,0,0,0, 
11939,KOR,19,Pyo Seungju ,OH,0,0,0,-20.00,0,0,0,0,0, ,0,1,0,1,-100.00,0,0,4,4,0.00,0,0,2,2,0.00,0,0,0, ,0,0,0,0, 
11939,TUR,2,Akoz Simge Sebnem ,L,0,0,0, ,0,0,0,0,0, ,0,0,0,0, ,0,0,0,0, ,8,2,12,22,27.27,10,2,12,66.67,1,0,4,5,20.00
11939,TUR,3,Ãzbay Cansu ,S,4,2,1,2.70,7,4,0,5,9,44.44,2,4,1,7,-28.57,1,2,18,21,-4.76,0,0,0,0, ,7,1,8,75.00,22,1,78,101,20.79
11939,TUR,4,Senoglu Tugba ,OH,0,0,0, ,0,0,0,0,0, ,0,0,0,0, ,0,0,0,0, ,0,0,0,0, ,0,0,0, ,0,0,0,0, 
11939,TUR,5,Ercan Seyma ,OH,0,0,0,0.00,0,0,0,0,0, ,0,0,0,0, ,0,0,2,2,0.00,0,0,0,0, ,0,0,0, ,0,0,0,0, 
11939,TUR,6,Caliskan Kubra ,MB,2,2,0,0.00,4,2,1,2,5,20.00,2,2,2,6,0.00,0,1,4,5,-20.00,0,0,0,0, ,0,0,0, ,0,0,1,1,0.00
11939,TUR,7,Baladin Hande ,OH,9,0,1,-2.22,10,9,6,12,27,11.11,0,2,1,3,-66.67,1,3,11,15,-13.33,11,0,16,27,40.74,5,4,9,11.11,0,0,0,0, 
11939,TUR,9,Ismailoglu Meliha ,OH,9,2,1,25.00,12,9,1,6,16,50.00,2,1,2,5,20.00,1,1,13,15,0.00,7,3,17,27,14.81,11,1,13,76.92,0,0,1,1,0.00
11939,TUR,12,Unal Buse ,S,0,0,0, ,0,0,0,0,0, ,0,0,0,0, ,0,0,0,0, ,0,0,1,1,0.00,1,0,1,100.00,1,0,3,4,25.00
11939,TUR,13,Boz Meryem ,O,1,0,0,33.33,1,1,0,2,3,33.33,0,0,0,0, ,0,0,0,0, ,0,0,0,0, ,0,0,0, ,0,0,0,0, 
11939,TUR,14,Erdem DÃ¼ndar Eda ,MB,11,3,2,36.11,16,11,1,4,16,62.50,3,1,1,5,40.00,2,1,12,15,6.67,0,0,1,1,0.00,4,4,8,0.00,0,0,3,3,0.00
11939,TUR,18,Gunes Zehra ,MB,8,2,1,21.43,11,8,1,0,9,77.78,2,4,3,9,-22.22,1,0,9,10,10.00,0,0,0,0, ,1,2,3,-33.33,0,0,2,2,0.00
11939,TUR,19,Kalac Asli ,MB,0,0,0, ,0,0,0,0,0, ,0,0,0,0, ,0,0,0,0, ,0,0,0,0, ,0,0,0, ,0,0,0,0, 
11939,TUR,20,Cebecioglu Derya ,OH,0,0,0, ,0,0,0,0,0, ,0,0,0,0, ,0,0,0,0, ,0,0,0,0, ,0,0,0, ,0,0,0,0, 
11939,TUR,99,Karakurt Ebrar ,OH,22,0,0,12.90,22,22,7,17,46,32.61,0,4,1,5,-80.00,0,3,8,11,-27.27,0,0,0,0, ,7,5,12,16.67,0,1,0,1,-100.00
11940,BRA,2,De Oliveira Saad Gattaz Caroline ,MB,7,0,0,14.29,7,7,0,3,10,70.00,0,3,3,6,-50.00,0,0,12,12,0.00,0,0,1,1,0.00,6,0,6,100.00,0,0,5,5,0.00
11940,BRA,5,Da Silva Adenizia ,MB,1,0,1,40.00,2,1,0,1,2,50.00,0,0,1,1,0.00,1,0,1,2,50.00,0,0,0,0, ,0,0,1,0.00,0,0,1,1,0.00
11940,BRA,6,Alexandre Costa Nunes Nyeme Victoria ,L,0,0,0, ,0,0,0,0,0, ,0,0,0,0, ,0,0,0,0, ,0,0,0,0, ,0,0,0, ,0,0,0,0, 
11940,BRA,7,Montibeller Rosamaria ,OH,0,0,0, ,0,0,0,0,0, ,0,0,0,0, ,0,0,0,0, ,0,0,0,0, ,0,0,0, ,0,0,0,0, 
11940,BRA,8,Silva Carneiro Macris Fernanda ,S,0,0,0,-17.65,0,0,0,3,3,0.00,0,3,1,4,-75.00,0,0,10,10,0.00,0,0,1,1,0.00,9,4,13,38.46,15,0,73,88,17.05
11940,BRA,9,Ratzke Roberta Silva ,S,0,0,0,0.00,0,0,0,0,0, ,0,0,0,0, ,0,0,2,2,0.00,0,0,0,0, ,1,0,1,100.00,1,0,2,3,33.33
11940,BRA,10,Braga Guimaraes Gabriela ,OH,16,0,1,30.43,17,16,3,8,27,48.15,0,0,4,4,0.00,1,0,14,15,6.67,6,1,8,15,33.33,4,3,7,14.29,0,0,1,1,0.00
11940,BRA,11,Caixeta Tandara ,OH,12,1,0,11.63,13,12,3,10,25,36.00,1,5,3,9,-44.44,0,0,9,9,0.00,0,0,0,0, ,11,3,17,47.06,0,0,0,0, 
11940,BRA,12,Pereira Natalia ,OH,1,1,0,12.50,2,1,0,3,4,25.00,1,1,1,3,0.00,0,0,1,1,0.00,0,0,0,0, ,1,0,1,100.00,0,0,0,0, 
11940,BRA,13,Castro De Paula Blassioli Sheilla ,O,2,0,0,25.00,2,2,0,1,3,66.67,0,0,0,0, ,0,1,0,1,-100.00,0,0,0,0, ,0,0,0, ,0,0,0,0, 
11940,BRA,16,Rodrigues Fernanda ,OH,6,0,0,0.00,6,6,2,17,25,16.00,0,4,4,8,-50.00,0,0,8,8,0.00,9,0,12,21,42.86,9,3,14,42.86,0,0,1,1,0.00
11940,BRA,18,Brait Camila ,L,0,0,0, ,0,0,0,0,0, ,0,0,0,0, ,0,0,0,0, ,10,0,6,16,62.50,12,2,15,66.67,0,0,7,7,0.00
11940,BRA,20,Correa Ana Beatriz ,MB,3,3,1,9.38,7,3,1,5,9,22.22,3,3,6,12,0.00,1,0,10,11,9.09,0,0,0,0, ,4,0,4,100.00,0,0,1,1,0.00
11940,BRA,28,Araujo De Souza Mayany Cristina ,MB,1,0,0,0.00,1,1,0,0,1,100.00,0,1,1,2,-50.00,0,0,2,2,0.00,0,0,0,0, ,0,0,0, ,0,0,0,0, 
11940,NED,1,Knip Kirsten ,L,0,0,0, ,0,0,0,0,0, ,0,0,0,0, ,0,0,0,0, ,0,0,0,0, ,0,0,0, ,0,0,0,0, 
11940,NED,4,Plak Celeste ,OH,15,1,1,17.86,17,15,4,16,35,31.43,1,3,4,8,-25.00,1,0,12,13,7.69,0,0,0,0, ,13,2,16,68.75,0,0,1,1,0.00
11940,NED,7,Lohuis Juliet ,MB,3,0,0,0.00,3,3,0,5,8,37.50,0,2,2,4,-50.00,0,1,5,6,-16.67,0,0,1,1,0.00,2,0,3,66.67,0,0,2,2,0.00
11940,NED,8,Korevaar Demi ,MB,2,1,0,15.38,3,2,0,3,5,40.00,1,1,1,3,0.00,0,0,5,5,0.00,0,0,0,0, ,2,1,3,33.33,0,0,0,0, 
11940,NED,9,Schoot Myrthe ,L,0,0,0, ,0,0,0,0,0, ,0,0,0,0, ,0,0,0,0, ,4,1,4,9,33.33,4,1,11,27.27,0,0,11,11,0.00
11940,NED,10,van Aalen Sarah ,S,0,0,0, ,0,0,0,0,0, ,0,0,0,0, ,0,0,0,0, ,0,0,0,0, ,0,0,0, ,1,0,5,6,16.67
11940,NED,11,Buijs Anne ,OH,6,0,0,0.00,6,6,3,6,15,20.00,0,2,1,3,-66.67,0,1,9,10,-10.00,12,2,12,26,38.46,6,5,12,8.33,0,0,2,2,0.00
11940,NED,12,Bongaerts Britt ,S,1,0,0,-25.00,1,1,1,2,4,0.00,0,1,1,2,-50.00,0,2,4,6,-33.33,0,0,0,0, ,13,3,17,58.82,17,2,65,84,17.86
11940,NED,17,Oude Luttikhuis Nicole ,OH,0,0,0, ,0,0,0,0,0, ,0,0,0,0, ,0,0,0,0, ,0,0,0,0, ,0,0,0, ,0,0,0,0, 
11940,NED,18,Jasper Marrit ,OH,2,1,0,37.50,3,2,0,2,4,50.00,1,0,2,3,33.33,0,0,1,1,0.00,3,0,4,7,42.86,1,1,2,0.00,0,0,2,2,0.00
11940,NED,19,Daalderop Nika ,OH,12,0,0,20.93,12,12,2,16,30,33.33,0,0,2,2,0.00,0,1,10,11,-9.09,13,0,16,29,44.83,4,2,11,18.18,0,0,4,4,0.00
11940,NED,21,Meijers Annick ,OH,0,0,0, ,0,0,0,0,0, ,0,0,0,0, ,0,0,0,0, ,0,0,0,0, ,0,0,0, ,0,0,0,0, 
11940,NED,23,Timmerman Eline ,MB,5,0,0,-22.86,5,5,3,6,14,14.29,0,9,4,13,-69.23,0,1,7,8,-12.50,0,0,0,0, ,0,0,1,0.00,0,0,1,1,0.00
11940,NED,27,Scholten Iris ,O,1,0,0,0.00,1,1,0,1,2,50.00,0,1,1,2,-50.00,0,0,0,0, ,0,0,0,0, ,0,0,0, ,0,0,0,0, 
11941,BEL,2,Van Sas Elise ,S,0,0,0, ,0,0,0,0,0, ,0,0,0,0, ,0,0,0,0, ,0,0,0,0, ,0,0,0, ,0,0,0,0, 
11941,BEL,3,Herbots Britt ,OH,33,1,0,22.09,34,33,10,24,67,34.33,1,4,1,6,-50.00,0,1,12,13,-7.69,6,0,11,17,35.29,4,1,6,50.00,0,0,1,1,0.00
11941,BEL,4,Lemmens Nathalie ,MB,0,0,0,-25.00,0,0,0,0,0, ,0,1,0,1,-100.00,0,0,3,3,0.00,0,0,0,0, ,0,0,0, ,0,0,1,1,0.00
11941,BEL,5,Guilliams Jodie ,OH,6,0,0,5.71,6,6,1,10,17,29.41,0,2,0,2,-100.00,0,1,15,16,-6.25,1,0,2,3,33.33,4,1,5,60.00,0,0,1,1,0.00
11941,BEL,6,Gilson Helena ,OH,0,0,0, ,0,0,0,0,0, ,0,0,0,0, ,0,0,0,0, ,0,0,0,0, ,0,0,0, ,0,0,0,0, 
11941,BEL,7,Van Gestel Celine ,OH,9,2,1,5.88,12,9,4,14,27,18.52,2,3,0,5,-20.00,1,2,16,19,-5.26,10,0,24,34,29.41,7,0,8,87.50,0,0,0,0, 
11941,BEL,9,Demeyer Nel ,L,0,0,0, ,0,0,0,0,0, ,0,0,0,0, ,0,0,0,0, ,0,0,0,0, ,0,0,0, ,0,0,0,0, 
11941,BEL,10,Sobolska Dominika ,MB,1,1,0,0.00,2,1,0,1,2,50.00,1,1,1,3,0.00,0,1,4,5,-20.00,0,0,0,0, ,0,1,1,-100.00,0,0,0,0, 
11941,BEL,13,Janssens Marlies ,MB,9,1,6,14.29,16,9,4,4,17,29.41,1,4,2,7,-42.86,6,2,10,18,22.22,0,0,2,2,0.00,2,0,2,100.00,0,0,0,0, 
11941,BEL,15,Van De Vyver Jutta ,S,0,0,0,0.00,0,0,0,1,1,0.00,0,0,0,0, ,0,0,1,1,0.00,0,0,0,0, ,0,0,0, ,0,0,2,2,0.00
11941,BEL,17,Van De Vyver Ilka ,S,0,2,1,0.00,3,0,0,1,1,0.00,2,1,5,8,12.50,1,2,13,16,-6.25,0,1,0,1,-100.00,3,5,8,-25.00,7,2,123,132,3.79
11941,BEL,18,Rampelberg Britt ,L,0,0,0, ,0,0,0,0,0, ,0,0,0,0, ,0,0,0,0, ,10,3,12,25,28.00,12,5,17,41.18,0,0,5,5,0.00
11941,BEL,19,Van Avermaet Silke ,MB,5,0,2,2.86,7,5,2,7,14,21.43,0,3,3,6,-50.00,2,1,12,15,6.67,0,0,0,0, ,6,1,7,71.43,0,0,0,0, 
11941,BEL,21,Stragier Manon ,OH,0,0,0,-100.00,0,0,0,0,0, ,0,0,0,0, ,0,1,0,1,-100.00,0,0,0,0, ,0,0,0, ,0,0,0,0, 
11941,ITA,2,Bosio Francesca ,S,0,1,1,0.00,2,0,0,1,1,0.00,1,2,1,4,-25.00,1,0,14,15,6.67,0,0,0,0, ,9,5,14,28.57,10,1,96,107,8.41
11941,ITA,4,Bonifacio Sara ,MB,5,1,1,0.00,7,5,1,5,11,36.36,1,4,0,5,-60.00,1,2,11,14,-7.14,0,0,0,0, ,0,1,1,-100.00,0,0,0,0, 
11941,ITA,12,Guerra Anastasia ,OH,7,0,0,2.78,7,7,2,12,21,23.81,0,2,0,2,-100.00,0,2,11,13,-15.38,2,3,23,28,-3.57,7,4,12,25.00,0,0,0,0, 
11941,ITA,15,Nwakalor Sylvia Chinelo ,O,19,3,0,9.09,22,19,9,13,41,24.39,3,4,0,7,-14.29,0,4,3,7,-57.14,0,0,0,0, ,6,3,9,33.33,0,0,2,2,0.00
11941,ITA,21,Lubian Marina ,MB,0,0,0,-50.00,0,0,2,1,3,-66.67,0,0,0,0, ,0,0,1,1,0.00,0,0,0,0, ,0,0,0, ,0,0,0,0, 
11941,ITA,22,Morello Rachele ,S,0,0,0,0.00,0,0,0,0,0, ,0,0,0,0, ,0,0,1,1,0.00,0,0,0,0, ,0,0,0, ,0,0,13,13,0.00
11941,ITA,23,De Bortoli Chiara ,L,0,0,0, ,0,0,0,0,0, ,0,0,0,0, ,0,0,0,0, ,1,0,2,3,33.33,2,0,2,100.00,0,0,0,0, 
11941,ITA,24,Mazzaro Alessia ,MB,9,3,1,21.28,13,9,1,5,15,53.33,3,2,1,6,16.67,1,0,25,26,3.85,0,0,0,0, ,3,3,6,0.00,0,0,2,2,0.00
11941,ITA,25,Piva Rebecca ,OH,0,0,0,0.00,0,0,0,0,0, ,0,0,0,0, ,0,0,4,4,0.00,0,0,0,0, ,1,1,2,0.00,0,0,0,0, 
11941,ITA,27,Furlan Eleonora ,MB,0,0,0, ,0,0,0,0,0, ,0,0,0,0, ,0,0,0,0, ,0,0,0,0, ,0,0,0, ,0,0,0,0, 
11941,ITA,28,Melli Giulia ,OH,2,0,0,8.33,2,2,1,7,10,10.00,0,0,0,0, ,0,0,2,2,0.00,2,2,10,14,0.00,1,0,1,100.00,0,0,2,2,0.00
11941,ITA,29,D'Odorico Sofia ,OH,10,2,1,7.69,13,10,4,24,38,15.79,2,2,0,4,0.00,1,3,6,10,-20.00,9,5,12,26,15.38,10,2,13,61.54,0,0,0,0, 
11941,ITA,31,Fersino Eleonora ,L,0,0,0, ,0,0,0,0,0, ,0,0,0,0, ,0,0,0,0, ,9,0,14,23,39.13,10,12,24,-8.33,0,1,13,14,-7.14
11941,ITA,32,Omoruyi Oghosasere Loveth ,OH,2,0,0,40.00,2,2,0,2,4,50.00,0,0,0,0, ,0,0,1,1,0.00,0,0,1,1,0.00,1,0,1,100.00,0,0,0,0, 
11942,DOM,3,Eve Mejia Lisvel Elisa ,U,7,2,1,5.56,10,7,1,4,12,50.00,2,4,6,12,-16.67,1,3,8,12,-16.67,0,0,0,0, ,3,1,7,28.57,0,0,1,1,0.00
11942,DOM,5,Castillo Brenda ,L,0,0,0, ,0,0,0,0,0, ,0,0,0,0, ,0,0,0,0, ,9,3,22,34,17.65,25,4,32,65.62,1,0,25,26,3.85
11942,DOM,6,Dominguez Martinez Camil Inmaculada ,S,0,0,0,0.00,0,0,0,0,0, ,0,0,2,2,0.00,0,0,0,0, ,0,0,0,0, ,2,0,2,100.00,1,0,15,16,6.25
11942,DOM,7,Marte Frica Niverka Dharlenis ,S,1,0,0,-9.52,1,1,1,1,3,0.00,0,1,2,3,-33.33,0,1,14,15,-6.67,0,0,0,0, ,14,6,21,38.10,10,0,88,98,10.20
11942,DOM,11,Rodriguez Marifranchi ,MB,0,0,0, ,0,0,0,0,0, ,0,0,0,0, ,0,0,0,0, ,0,0,0,0, ,0,0,0, ,0,0,0,0, 
11942,DOM,12,Perez Flores Yokaty ,S,0,0,0, ,0,0,0,0,0, ,0,0,0,0, ,0,0,0,0, ,0,0,0,0, ,0,0,0, ,0,0,0,0, 
11942,DOM,14,Rivera Brens Prisilla ,OH,11,0,2,10.71,13,11,5,17,33,18.18,0,1,2,3,-33.33,2,1,17,20,5.00,2,1,19,22,4.55,12,6,21,28.57,0,0,2,2,0.00
11942,DOM,16,PeÃ±a Isabel Yonkaira Paola ,OH,8,0,0,-4.35,8,8,7,11,26,3.85,0,2,3,5,-40.00,0,1,14,15,-6.67,4,4,10,18,0.00,5,2,8,37.50,0,0,2,2,0.00
11942,DOM,17,Mambru Casilla Gina Altagracia ,O,0,0,0, ,0,0,0,0,0, ,0,0,0,0, ,0,0,0,0, ,0,0,0,0, ,0,0,0, ,0,0,0,0, 
11942,DOM,18,De La Cruz De PeÃ±a Bethania ,OH,20,2,0,22.58,22,20,4,17,41,39.02,2,2,1,5,0.00,0,2,14,16,-12.50,2,2,10,14,0.00,15,3,18,66.67,0,0,4,4,0.00
11942,DOM,20,Martinez Brayelin Elizabeth ,OH,0,0,0,-25.00,0,0,0,2,2,0.00,0,1,1,2,-50.00,0,0,0,0, ,0,0,0,0, ,0,0,0, ,0,0,1,1,0.00
11942,DOM,21,Martinez Jineiry ,MB,7,2,0,6.67,9,7,1,9,17,35.29,2,4,8,14,-14.29,0,1,13,14,-7.14,0,0,0,0, ,3,0,3,100.00,0,0,1,1,0.00
11942,DOM,23,Gonzalez Lopez Gaila Ceneida ,O,7,0,1,13.79,8,7,1,10,18,33.33,0,0,0,0, ,1,3,7,11,-18.18,0,0,1,1,0.00,4,0,5,80.00,0,0,1,1,0.00
11942,DOM,25,Martinez Caro Larysmer ,OH,0,0,0, ,0,0,0,0,0, ,0,0,0,0, ,0,0,0,0, ,0,0,0,0, ,0,0,0, ,0,0,0,0, 
11942,GER,1,Bock Linda ,L,0,0,0,-16.67,0,0,0,0,0, ,0,0,0,0, ,0,1,5,6,-16.67,0,0,0,0, ,0,0,1,0.00,0,0,1,1,0.00
11942,GER,2,KÃ¤stner Pia ,S,0,0,0,0.00,0,0,0,0,0, ,0,0,0,0, ,0,0,2,2,0.00,0,0,0,0, ,0,0,0, ,2,0,11,13,15.38
11942,GER,4,Imoudu Denise ,S,2,2,1,-6.90,5,2,0,4,6,33.33,2,5,3,10,-30.00,1,2,10,13,-7.69,0,1,0,1,-100.00,16,4,22,54.55,22,1,88,111,18.92
11942,GER,5,Poll Jana Franziska ,OH,0,0,0, ,0,0,0,0,0, ,0,0,0,0, ,0,0,0,0, ,2,0,3,5,40.00,2,0,3,66.67,0,0,0,0, 
11942,GER,8,Drewniok Kimberly ,O,23,1,1,17.14,25,23,8,18,49,30.61,1,3,4,8,-25.00,1,2,10,13,-7.69,0,0,0,0, ,7,5,13,15.38,0,0,1,1,0.00
11942,GER,9,Alsmeier Lina ,OH,12,0,0,12.00,12,12,2,18,32,31.25,0,2,2,4,-50.00,0,2,12,14,-14.29,10,0,13,23,43.48,11,3,16,50.00,0,0,2,2,0.00
11942,GER,10,Stigrot Lena ,OH,1,0,0,0.00,1,1,0,2,3,33.33,0,1,1,2,-50.00,0,0,2,2,0.00,0,0,0,0, ,0,0,0, ,0,0,0,0, 
11942,GER,12,Orthmann Hanna ,OH,11,1,5,9.84,17,11,6,16,33,15.15,1,0,5,6,16.67,5,5,12,22,0.00,11,1,19,31,32.26,11,1,14,71.43,0,0,3,3,0.00
11942,GER,14,SchÃ¶lzel Marie ,MB,4,0,3,-6.67,7,4,1,11,16,18.75,0,8,3,11,-72.73,3,1,14,18,11.11,0,0,0,0, ,3,0,3,100.00,0,0,1,1,0.00
11942,GER,17,Pogany Anna ,L,0,0,0, ,0,0,0,0,0, ,0,0,0,0, ,0,0,0,0, ,15,2,13,30,43.33,17,5,25,48.00,0,0,21,21,0.00
11942,GER,20,Bock Josepha ,MB,0,0,0, ,0,0,0,0,0, ,0,0,0,0, ,0,0,0,0, ,0,0,0,0, ,0,0,0, ,0,0,0,0, 
11942,GER,21,Weitzel Camilla ,MB,7,5,0,12.00,12,7,0,11,18,38.89,5,3,9,17,11.76,0,3,12,15,-20.00,1,0,0,1,100.00,3,2,5,20.00,0,0,0,0, 
11943,CHN,1,Yuan Xinyue ,MB,5,2,0,10.71,7,5,0,6,11,45.45,2,2,5,9,0.00,0,2,6,8,-25.00,0,0,0,0, ,2,1,3,33.33,0,0,0,0, 
11943,CHN,2,Zhu Ting ,OH,13,1,2,38.89,16,13,1,4,18,66.67,1,1,1,3,0.00,2,0,13,15,13.33,1,0,3,4,25.00,2,4,6,-33.33,0,0,2,2,0.00
11943,CHN,4,Yang Hanyu ,MB,0,0,0, ,0,0,0,0,0, ,0,0,0,0, ,0,0,0,0, ,0,0,0,0, ,0,0,0, ,0,0,0,0, 
11943,CHN,6,Gong Xiangyu ,O,11,0,1,22.86,12,11,1,5,17,58.82,0,2,1,3,-66.67,1,1,13,15,0.00,10,0,7,17,58.82,4,4,8,0.00,0,0,4,4,0.00
11943,CHN,7,Wang Yuanyuan ,MB,0,0,0, ,0,0,0,0,0, ,0,0,0,0, ,0,0,0,0, ,0,0,0,0, ,0,0,0, ,0,0,0,0, 
11943,CHN,8,Li Yao ,OH,0,0,0, ,0,0,0,0,0, ,0,0,0,0, ,0,0,0,0, ,0,0,0,0, ,0,0,0, ,0,0,0,0, 
11943,CHN,9,Zhang Changning ,OH,10,2,1,28.57,13,10,2,11,23,34.78,2,0,0,2,100.00,1,1,8,10,0.00,4,1,5,10,30.00,3,2,5,20.00,0,0,0,0, 
11943,CHN,11,Yao Di ,S,0,0,0, ,0,0,0,0,0, ,0,0,0,0, ,0,0,0,0, ,0,0,0,0, ,0,0,0, ,0,0,0,0, 
11943,CHN,12,Li Yingying ,OH,0,0,0, ,0,0,0,0,0, ,0,0,0,0, ,0,0,0,0, ,0,0,0,0, ,0,0,0, ,0,0,0,0, 
11943,CHN,15,Lin Li ,L,0,0,0, ,0,0,0,0,0, ,0,0,0,0, ,0,0,0,0, ,0,0,0,0, ,0,0,0, ,0,0,0,0, 
11943,CHN,16,Ding Xia ,S,0,1,0,-6.25,1,0,1,1,2,-50.00,1,0,1,2,50.00,0,1,11,12,-8.33,0,0,0,0, ,4,5,9,-11.11,5,0,60,65,7.69
11943,CHN,17,Yan Ni ,MB,6,3,3,40.74,12,6,0,3,9,66.67,3,1,0,4,50.00,3,0,11,14,21.43,0,0,0,0, ,0,1,2,-50.00,0,0,0,0, 
11943,CHN,18,Wang Mengjie ,L,0,0,0, ,0,0,0,0,0, ,0,0,0,0, ,0,0,0,0, ,6,0,6,12,50.00,10,4,15,40.00,0,0,3,3,0.00
11943,CHN,19,Liu Yanhan ,OH,0,0,0, ,0,0,0,0,0, ,0,0,0,0, ,0,0,0,0, ,0,0,0,0, ,0,0,0, ,0,0,0,0, 
11943,USA,1,Hancock Micha ,S,2,0,1,-6.67,3,2,1,1,4,25.00,0,2,0,2,-100.00,1,1,7,9,0.00,0,0,0,0, ,3,4,8,-12.50,8,2,63,73,8.22
11943,USA,2,Poulter Jordyn ,S,0,0,0, ,0,0,0,0,0, ,0,0,0,0, ,0,0,0,0, ,0,0,0,0, ,0,0,0, ,0,0,0,0, 
11943,USA,4,Wong-Orantes Justine ,L,0,0,0, ,0,0,0,0,0, ,0,0,0,0, ,0,0,0,0, ,0,0,0,0, ,0,0,0, ,0,0,0,0, 
11943,USA,6,Dixon Tetori ,MB,0,0,0, ,0,0,0,0,0, ,0,0,0,0, ,0,0,0,0, ,0,0,0,0, ,0,0,0, ,0,0,0,0, 
11943,USA,8,Tapp Hannah ,MB,0,1,0,0.00,1,0,1,1,2,-50.00,1,0,2,3,33.33,0,0,4,4,0.00,0,0,0,0, ,0,2,2,-100.00,0,0,0,0, 
11943,USA,10,Larson Jordan ,OH,0,0,0, ,0,0,0,0,0, ,0,0,0,0, ,0,0,0,0, ,0,0,0,0, ,0,0,0, ,0,0,0,0, 
11943,USA,11,Drews Andrea ,O,9,2,0,22.58,11,9,3,7,19,31.58,2,1,0,3,33.33,0,0,9,9,0.00,0,0,0,0, ,1,5,6,-66.67,0,0,2,2,0.00
11943,USA,12,Thompson Jordan ,O,0,0,0, ,0,0,0,0,0, ,0,0,0,0, ,0,0,0,0, ,0,0,0,0, ,0,0,0, ,0,0,0,0, 
11943,USA,13,Wilhite Sarah ,OH,0,0,0, ,0,0,0,0,0, ,0,0,0,0, ,0,0,0,0, ,0,0,0,0, ,0,0,0, ,0,0,0,0, 
11943,USA,14,Bartsch-Hackley Michelle ,OH,7,0,0,10.71,7,7,3,9,19,21.05,0,0,0,0, ,0,1,8,9,-11.11,8,1,12,21,33.33,2,4,7,-28.57,0,0,2,2,0.00
11943,USA,15,Hill Kimberly ,OH,0,0,0, ,0,0,0,0,0, ,0,0,0,0, ,0,0,0,0, ,15,5,22,42,23.81,7,6,14,7.14,0,0,1,1,0.00
11943,USA,16,Akinradewo Foluke ,MB,7,0,0,16.67,7,7,2,2,11,45.45,0,1,0,1,-100.00,0,1,5,6,-16.67,0,0,1,1,0.00,0,0,0, ,0,0,0,0, 
11943,USA,22,Washington Haleigh ,MB,2,1,0,14.29,3,2,0,0,2,100.00,1,1,0,2,0.00,0,1,2,3,-33.33,0,0,0,0, ,0,0,0, ,0,0,0,0, 
11943,USA,23,Robinson Kelsey ,OH,9,0,0,5.71,9,9,4,12,25,20.00,0,2,0,2,-100.00,0,1,7,8,-12.50,3,1,1,5,40.00,5,2,8,37.50,0,0,3,3,0.00
11944,THA,2,Pannoy Piyanut ,L,0,0,0, ,0,0,0,0,0, ,0,0,0,0, ,0,0,0,0, ,12,0,13,25,48.00,7,2,9,55.56,0,0,5,5,0.00
11944,THA,3,ManaKij Sirima ,S,0,0,0, ,0,0,0,0,0, ,0,0,0,0, ,0,0,0,0, ,0,0,0,0, ,0,0,0, ,0,0,0,0, 
11944,THA,5,Thinkaow Pleumjit ,MB,12,3,1,14.81,16,12,2,15,29,34.48,3,5,4,12,-16.67,1,1,11,13,0.00,0,0,0,0, ,6,3,10,30.00,0,0,3,3,0.00
11944,THA,6,Sittirak Onuma ,OH,24,0,0,18.42,24,24,4,25,53,37.74,0,4,2,6,-66.67,0,2,15,17,-11.76,4,1,7,12,25.00,15,3,19,63.16,0,0,7,7,0.00
11944,THA,9,Chuewulim Sutadta ,OH,12,0,0,7.14,12,12,5,18,35,20.00,0,3,2,5,-60.00,0,0,16,16,0.00,6,2,12,20,20.00,11,4,16,43.75,0,0,3,3,0.00
11944,THA,10,Apinyapong Wilavan ,L,0,0,0, ,0,0,0,0,0, ,0,0,0,0, ,0,0,0,0, ,4,1,7,12,25.00,11,1,13,76.92,0,0,9,9,0.00
11944,THA,11,Hyapha Amporn ,MB,0,0,0,-25.00,0,0,1,1,2,-50.00,0,0,1,1,0.00,0,0,1,1,0.00,0,0,0,0, ,1,0,1,100.00,0,0,1,1,0.00
11944,THA,13,Tomkom Nootsara ,S,2,0,1,3.85,3,2,0,3,5,40.00,0,1,2,3,-33.33,1,1,16,18,0.00,0,0,0,0, ,21,3,27,66.67,22,2,129,153,13.07
11944,THA,14,Juangjan Pattiya ,OH,0,0,0, ,0,0,0,0,0, ,0,0,0,0, ,0,0,0,0, ,0,0,0,0, ,0,0,0, ,0,0,0,0, 
11944,THA,15,Kanthong Malika ,O,8,0,1,-8.57,9,8,7,24,39,2.56,0,6,6,12,-50.00,1,2,16,19,-5.26,6,2,19,27,14.81,12,1,14,78.57,0,0,2,2,0.00
11944,THA,19,Krause Karina ,MB,2,0,1,0.00,3,2,2,4,8,0.00,0,0,1,1,0.00,1,1,10,12,0.00,0,1,0,1,-100.00,4,0,5,80.00,0,0,1,1,0.00
11944,THA,20,Phomla Soraya ,S,0,0,0, ,0,0,0,0,0, ,0,0,0,0, ,0,0,0,0, ,0,0,0,0, ,0,0,0, ,0,0,0,0, 
11944,THA,22,Nilapa Chatsuda ,OH,0,0,0,0.00,0,0,0,0,0, ,0,0,0,0, ,0,0,2,2,0.00,0,0,0,0, ,0,0,0, ,0,0,0,0, 
11944,THA,24,Nuanjam Watchareeya ,MB,3,0,0,-10.53,3,3,2,4,9,11.11,0,1,5,6,-16.67,0,2,2,4,-50.00,0,0,1,1,0.00,2,0,2,100.00,0,0,0,0, 
11944,ITA,2,Bosio Francesca ,S,0,0,0, ,0,0,0,0,0, ,0,0,0,0, ,0,0,0,0, ,0,0,0,0, ,0,0,0, ,0,0,0,0, 
11944,ITA,4,Bonifacio Sara ,MB,0,0,0, ,0,0,0,0,0, ,0,0,0,0, ,0,0,0,0, ,0,0,0,0, ,0,0,0, ,0,0,0,0, 
11944,ITA,12,Guerra Anastasia ,OH,0,0,0, ,0,0,0,0,0, ,0,0,0,0, ,0,0,0,0, ,0,0,0,0, ,0,0,0, ,0,0,0,0, 
11944,ITA,15,Nwakalor Sylvia Chinelo ,O,0,0,0, ,0,0,0,0,0, ,0,0,0,0, ,0,0,0,0, ,0,0,0,0, ,0,0,0, ,0,0,0,0, 
11944,ITA,21,Lubian Marina ,MB,7,2,1,1.82,10,7,2,7,16,31.25,2,4,11,17,-11.76,1,3,18,22,-9.09,0,0,0,0, ,3,1,4,50.00,0,0,1,1,0.00
11944,ITA,22,Morello Rachele ,S,0,1,1,-2.86,2,0,0,3,3,0.00,1,3,5,9,-22.22,1,0,22,23,4.35,0,0,0,0, ,9,2,11,63.64,24,4,108,136,14.71
11944,ITA,23,De Bortoli Chiara ,L,0,0,0, ,0,0,0,0,0, ,0,0,0,0, ,0,0,0,0, ,12,1,14,27,40.74,18,6,26,46.15,1,0,14,15,6.67
11944,ITA,24,Mazzaro Alessia ,MB,0,0,0,0.00,0,0,0,0,0, ,0,0,0,0, ,0,0,3,3,0.00,0,0,0,0, ,1,0,1,100.00,0,0,0,0, 
11944,ITA,25,Piva Rebecca ,OH,4,1,2,-4.88,7,4,3,7,14,7.14,1,3,8,12,-16.67,2,3,10,15,-6.67,5,0,11,16,31.25,15,3,19,63.16,0,0,2,2,0.00
11944,ITA,27,Furlan Eleonora ,MB,11,8,1,10.71,20,11,1,6,18,55.56,8,10,10,28,-7.14,1,3,6,10,-20.00,0,0,0,0, ,6,2,8,50.00,0,0,2,2,0.00
11944,ITA,28,Melli Giulia ,OH,17,2,1,21.21,20,17,3,23,43,32.56,2,2,0,4,0.00,1,1,17,19,0.00,7,0,8,15,46.67,7,2,11,45.45,0,0,2,2,0.00
11944,ITA,29,D'Odorico Sofia ,OH,0,0,0,-100.00,0,0,0,0,0, ,0,0,0,0, ,0,1,0,1,-100.00,2,0,2,4,50.00,1,0,1,100.00,0,0,0,0, 
11944,ITA,31,Fersino Eleonora ,L,0,0,0,0.00,0,0,0,1,1,0.00,0,0,0,0, ,0,0,0,0, ,8,0,1,9,88.89,1,0,1,100.00,0,0,1,1,0.00
11944,ITA,32,Omoruyi Oghosasere Loveth ,OH,28,4,1,27.27,33,28,5,27,60,38.33,4,4,4,12,0.00,1,0,15,16,6.25,5,3,14,22,9.09,15,3,19,63.16,0,0,2,2,0.00
11945,JPN,1,Kurogo Ai ,OH,0,0,0, ,0,0,0,0,0, ,0,0,0,0, ,0,0,0,0, ,0,0,0,0, ,0,0,0, ,0,0,0,0, 
11945,JPN,2,Koga Sarina ,OH,0,0,0,0.00,0,0,0,0,0, ,0,0,0,0, ,0,0,1,1,0.00,0,0,0,0, ,0,0,0, ,0,0,0,0, 
11945,JPN,5,Araki Erika ,MB,0,0,0, ,0,0,0,0,0, ,0,0,0,0, ,0,0,0,0, ,0,0,0,0, ,0,0,0, ,0,0,0,0, 
11945,JPN,7,Ishii Yuki ,OH,12,2,0,20.45,14,12,3,17,32,28.12,2,1,0,3,33.33,0,1,8,9,-11.11,0,0,0,0, ,7,1,8,75.00,0,0,0,0, 
11945,JPN,8,Ishikawa Mayu ,OH,0,0,0, ,0,0,0,0,0, ,0,0,0,0, ,0,0,0,0, ,0,0,0,0, ,0,0,0, ,0,0,0,0, 
11945,JPN,10,Akutagawa Aika ,MB,4,2,1,12.00,7,4,2,4,10,20.00,2,1,1,4,25.00,1,1,9,11,0.00,1,0,0,1,100.00,2,2,4,0.00,0,0,0,0, 
11945,JPN,11,Nabeya Yurie ,OH,8,1,2,16.22,11,8,3,8,19,26.32,1,0,0,1,100.00,2,2,13,17,0.00,8,1,9,18,38.89,7,2,9,55.56,0,0,0,0, 
11945,JPN,13,Okumura Mai ,MB,3,1,2,12.00,6,3,1,1,5,40.00,1,2,2,5,-20.00,2,0,13,15,13.33,0,0,1,1,0.00,1,2,3,-33.33,0,0,2,2,0.00
11945,JPN,14,Kobata Mako ,L,0,0,0, ,0,0,0,0,0, ,0,0,0,0, ,0,0,0,0, ,0,0,0,0, ,6,1,7,71.43,0,0,2,2,0.00
11945,JPN,15,Inoue Kotoe ,L,0,0,0, ,0,0,0,0,0, ,0,0,0,0, ,0,0,0,0, ,6,0,4,10,60.00,4,0,4,100.00,0,0,6,6,0.00
11945,JPN,19,Yamada Nichika ,MB,0,0,0, ,0,0,0,0,0, ,0,0,0,0, ,0,0,0,0, ,0,0,0,0, ,0,0,0, ,0,0,0,0, 
11945,JPN,20,Seki Nanami ,S,2,1,1,18.18,4,2,0,0,2,100.00,1,1,0,2,0.00,1,1,5,7,0.00,0,0,1,1,0.00,5,0,6,83.33,2,1,83,86,1.16
11945,JPN,21,Hayashi Kotona ,OH,12,0,1,11.36,13,12,6,12,30,20.00,0,0,1,1,0.00,1,2,10,13,-7.69,6,1,6,13,38.46,6,1,7,71.43,0,0,1,1,0.00
11945,JPN,24,Momii Aki ,S,0,0,0, ,0,0,0,0,0, ,0,0,0,0, ,0,0,0,0, ,0,0,0,0, ,0,0,0, ,0,0,0,0, 
11945,SRB,6,Uzelac Aleksandra ,OH,1,1,0,-8.00,2,1,4,13,18,-16.67,1,0,0,1,100.00,0,0,6,6,0.00,3,1,7,11,18.18,1,0,1,100.00,0,0,0,0, 
11945,SRB,7,Jaksic Ana ,S,0,1,0,-20.00,1,0,0,0,0, ,1,2,1,4,-25.00,0,0,1,1,0.00,0,0,0,0, ,0,0,0, ,1,0,20,21,4.76
11945,SRB,21,Kocic Jovana ,MB,4,3,0,15.00,7,4,2,2,8,25.00,3,2,0,5,20.00,0,0,7,7,0.00,0,0,0,0, ,2,0,2,100.00,0,0,0,0, 
11945,SRB,22,Lozo Sara ,O,6,1,0,12.50,7,6,2,9,17,23.53,1,1,0,2,0.00,0,1,4,5,-20.00,14,5,17,36,25.00,1,4,5,-60.00,0,0,5,5,0.00
11945,SRB,23,Djordjevic Mila ,S,3,2,0,-13.04,5,3,0,1,4,75.00,2,6,2,10,-40.00,0,2,7,9,-22.22,0,0,0,0, ,4,3,7,14.29,2,0,55,57,3.51
11945,SRB,24,Medic Sofija ,MB,0,0,0,-33.33,0,0,1,1,2,-50.00,0,0,0,0, ,0,0,1,1,0.00,0,0,0,0, ,0,0,0, ,0,0,0,0, 
11945,SRB,25,Markovic Bozica ,MB,2,0,0,-9.09,2,2,1,4,7,14.29,0,0,0,0, ,0,2,2,4,-50.00,0,0,0,0, ,0,0,0, ,0,0,0,0, 
11945,SRB,26,Savic Vanja ,O,6,0,1,-5.00,7,6,6,14,26,0.00,0,2,0,2,-100.00,1,1,10,12,0.00,0,0,0,0, ,4,4,8,0.00,0,0,2,2,0.00
11945,SRB,27,Bukilic Vanja ,O,0,0,0, ,0,0,0,0,0, ,0,0,0,0, ,0,0,0,0, ,0,0,0,0, ,0,0,0, ,0,0,0,0, 
11945,SRB,28,Delic Jelena ,MB,0,0,0, ,0,0,0,0,0, ,0,0,0,0, ,0,0,0,0, ,0,0,0,0, ,0,0,0, ,0,0,0,0, 
11945,SRB,31,Djurdjevic Sanja ,L,0,0,0, ,0,0,0,0,0, ,0,0,0,0, ,0,0,0,0, ,1,0,4,5,20.00,6,3,9,33.33,0,0,5,5,0.00
11945,SRB,32,Gocanin Bojana ,L,0,0,0, ,0,0,0,0,0, ,0,0,0,0, ,0,0,0,0, ,2,0,0,2,100.00,3,1,4,50.00,0,0,1,1,0.00
11945,SRB,33,Cvetkovic Jovana ,OH,0,0,0,-16.67,0,0,0,4,4,0.00,0,0,0,0, ,0,1,1,2,-50.00,2,0,6,8,25.00,1,0,1,100.00,0,0,0,0, 
11945,SRB,34,Mirosavljevic Jovana ,OH,0,0,1,-7.14,1,0,1,7,8,-12.50,0,1,1,2,-50.00,1,0,3,4,25.00,0,1,3,4,-25.00,0,2,3,-66.67,0,0,0,0, 
11946,RUS,4,Pilipenko Daria ,L,0,0,0, ,0,0,0,0,0, ,0,0,0,0, ,0,0,0,0, ,3,2,12,17,5.88,6,2,9,44.44,0,0,5,5,0.00
11946,RUS,5,Fedorovtseva Arina ,OH,15,0,2,3.28,17,15,9,8,32,18.75,0,4,2,6,-66.67,2,2,19,23,0.00,13,3,20,36,27.78,1,3,6,-33.33,0,0,2,2,0.00
11946,RUS,6,Koroleva Irina ,MB,11,5,1,29.27,17,11,2,4,17,52.94,5,3,8,16,12.50,1,0,7,8,12.50,0,0,1,1,0.00,0,2,4,-50.00,0,0,1,1,0.00
11946,RUS,8,Goncharova Nataliya ,O,0,0,0, ,0,0,0,0,0, ,0,0,0,0, ,0,0,0,0, ,0,0,0,0, ,0,0,0, ,0,0,0,0, 
11946,RUS,10,Matveeva Polina ,S,1,1,0,0.00,2,1,0,0,1,100.00,1,1,1,3,0.00,0,1,7,8,-12.50,0,0,0,0, ,4,4,9,0.00,9,0,34,43,20.93
11946,RUS,11,Brovkina Yulia ,MB,5,2,0,6.90,7,5,1,2,8,50.00,2,3,4,9,-11.11,0,1,11,12,-8.33,1,0,0,1,100.00,1,0,1,100.00,0,0,1,1,0.00
11946,RUS,12,Lazareva Anna ,O,7,2,0,7.14,9,7,6,6,19,5.26,2,0,1,3,66.67,0,1,5,6,-16.67,0,0,0,0, ,3,2,5,20.00,0,0,1,1,0.00
11946,RUS,13,Startseva Evgeniya ,S,0,0,0,-25.00,0,0,0,1,1,0.00,0,0,0,0, ,0,1,2,3,-33.33,0,0,0,0, ,5,3,8,25.00,12,1,54,67,16.42
11946,RUS,14,Fetisova Irina ,MB,1,1,0,11.11,2,1,0,1,2,50.00,1,1,1,3,0.00,0,0,4,4,0.00,0,0,0,0, ,0,0,0, ,0,0,0,0, 
11946,RUS,15,Kosheleva Tatyana ,OH,1,2,1,7.69,4,1,1,3,5,0.00,2,1,0,3,33.33,1,1,3,5,0.00,2,0,10,12,16.67,0,1,1,-100.00,0,0,1,1,0.00
11946,RUS,16,Voronkova Irina ,OH,10,2,1,11.63,13,10,6,11,27,14.81,2,2,3,7,0.00,1,0,8,9,11.11,6,3,18,27,11.11,3,1,5,40.00,0,0,0,0, 
11946,RUS,19,Podkopaeva Anna ,L,0,0,0, ,0,0,0,0,0, ,0,0,0,0, ,0,0,0,0, ,2,0,4,6,33.33,11,3,15,53.33,0,0,6,6,0.00
11946,RUS,24,Pipunyrova Ekaterina ,OH,0,0,0,-50.00,0,0,0,0,0, ,0,0,0,0, ,0,1,1,2,-50.00,0,0,0,0, ,0,0,0, ,0,0,0,0, 
11946,RUS,25,Smirnova Kseniia ,OH,5,0,1,-6.25,6,5,5,8,18,0.00,0,1,2,3,-33.33,1,2,8,11,-9.09,2,0,1,3,66.67,3,0,3,100.00,0,0,1,1,0.00
11946,POL,1,Nowicka Julia ,S,0,0,0,0.00,0,0,0,1,1,0.00,0,0,0,0, ,0,0,7,7,0.00,0,0,0,0, ,3,0,3,100.00,2,0,5,7,28.57
11946,POL,3,Alagierska Klaudia ,MB,0,2,2,4.76,4,0,3,2,5,-60.00,2,0,1,3,66.67,2,0,11,13,15.38,0,0,0,0, ,3,1,4,50.00,0,0,1,1,0.00
11946,POL,5,Kakolewska Agnieszka ,MB,2,7,1,38.10,10,2,0,1,3,66.67,7,2,1,10,50.00,1,0,7,8,12.50,0,0,0,0, ,2,1,5,20.00,0,0,0,0, 
11946,POL,8,Stenzel Maria ,L,0,0,0, ,0,0,0,0,0, ,0,0,0,0, ,0,0,0,0, ,12,3,13,28,32.14,5,0,5,100.00,0,0,7,7,0.00
11946,POL,9,Stysiak Magdalena ,O,25,1,0,20.31,26,25,10,19,54,27.78,1,2,1,4,-25.00,0,1,5,6,-16.67,0,0,0,0, ,6,2,12,33.33,0,0,1,1,0.00
11946,POL,10,Efimienko-Mlotkowska Zuzanna ,MB,5,3,0,9.68,8,5,1,2,8,50.00,3,4,5,12,-8.33,0,0,11,11,0.00,0,0,0,0, ,3,1,4,50.00,0,0,0,0, 
11946,POL,11,Lukasik Martyna ,O,8,3,3,12.77,14,8,4,6,18,22.22,3,3,0,6,0.00,3,1,19,23,8.70,11,2,16,29,31.03,10,2,12,66.67,0,0,2,2,0.00
11946,POL,13,Jagla Monika ,L,0,0,0, ,0,0,0,0,0, ,0,0,0,0, ,0,0,0,0, ,0,0,0,0, ,9,0,11,81.82,0,0,5,5,0.00
11946,POL,19,Fedusio Monika ,OH,0,0,0, ,0,0,0,0,0, ,0,0,0,0, ,0,0,0,0, ,0,0,0,0, ,0,0,0, ,0,0,0,0, 
11946,POL,20,Czyrnianska Martyna ,OH,4,0,0,33.33,4,4,1,4,9,33.33,0,0,0,0, ,0,0,0,0, ,0,0,0,0, ,0,0,0, ,0,0,1,1,0.00
11946,POL,26,Wenerska Katarzyna ,S,1,0,1,-9.09,2,1,0,1,2,50.00,0,4,2,6,-66.67,1,1,23,25,0.00,0,0,0,0, ,1,2,3,-33.33,23,1,72,96,22.92
11946,POL,30,Rozanski Olivia ,OH,0,0,0, ,0,0,0,0,0, ,0,0,0,0, ,0,0,0,0, ,0,0,0,0, ,0,0,0, ,0,0,0,0, 
11946,POL,78,Gryka Aleksandra ,MB,0,0,0, ,0,0,0,0,0, ,0,0,0,0, ,0,0,0,0, ,0,0,0,0, ,0,0,0, ,0,0,0,0, 
11946,POL,88,Gorecka Zuzanna ,OH,13,3,1,18.00,17,13,4,10,27,33.33,3,4,3,10,-10.00,1,0,12,13,7.69,5,1,18,24,16.67,7,3,12,33.33,1,0,2,3,33.33
11947,KOR,1,Lee Soyoung ,OH,16,1,1,8.20,18,16,8,17,41,19.51,1,2,1,4,-25.00,1,3,12,16,-12.50,4,2,14,20,10.00,10,0,15,66.67,0,0,1,1,0.00
11947,KOR,2,Lee Dahyeon ,MB,1,0,0,100.00,1,1,0,0,1,100.00,0,0,0,0, ,0,0,0,0, ,0,0,0,0, ,0,0,0, ,0,0,0,0, 
11947,KOR,3,Yeum Hye Seon ,S,0,0,0,-21.43,0,0,0,1,1,0.00,0,1,0,1,-100.00,0,2,10,12,-16.67,0,0,1,1,0.00,4,1,9,33.33,9,1,68,78,10.26
11947,KOR,5,Han Dahye ,L,0,0,0, ,0,0,0,0,0, ,0,0,0,0, ,0,0,0,0, ,0,0,0,0, ,0,0,0, ,0,0,0,0, 
11947,KOR,6,Kim Dain ,S,0,1,0,-30.00,1,0,0,0,0, ,1,2,1,4,-25.00,0,2,4,6,-33.33,0,0,1,1,0.00,11,0,12,91.67,7,0,54,61,11.48
11947,KOR,7,An Hyejin ,S,0,0,0, ,0,0,0,0,0, ,0,0,0,0, ,0,0,0,0, ,0,0,0,0, ,0,0,0, ,0,0,0,0, 
11947,KOR,8,Park Eunjin ,MB,0,0,1,-16.67,1,0,1,4,5,-20.00,0,3,4,7,-42.86,1,0,5,6,16.67,0,0,0,0, ,1,1,3,0.00,0,0,0,0, 
11947,KOR,9,Oh Jiyoung ,L,0,0,0, ,0,0,0,0,0, ,0,0,0,0, ,0,0,0,0, ,15,1,24,40,35.00,18,3,21,71.43,0,0,11,11,0.00
11947,KOR,10,Kim Yeon Koung ,OH,19,0,1,20.00,20,19,3,24,46,34.78,0,2,4,6,-33.33,1,1,16,18,0.00,4,1,24,29,10.34,12,4,18,44.44,0,0,9,9,0.00
11947,KOR,12,Han Songyi ,MB,5,2,0,12.00,7,5,1,0,6,66.67,2,3,2,7,-14.29,0,0,12,12,0.00,0,0,0,0, ,2,2,4,0.00,0,0,1,1,0.00
11947,KOR,13,Park Jeongah ,OH,24,0,0,14.29,24,24,5,29,58,32.76,0,5,1,6,-83.33,0,3,10,13,-23.08,1,0,7,8,12.50,11,0,13,84.62,0,0,3,3,0.00
11947,KOR,14,Yang Hyo Jin ,MB,5,5,0,-2.13,10,5,1,3,9,44.44,5,9,7,21,-19.05,0,1,16,17,-5.88,0,0,0,0, ,4,0,4,100.00,0,0,4,4,0.00
11947,KOR,16,Jeong Jiyun ,O,0,0,0, ,0,0,0,0,0, ,0,0,0,0, ,0,0,0,0, ,0,0,0,0, ,0,0,0, ,0,0,0,0, 
11947,KOR,19,Pyo Seungju ,OH,0,0,0,0.00,0,0,0,2,2,0.00,0,0,0,0, ,0,0,1,1,0.00,0,0,2,2,0.00,0,0,0, ,0,0,0,0, 
11947,NED,1,Knip Kirsten ,L,0,0,0, ,0,0,0,0,0, ,0,0,0,0, ,0,0,0,0, ,0,0,0,0, ,0,0,0, ,0,0,0,0, 
11947,NED,2,Savelkoel Fleur ,OH,0,0,0, ,0,0,0,0,0, ,0,0,0,0, ,0,0,0,0, ,0,0,0,0, ,0,0,0, ,0,0,0,0, 
11947,NED,4,Plak Celeste ,OH,3,0,0,-13.04,3,3,1,6,10,20.00,0,4,1,5,-80.00,0,1,7,8,-12.50,0,0,0,0, ,3,1,4,50.00,0,0,0,0, 
11947,NED,7,Lohuis Juliet ,MB,5,0,1,-6.25,6,5,0,2,7,71.43,0,6,5,11,-54.55,1,2,11,14,-7.14,0,0,0,0, ,3,0,3,100.00,0,0,2,2,0.00
11947,NED,8,Korevaar Demi ,MB,1,1,0,10.00,2,1,1,1,3,0.00,1,0,1,2,50.00,0,0,5,5,0.00,0,0,0,0, ,0,0,0, ,0,0,0,0, 
11947,NED,9,Schoot Myrthe ,L,0,0,0, ,0,0,0,0,0, ,0,0,0,0, ,0,0,0,0, ,2,0,4,6,33.33,18,7,31,35.48,0,0,10,10,0.00
11947,NED,10,van Aalen Sarah ,S,0,0,0, ,0,0,0,0,0, ,0,0,0,0, ,0,0,0,0, ,0,0,0,0, ,0,0,0, ,0,0,0,0, 
11947,NED,11,Buijs Anne ,OH,14,1,0,7.55,15,14,6,11,31,25.81,1,4,3,8,-37.50,0,1,13,14,-7.14,14,1,21,36,36.11,9,4,16,31.25,0,0,1,1,0.00
11947,NED,12,Bongaerts Britt ,S,4,0,1,-7.32,5,4,0,4,8,50.00,0,8,11,19,-42.11,1,0,13,14,7.14,0,0,0,0, ,9,2,12,58.33,35,0,94,129,27.13
11947,NED,18,Jasper Marrit ,OH,0,0,0,-16.67,0,0,1,0,1,-100.00,0,0,0,0, ,0,0,5,5,0.00,4,0,2,6,66.67,3,1,6,33.33,0,0,1,1,0.00
11947,NED,19,Daalderop Nika ,OH,28,2,0,21.59,30,28,7,30,65,32.31,2,2,4,8,0.00,0,2,13,15,-13.33,10,1,27,38,23.68,12,4,18,44.44,0,0,4,4,0.00
11947,NED,21,Meijers Annick ,OH,0,0,0, ,0,0,0,0,0, ,0,0,0,0, ,0,0,0,0, ,0,0,0,0, ,0,0,0, ,0,0,0,0, 
11947,NED,23,Timmerman Eline ,MB,8,4,1,0.00,13,8,1,7,16,43.75,4,10,9,23,-26.09,1,2,12,15,-6.67,1,0,1,2,50.00,5,1,9,44.44,0,0,0,0, 
11947,NED,27,Scholten Iris ,O,9,0,1,10.20,10,9,2,8,19,36.84,0,3,8,11,-27.27,1,0,18,19,5.26,0,1,0,1,-100.00,4,2,9,22.22,0,0,3,3,0.00
11948,BEL,2,Van Sas Elise ,S,0,1,1,16.67,2,0,0,0,0, ,1,0,1,2,50.00,1,1,2,4,0.00,0,0,0,0, ,1,0,2,50.00,2,0,10,12,16.67
11948,BEL,3,Herbots Britt ,OH,23,0,3,25.81,26,23,3,17,43,46.51,0,4,1,5,-80.00,3,3,8,14,0.00,2,0,10,12,16.67,14,1,15,86.67,0,0,2,2,0.00
11948,BEL,4,Lemmens Nathalie ,MB,0,0,0, ,0,0,0,0,0, ,0,0,0,0, ,0,0,0,0, ,0,0,0,0, ,0,0,0, ,0,0,0,0, 
11948,BEL,5,Guilliams Jodie ,OH,1,0,0,-21.43,1,1,0,3,4,25.00,0,2,4,6,-33.33,0,2,2,4,-50.00,1,0,0,1,100.00,1,0,1,100.00,0,0,2,2,0.00
11948,BEL,6,Gilson Helena ,OH,0,0,0, ,0,0,0,0,0, ,0,0,0,0, ,0,0,0,0, ,0,0,0,0, ,0,0,0, ,0,0,0,0, 
11948,BEL,7,Van Gestel Celine ,OH,12,0,2,23.91,14,12,2,12,26,38.46,0,1,6,7,-14.29,2,0,11,13,15.38,5,0,15,20,25.00,11,1,13,76.92,0,0,1,1,0.00
11948,BEL,9,Demeyer Nel ,L,0,0,0, ,0,0,0,0,0, ,0,0,0,0, ,0,0,0,0, ,0,0,0,0, ,0,0,0, ,0,0,0,0, 
11948,BEL,10,Sobolska Dominika ,MB,1,0,2,-4.35,3,1,0,2,3,33.33,0,4,6,10,-40.00,2,0,8,10,20.00,0,0,0,0, ,5,1,7,57.14,0,0,1,1,0.00
11948,BEL,13,Janssens Marlies ,MB,4,2,2,5.71,8,4,2,5,11,18.18,2,4,5,11,-18.18,2,0,11,13,15.38,0,0,0,0, ,2,4,7,-28.57,0,0,0,0, 
11948,BEL,15,Van De Vyver Jutta ,S,0,0,0, ,0,0,0,0,0, ,0,0,0,0, ,0,0,0,0, ,0,0,0,0, ,0,0,0, ,0,0,0,0, 
11948,BEL,17,Van De Vyver Ilka ,S,0,0,1,-8.33,1,0,0,0,0, ,0,2,3,5,-40.00,1,0,6,7,14.29,0,0,0,0, ,4,1,7,42.86,9,0,66,75,12.00
11948,BEL,18,Rampelberg Britt ,L,0,0,0, ,0,0,0,0,0, ,0,0,0,0, ,0,0,0,0, ,4,3,10,17,5.88,14,2,18,66.67,0,0,6,6,0.00
11948,BEL,19,Van Avermaet Silke ,MB,4,1,0,15.00,5,4,1,5,10,30.00,1,1,0,2,0.00,0,0,8,8,0.00,0,1,0,1,-100.00,1,1,3,0.00,0,0,0,0, 
11948,BEL,21,Stragier Manon ,OH,0,0,0,-50.00,0,0,0,0,0, ,0,0,0,0, ,0,1,1,2,-50.00,0,0,0,0, ,0,1,1,-100.00,0,0,0,0, 
11948,CAN,1,Bujan Cassandra ,L,0,0,0, ,0,0,0,0,0, ,0,0,0,0, ,0,0,0,0, ,2,1,6,9,11.11,9,2,11,63.64,0,0,6,6,0.00
11948,CAN,3,Van Ryk Kiera ,OH,15,0,3,13.33,18,15,2,10,27,48.15,0,5,1,6,-83.33,3,5,4,12,-16.67,5,0,8,13,38.46,9,2,11,63.64,0,0,2,2,0.00
11948,CAN,5,Smith Danielle ,S,0,0,0,-100.00,0,0,0,0,0, ,0,2,0,2,-100.00,0,0,0,0, ,0,0,0,0, ,4,0,4,100.00,4,0,8,12,33.33
11948,CAN,7,Van Buskirk Layne ,MB,0,0,0, ,0,0,0,0,0, ,0,0,0,0, ,0,0,0,0, ,0,0,0,0, ,0,0,0, ,0,0,0,0, 
11948,CAN,8,Ogoms Alicia ,MB,0,0,0, ,0,0,0,0,0, ,0,0,0,0, ,0,0,0,0, ,0,0,0,0, ,0,0,0, ,0,0,0,0, 
11948,CAN,9,Gray Alexa ,OH,0,0,0, ,0,0,0,0,0, ,0,0,0,0, ,0,0,0,0, ,0,0,1,1,0.00,2,0,2,100.00,0,0,0,0, 
11948,CAN,11,Mitrovic Andrea ,OH,7,1,0,11.43,8,7,3,13,23,17.39,1,1,3,5,0.00,0,0,7,7,0.00,5,3,16,24,8.33,4,0,4,100.00,0,0,4,4,0.00
11948,CAN,12,Cross Jennifer ,MB,3,2,0,0.00,5,3,1,4,8,25.00,2,4,4,10,-20.00,0,0,11,11,0.00,0,0,0,0, ,3,1,5,40.00,0,0,2,2,0.00
11948,CAN,13,King Brie ,S,1,1,1,14.29,3,1,0,3,4,25.00,1,1,1,3,0.00,1,0,6,7,14.29,0,0,0,0, ,8,1,10,70.00,19,1,48,68,26.47
11948,CAN,14,Howe Hilary ,OH,5,1,0,-5.13,6,5,3,15,23,8.70,1,3,3,7,-28.57,0,2,7,9,-22.22,2,6,10,18,-22.22,7,1,9,66.67,0,0,2,2,0.00
11948,CAN,15,Joseph Shainah ,O,2,0,0,14.29,2,2,0,2,4,50.00,0,1,0,1,-100.00,0,0,2,2,0.00,0,0,0,0, ,1,0,1,100.00,0,0,0,0, 
11948,CAN,16,Livingston Caroline ,OH,0,0,0,-100.00,0,0,0,0,0, ,0,0,0,0, ,0,1,0,1,-100.00,0,1,2,3,-33.33,1,1,2,0.00,0,0,1,1,0.00
11948,CAN,19,Maglio Emily ,MB,5,3,0,2.78,8,5,2,7,14,21.43,3,5,4,12,-16.67,0,0,10,10,0.00,0,0,0,0, ,7,1,8,75.00,0,0,4,4,0.00
11948,CAN,22,Snape Kennedy Brooklyn ,L,0,0,0, ,0,0,0,0,0, ,0,0,0,0, ,0,0,0,0, ,0,0,0,0, ,1,3,5,-40.00,0,0,5,5,0.00
11949,BRA,2,De Oliveira Saad Gattaz Caroline ,MB,7,0,0,3.45,7,7,2,2,11,45.45,0,4,1,5,-80.00,0,0,13,13,0.00,0,0,1,1,0.00,1,0,1,100.00,0,0,3,3,0.00
11949,BRA,3,Rodrigues Lins Dos Santos Danielle ,S,0,0,0,-14.29,0,0,0,0,0, ,0,0,0,0, ,0,1,6,7,-14.29,0,0,0,0, ,3,1,5,40.00,3,0,14,17,17.65
11949,BRA,6,Alexandre Costa Nunes Nyeme Victoria ,L,0,0,0, ,0,0,0,0,0, ,0,0,0,0, ,0,0,0,0, ,0,0,0,0, ,0,0,0, ,0,0,0,0, 
11949,BRA,7,Montibeller Rosamaria ,OH,2,0,0,-22.22,2,2,2,3,7,0.00,0,2,0,2,-100.00,0,0,0,0, ,0,0,0,0, ,1,0,1,100.00,0,0,0,0, 
11949,BRA,8,Silva Carneiro Macris Fernanda ,S,0,0,1,-10.00,1,0,0,1,1,0.00,0,3,4,7,-42.86,1,0,11,12,8.33,0,0,0,0, ,9,0,9,100.00,20,0,75,95,21.05
11949,BRA,10,Braga Guimaraes Gabriela ,OH,8,0,1,10.53,9,8,4,14,26,15.38,0,0,2,2,0.00,1,1,8,10,0.00,4,1,5,10,30.00,7,2,12,41.67,0,0,4,4,0.00
11949,BRA,11,Caixeta Tandara ,OH,17,1,1,29.41,19,17,1,18,36,44.44,1,3,3,7,-28.57,1,0,7,8,12.50,0,0,0,0, ,11,1,12,83.33,0,0,2,2,0.00
11949,BRA,12,Pereira Natalia ,OH,6,0,0,11.11,6,6,2,6,14,28.57,0,1,0,1,-100.00,0,0,12,12,0.00,4,0,10,14,28.57,4,2,8,25.00,0,0,0,0, 
11949,BRA,15,Da Silva Ana Carolina ,MB,4,1,0,0.00,5,4,0,1,5,80.00,1,4,1,6,-50.00,0,1,2,3,-33.33,0,0,0,0, ,0,0,0, ,0,0,0,0, 
11949,BRA,16,Rodrigues Fernanda ,OH,9,2,2,11.54,13,9,1,20,30,26.67,2,4,5,11,-18.18,2,2,7,11,0.00,5,1,5,11,36.36,10,0,12,83.33,0,0,2,2,0.00
11949,BRA,17,Menezes Oliveira de Souza Ana Cristina ,OH,2,0,0,20.00,2,2,0,1,3,66.67,0,0,0,0, ,0,1,1,2,-50.00,0,0,0,0, ,1,0,1,100.00,0,0,0,0, 
11949,BRA,18,Brait Camila ,L,0,0,0, ,0,0,0,0,0, ,0,0,0,0, ,0,0,0,0, ,13,2,20,35,31.43,21,2,25,76.00,0,0,9,9,0.00
11949,BRA,20,Correa Ana Beatriz ,MB,5,1,1,-2.44,7,5,0,5,10,50.00,1,7,4,12,-50.00,1,1,17,19,0.00,0,0,0,0, ,5,2,8,37.50,0,0,4,4,0.00
11949,BRA,28,Araujo De Souza Mayany Cristina ,MB,3,1,0,33.33,4,3,0,0,3,100.00,1,1,3,5,0.00,0,0,1,1,0.00,0,0,0,0, ,0,0,0, ,0,0,0,0, 
11949,TUR,2,Akoz Simge Sebnem ,L,0,0,0, ,0,0,0,0,0, ,0,0,0,0, ,0,0,0,0, ,1,2,5,8,-12.50,5,1,7,57.14,0,0,5,5,0.00
11949,TUR,3,Ãzbay Cansu ,S,1,1,0,10.00,2,1,0,0,1,100.00,1,1,2,4,0.00,0,0,5,5,0.00,0,0,0,0, ,8,2,12,50.00,9,0,33,42,21.43
11949,TUR,4,Senoglu Tugba ,OH,11,0,0,9.30,11,11,5,11,27,22.22,0,2,2,4,-50.00,0,0,12,12,0.00,3,1,11,15,13.33,9,3,13,46.15,0,0,1,1,0.00
11949,TUR,5,Ercan Seyma ,OH,0,0,0, ,0,0,0,0,0, ,0,0,0,0, ,0,0,0,0, ,6,1,11,18,27.78,9,1,12,66.67,0,0,3,3,0.00
11949,TUR,6,Caliskan Kubra ,MB,0,0,0, ,0,0,0,0,0, ,0,0,0,0, ,0,0,0,0, ,0,0,0,0, ,0,0,0, ,0,0,0,0, 
11949,TUR,7,Baladin Hande ,OH,1,0,0,-23.53,1,1,3,6,10,-20.00,0,2,3,5,-40.00,0,0,2,2,0.00,2,0,5,7,28.57,1,0,1,100.00,0,0,0,0, 
11949,TUR,9,Ismailoglu Meliha ,OH,1,0,0,0.00,1,1,0,3,4,25.00,0,1,0,1,-100.00,0,0,3,3,0.00,4,1,11,16,18.75,1,0,2,50.00,0,0,1,1,0.00
11949,TUR,12,Unal Buse ,S,1,1,0,-7.14,2,1,0,2,3,33.33,1,1,3,5,0.00,0,2,4,6,-33.33,0,0,0,0, ,1,1,2,0.00,16,0,56,72,22.22
11949,TUR,13,Boz Meryem ,O,6,0,0,3.23,6,6,2,15,23,17.39,0,1,1,2,-50.00,0,2,4,6,-33.33,0,0,0,0, ,8,0,10,80.00,0,0,0,0, 
11949,TUR,14,Erdem DÃ¼ndar Eda ,MB,7,2,3,-3.77,12,7,1,8,16,37.50,2,13,7,22,-50.00,3,0,12,15,20.00,0,0,0,0, ,4,3,8,12.50,0,0,5,5,0.00
11949,TUR,16,Sahin Saliha ,OH,0,0,0, ,0,0,0,0,0, ,0,0,0,0, ,0,0,0,0, ,0,0,0,0, ,0,0,0, ,0,0,0,0, 
11949,TUR,19,Kalac Asli ,MB,2,0,0,-29.03,2,2,3,1,6,-16.67,0,7,8,15,-46.67,0,1,9,10,-10.00,0,0,0,0, ,0,2,2,-100.00,0,0,3,3,0.00
11949,TUR,22,Aydin Ä°lkin ,OH,10,0,0,24.14,10,10,2,6,18,44.44,0,1,2,3,-33.33,0,0,8,8,0.00,7,1,19,27,22.22,5,2,10,30.00,0,0,2,2,0.00
11949,TUR,99,Karakurt Ebrar ,OH,11,0,1,6.67,12,11,5,15,31,19.35,0,3,1,4,-75.00,1,1,8,10,0.00,0,0,0,0, ,7,0,10,70.00,0,1,1,2,-50.00
11796,AUS,1,Graham Beau ,MB,7,0,0,-19.05,7,7,9,7,23,-8.70,0,4,2,6,-66.67,0,2,11,13,-15.38,0,0,0,0, ,1,2,3,-33.33,0,0,2,2,0.00
11796,AUS,2,Dosanjh Arshdeep ,S,2,1,1,0.00,4,2,0,1,3,66.67,1,4,1,6,-50.00,1,0,12,13,7.69,0,0,0,0, ,10,3,13,53.85,18,0,59,77,23.38
11796,AUS,3,Macdonald Steven ,MB,0,0,0, ,0,0,0,0,0, ,0,0,0,0, ,0,0,0,0, ,0,0,0,0, ,0,0,0, ,0,0,0,0, 
11796,AUS,7,Weir James ,MB,6,3,1,14.29,10,6,4,3,13,15.38,3,1,0,4,50.00,1,1,9,11,0.00,0,0,0,0, ,1,1,2,0.00,0,0,1,1,0.00
11796,AUS,8,O'Dea Trent ,MB,3,0,1,0.00,4,3,1,3,7,28.57,0,2,0,2,-100.00,1,1,8,10,0.00,0,0,1,1,0.00,1,1,2,0.00,0,0,1,1,0.00
11796,AUS,11,Perry Luke ,L,0,0,0, ,0,0,0,0,0, ,0,0,0,0, ,0,0,0,0, ,8,0,8,16,50.00,4,3,7,14.29,0,0,10,10,0.00
11796,AUS,12,Mote Nehemiah ,MB,0,0,0, ,0,0,0,0,0, ,0,0,0,0, ,0,0,0,0, ,0,0,0,0, ,0,0,0, ,0,0,0,0, 
11796,AUS,21,Butler Nicholas ,S,0,0,0, ,0,0,0,0,0, ,0,0,0,0, ,0,0,0,0, ,0,0,0,0, ,0,1,1,-100.00,1,0,3,4,25.00
11796,AUS,27,Senica Max ,OH,4,0,1,0.00,5,4,3,9,16,6.25,0,0,0,0, ,1,2,4,7,-14.29,5,1,4,10,40.00,1,0,1,100.00,0,0,3,3,0.00
11796,AUS,28,Taylor Tim ,OH,2,0,0,0.00,2,2,1,1,4,25.00,0,0,0,0, ,0,1,0,1,-100.00,1,2,6,9,-11.11,0,0,0, ,0,0,0,0, 
11796,AUS,29,Garrett Ethan ,OH,2,0,0,-20.00,2,2,2,7,11,0.00,0,1,0,1,-100.00,0,2,1,3,-66.67,3,1,12,16,12.50,0,1,1,-100.00,0,0,0,0, 
11796,AUS,31,Aubrey Matthew ,O,0,0,0,-100.00,0,0,1,0,1,-100.00,0,0,0,0, ,0,1,0,1,-100.00,0,0,0,0, ,0,0,0, ,0,0,0,0, 
11796,AUS,32,Azeez Oluwatobi Elliot ,OH,8,2,2,13.51,12,8,3,10,21,23.81,2,3,0,5,-20.00,2,1,8,11,9.09,10,2,14,26,30.77,10,5,15,33.33,0,0,0,0, 
11796,AUS,34,Greber Billy ,L,0,0,0, ,0,0,0,0,0, ,0,0,0,0, ,0,0,0,0, ,0,0,0,0, ,0,0,0, ,0,0,0,0, 
11796,SRB,3,Kapur Milorad ,L,0,0,0, ,0,0,0,0,0, ,0,0,0,0, ,0,0,0,0, ,0,0,0,0, ,7,1,9,66.67,0,0,1,1,0.00
11796,SRB,6,Pekovic Nikola ,L,0,0,0, ,0,0,0,0,0, ,0,0,0,0, ,0,0,0,0, ,8,3,5,16,31.25,0,0,0, ,0,0,1,1,0.00
11796,SRB,7,Krsmanovic Petar ,MB,5,7,3,32.26,15,5,1,1,7,57.14,7,1,2,10,60.00,3,3,8,14,0.00,0,0,0,0, ,2,1,3,33.33,0,0,2,2,0.00
11796,SRB,8,Ivovic Marko ,OH,9,1,2,39.29,12,9,1,7,17,47.06,1,0,0,1,100.00,2,0,8,10,20.00,4,0,1,5,80.00,2,1,3,33.33,0,0,0,0, 
11796,SRB,9,Jovovic Nikola ,S,0,0,0,-33.33,0,0,0,0,0, ,0,1,0,1,-100.00,0,0,2,2,0.00,0,0,0,0, ,1,0,1,100.00,2,0,11,13,15.38
11796,SRB,10,KujundÅ¾iÄ Miran ,OH,2,0,0,0.00,2,2,0,3,5,40.00,0,1,0,1,-100.00,0,1,2,3,-33.33,3,2,4,9,11.11,0,1,1,-100.00,0,0,0,0, 
11796,SRB,11,Batak Aleksa ,S,0,0,0, ,0,0,0,0,0, ,0,0,0,0, ,0,0,0,0, ,0,0,0,0, ,0,0,0, ,0,0,0,0, 
11796,SRB,12,Peric Pavle ,OH,7,0,0,7.41,7,7,2,7,16,31.25,0,0,2,2,0.00,0,3,6,9,-33.33,8,0,8,16,50.00,3,0,4,75.00,0,0,1,1,0.00
11796,SRB,14,Atanasijevic Aleksandar ,O,19,0,0,17.02,19,19,4,6,29,51.72,0,3,0,3,-100.00,0,4,11,15,-26.67,0,0,0,0, ,3,1,4,50.00,0,0,3,3,0.00
11796,SRB,16,Luburic Drazen ,O,0,0,0, ,0,0,0,0,0, ,0,0,0,0, ,0,0,0,0, ,0,0,0,0, ,0,0,0, ,0,0,0,0, 
11796,SRB,18,Podrascanin Marko ,MB,7,3,0,5.26,10,7,1,1,9,66.67,3,5,1,9,-22.22,0,2,18,20,-10.00,1,0,0,1,100.00,3,0,3,100.00,0,0,2,2,0.00
11796,SRB,21,Todorovic Vuk ,S,0,0,1,-13.04,1,0,0,0,0, ,0,2,3,5,-40.00,1,2,15,18,-5.56,0,0,0,0, ,1,0,1,100.00,19,2,42,63,26.98
11796,SRB,23,Vucicevic Bozidar ,O,0,0,0,-100.00,0,0,1,0,1,-100.00,0,0,0,0, ,0,0,0,0, ,0,0,0,0, ,0,0,0, ,0,0,0,0, 
11796,SRB,26,Kovac Davide ,OH,3,0,0,12.50,3,3,1,1,5,40.00,0,1,0,1,-100.00,0,0,2,2,0.00,3,1,8,12,16.67,0,2,2,-100.00,0,0,1,1,0.00
11797,JPN,1,Shimizu Kunihiro ,O,1,0,0,0.00,1,1,0,1,2,50.00,0,0,0,0, ,0,1,2,3,-33.33,0,0,1,1,0.00,0,0,0, ,0,0,0,0, 
11797,JPN,2,Onodera Taishi ,MB,6,2,0,0.00,8,6,1,3,10,50.00,2,7,1,10,-50.00,0,0,6,6,0.00,0,0,1,1,0.00,2,1,3,33.33,0,0,0,0, 
11797,JPN,5,Fukuzawa Tatsuya ,OH,0,0,0, ,0,0,0,0,0, ,0,0,0,0, ,0,0,0,0, ,0,0,0,0, ,0,0,0, ,0,0,0,0, 
11797,JPN,6,Yamauchi Akihiro ,MB,5,0,1,7.14,6,5,1,2,8,50.00,0,3,1,4,-75.00,1,0,15,16,6.25,0,0,0,0, ,3,2,5,20.00,0,0,0,0, 
11797,JPN,11,Nishida Yuji ,O,20,3,0,26.09,23,20,4,5,29,55.17,3,4,2,9,-11.11,0,3,5,8,-37.50,0,0,0,0, ,4,2,6,33.33,0,0,0,0, 
11797,JPN,12,Sekita Masahiro ,S,0,0,1,-16.67,1,0,0,0,0, ,0,3,2,5,-60.00,1,0,6,7,14.29,0,0,0,0, ,5,1,7,57.14,16,0,50,66,24.24
11797,JPN,13,Oya Masaki ,S,0,0,0, ,0,0,0,0,0, ,0,0,0,0, ,0,0,0,0, ,0,0,0,0, ,0,0,0, ,1,0,6,7,14.29
11797,JPN,14,Ishikawa Yuki ,OH,11,1,0,17.07,12,11,2,5,18,50.00,1,2,6,9,-11.11,0,1,13,14,-7.14,8,0,10,18,44.44,10,0,11,90.91,0,0,8,8,0.00
11797,JPN,15,Ri Haku ,MB,0,0,0, ,0,0,0,0,0, ,0,0,0,0, ,0,0,0,0, ,0,0,0,0, ,0,0,0, ,0,0,0,0, 
11797,JPN,17,Takanashi Kenta ,OH,0,0,0,-100.00,0,0,0,0,0, ,0,1,0,1,-100.00,0,0,0,0, ,0,0,1,1,0.00,0,0,0, ,0,0,0,0, 
11797,JPN,19,Otsuka Tatsunori ,OH,0,0,0, ,0,0,0,0,0, ,0,0,0,0, ,0,0,0,0, ,0,0,0,0, ,0,0,0, ,0,0,0,0, 
11797,JPN,20,Yamamoto Tomohiro ,L,0,0,0, ,0,0,0,0,0, ,0,0,0,0, ,0,0,0,0, ,6,0,8,14,42.86,10,2,14,57.14,0,0,2,2,0.00
11797,JPN,21,Takahashi Ran ,OH,7,0,1,5.26,8,7,4,7,18,16.67,0,0,1,1,0.00,1,2,16,19,-5.26,1,2,10,13,-7.69,4,2,6,33.33,0,0,1,1,0.00
11797,JPN,24,Ogawa Tomohiro ,L,0,0,0, ,0,0,0,0,0, ,0,0,0,0, ,0,0,0,0, ,0,0,0,0, ,0,0,0, ,0,0,0,0, 
11797,BUL,1,Karyagin Denis ,O,6,0,0,8.00,6,6,3,10,19,15.79,0,1,0,1,-100.00,0,0,5,5,0.00,0,0,0,0, ,4,1,5,60.00,0,0,0,0, 
11797,BUL,2,Chavdarov Stefan ,MB,2,1,0,-17.39,3,2,0,2,4,50.00,1,4,3,8,-37.50,0,3,8,11,-27.27,0,0,1,1,0.00,2,0,2,100.00,0,0,0,0, 
11797,BUL,3,Kolev Nikolay ,MB,5,3,0,21.74,8,5,0,3,8,62.50,3,3,3,9,0.00,0,0,6,6,0.00,0,0,2,2,0.00,0,1,1,-100.00,0,0,1,1,0.00
11797,BUL,4,Atanasov Martin ,OH,2,0,1,0.00,3,2,1,7,10,10.00,0,2,0,2,-100.00,1,0,9,10,10.00,4,0,13,17,23.53,5,3,8,25.00,0,0,1,1,0.00
11797,BUL,6,Stankov Vladimir ,S,0,0,0,-50.00,0,0,0,0,0, ,0,0,0,0, ,0,1,1,2,-50.00,0,0,1,1,0.00,0,0,0, ,6,0,6,12,50.00
11797,BUL,9,Seganov Georgi ,S,0,2,0,0.00,2,0,1,0,1,-100.00,2,0,3,5,40.00,0,1,8,9,-11.11,0,0,0,0, ,2,3,5,-20.00,13,0,44,57,22.81
11797,BUL,12,Petrov Georgi ,OH,0,0,0, ,0,0,0,0,0, ,0,0,0,0, ,0,0,0,0, ,0,0,0,0, ,0,0,0, ,0,0,0,0, 
11797,BUL,14,Asparuhov Asparuh ,OH,14,2,1,27.78,17,14,3,6,23,47.83,2,2,2,6,0.00,1,2,4,7,-14.29,3,3,14,20,0.00,3,3,6,0.00,0,0,0,0, 
11797,BUL,15,Lyutskanov Gordan ,OH,1,0,0,0.00,1,1,0,2,3,33.33,0,1,0,1,-100.00,0,0,1,1,0.00,1,0,4,5,20.00,1,0,1,100.00,0,0,0,0, 
11797,BUL,16,Ivanov Vladislav ,L,0,0,0, ,0,0,0,0,0, ,0,0,0,0, ,0,0,0,0, ,3,0,10,13,23.08,8,5,13,23.08,0,0,8,8,0.00
11797,BUL,22,Kartev Nikolay ,MB,0,0,0, ,0,0,0,0,0, ,0,0,0,0, ,0,0,0,0, ,0,0,0,0, ,0,0,0, ,0,0,0,0, 
11797,BUL,24,Ivanov Martin ,L,0,0,0, ,0,0,0,0,0, ,0,0,0,0, ,0,0,0,0, ,0,0,0,0, ,0,0,0, ,0,0,0,0, 
11797,BUL,25,Parapunov Radoslav ,O,3,0,0,-7.69,3,3,3,4,10,0.00,0,0,0,0, ,0,1,2,3,-33.33,0,0,0,0, ,0,1,1,-100.00,0,0,0,0, 
11797,BUL,26,Ivanov Svetoslav ,OH,1,0,0,-25.00,1,1,1,2,4,0.00,0,1,0,1,-100.00,0,1,2,3,-33.33,0,0,7,7,0.00,0,2,2,-100.00,0,0,0,0, 
11798,FRA,1,Chinenyeze BarthÃ©lÃ©my ,MB,5,2,0,15.00,7,5,0,2,7,71.43,2,2,0,4,0.00,0,2,7,9,-22.22,0,0,0,0, ,2,1,3,33.33,0,0,0,0, 
11798,FRA,2,Grebennikov Jenia ,L,0,0,0, ,0,0,0,0,0, ,0,0,0,0, ,0,0,0,0, ,13,0,11,24,54.17,5,6,13,-7.69,0,0,0,0, 
11798,FRA,4,Patry Jean ,O,0,0,0, ,0,0,0,0,0, ,0,0,0,0, ,0,0,0,0, ,0,0,0,0, ,0,0,0, ,0,0,0,0, 
11798,FRA,6,Toniutti Benjamin ,S,0,0,0,-12.50,0,0,0,0,0, ,0,1,3,4,-25.00,0,1,11,12,-8.33,0,0,0,0, ,5,3,8,25.00,17,0,49,66,25.76
11798,FRA,7,Tillie Kevin ,OH,8,0,0,35.00,8,8,1,3,12,58.33,0,0,1,1,0.00,0,0,7,7,0.00,4,0,6,10,40.00,1,2,3,-33.33,0,0,0,0, 
11798,FRA,9,Ngapeth Earvin ,OH,7,0,2,-5.41,9,7,5,2,14,14.29,0,3,0,3,-100.00,2,3,15,20,-5.00,5,2,10,17,17.65,3,1,5,40.00,0,0,3,3,0.00
11798,FRA,11,Brizard Antoine ,S,0,0,0, ,0,0,0,0,0, ,0,0,0,0, ,0,0,0,0, ,0,0,0,0, ,0,0,0, ,0,0,0,0, 
11798,FRA,12,Boyer Stephen ,O,15,1,1,17.95,17,15,3,8,26,46.15,1,2,1,4,-25.00,1,5,3,9,-44.44,0,0,0,0, ,1,1,3,0.00,0,0,1,1,0.00
11798,FRA,14,Le Goff Nicolas ,MB,4,4,1,20.00,9,4,1,1,6,50.00,4,2,1,7,28.57,1,1,10,12,0.00,0,0,1,1,0.00,2,0,2,100.00,0,0,1,1,0.00
11798,FRA,16,Bultor Daryl ,MB,0,0,0, ,0,0,0,0,0, ,0,0,0,0, ,0,0,0,0, ,0,0,0,0, ,0,0,0, ,0,0,0,0, 
11798,FRA,17,Clevenot Trevor ,OH,2,1,1,20.00,4,2,1,2,5,20.00,1,0,0,1,100.00,1,1,2,4,0.00,0,0,0,0, ,1,0,1,100.00,0,0,0,0, 
11798,FRA,19,Louati Yacine ,OH,0,0,0, ,0,0,0,0,0, ,0,0,0,0, ,0,0,0,0, ,0,0,0,0, ,0,0,0, ,0,0,0,0, 
11798,FRA,20,Diez Benjamin ,L,0,0,0, ,0,0,0,0,0, ,0,0,0,0, ,0,0,0,0, ,0,0,0,0, ,0,0,0, ,0,0,0,0, 
11798,FRA,24,Gueye Mousse ,MB,0,0,0, ,0,0,0,0,0, ,0,0,0,0, ,0,0,0,0, ,0,0,0,0, ,0,0,0, ,0,0,0,0, 
11798,IRI,2,Ebadipour Ghara H. Milad ,OH,5,2,0,0.00,7,5,2,8,15,20.00,2,2,0,4,0.00,0,3,5,8,-37.50,6,1,10,17,29.41,2,1,3,33.33,0,0,4,4,0.00
11798,IRI,4,Marouflakrani Mir Saeid ,S,0,0,0,-25.00,0,0,0,1,1,0.00,0,1,0,1,-100.00,0,0,2,2,0.00,0,0,0,0, ,1,0,1,100.00,8,1,11,20,35.00
11798,IRI,6,Mousavi Eraghi Seyed Mohammad ,MB,2,2,0,-21.05,4,2,1,1,4,25.00,2,6,1,9,-44.44,0,1,5,6,-16.67,1,0,0,1,100.00,0,0,0, ,0,0,2,2,0.00
11798,IRI,8,Hazratpourtalatappeh Mohammadreza ,L,0,0,0, ,0,0,0,0,0, ,0,0,0,0, ,0,0,0,0, ,0,0,0,0, ,0,0,0, ,0,0,0,0, 
11798,IRI,9,Gholami Masoud ,MB,0,0,0, ,0,0,0,0,0, ,0,0,0,0, ,0,0,0,0, ,0,0,0,0, ,0,0,0, ,0,0,0,0, 
11798,IRI,10,Ghafour Amir ,O,5,2,0,5.56,7,5,3,1,9,22.22,2,2,1,5,0.00,0,1,3,4,-25.00,0,0,1,1,0.00,0,0,0, ,0,0,1,1,0.00
11798,IRI,11,Kazemi Saber ,O,9,0,1,6.25,10,9,5,5,19,21.05,0,3,0,3,-100.00,1,0,9,10,10.00,0,0,0,0, ,1,0,1,100.00,0,0,2,2,0.00
11798,IRI,12,Sharifi Morteza ,OH,0,0,0, ,0,0,0,0,0, ,0,0,0,0, ,0,0,0,0, ,0,0,0,0, ,0,0,0, ,0,0,0,0, 
11798,IRI,15,Mojarad Aliasghar ,MB,1,1,0,-25.00,2,1,3,1,5,-40.00,1,2,3,6,-16.67,0,2,7,9,-22.22,0,0,0,0, ,1,1,2,0.00,0,0,0,0, 
11798,IRI,17,Salehi Meisam ,OH,12,0,0,20.00,12,12,1,9,22,50.00,0,2,1,3,-66.67,0,2,8,10,-20.00,8,2,5,15,40.00,2,0,2,100.00,0,0,3,3,0.00
11798,IRI,21,Salehi Arman ,L,0,0,0, ,0,0,0,0,0, ,0,0,0,0, ,0,0,0,0, ,14,0,9,23,60.87,7,1,9,66.67,0,0,4,4,0.00
11798,IRI,22,Esfandiar Amirhossein ,OH,1,0,0,0.00,1,1,0,1,2,50.00,0,0,0,0, ,0,1,6,7,-14.29,0,2,1,3,-66.67,0,0,0, ,0,0,0,0, 
11798,IRI,23,Saadat Bardia ,O,0,0,0, ,0,0,0,0,0, ,0,0,0,0, ,0,0,0,0, ,0,0,0,0, ,0,0,0, ,0,0,0,0, 
11798,IRI,24,Karimisouchelmaei Javad ,S,0,1,1,0.00,2,0,0,0,0, ,1,1,0,2,0.00,1,1,5,7,0.00,0,0,0,0, ,1,1,2,0.00,7,2,31,40,12.50
11799,CAN,2,Perrin John Gordon ,OH,11,0,0,16.13,11,11,2,7,20,45.00,0,2,1,3,-66.67,0,2,6,8,-25.00,6,0,7,13,46.15,7,2,10,50.00,0,0,1,1,0.00
11799,CAN,3,Marshall Steven ,OH,0,0,0, ,0,0,0,0,0, ,0,0,0,0, ,0,0,0,0, ,0,0,0,0, ,0,0,0, ,0,0,0,0, 
11799,CAN,4,Hoag Nicholas ,OH,6,1,4,0.00,11,6,6,5,17,0.00,1,2,6,9,-11.11,4,3,8,15,6.67,5,0,8,13,38.46,5,0,5,100.00,0,1,1,2,-50.00
11799,CAN,7,Maar Stephen Timothy ,OH,1,0,0,100.00,1,1,0,0,1,100.00,0,0,0,0, ,0,0,0,0, ,0,0,0,0, ,1,0,1,100.00,0,0,0,0, 
11799,CAN,8,Blankenau Jay ,S,1,1,0,0.00,2,1,0,0,1,100.00,1,0,2,3,33.33,0,2,13,15,-13.33,0,0,1,1,0.00,3,0,5,60.00,20,2,35,57,31.58
11799,CAN,10,Sclater Ryan Joseph ,O,0,0,0,0.00,0,0,0,0,0, ,0,0,0,0, ,0,0,3,3,0.00,0,0,0,0, ,1,0,1,100.00,0,0,0,0, 
11799,CAN,11,Jansen Vandoorn Daniel ,MB,0,0,0, ,0,0,0,0,0, ,0,0,0,0, ,0,0,0,0, ,0,0,0,0, ,0,0,0, ,0,0,0,0, 
11799,CAN,12,Van Berkel Lucas ,MB,7,2,0,20.00,9,7,0,3,10,70.00,2,2,4,8,0.00,0,1,11,12,-8.33,1,0,0,1,100.00,0,1,1,-100.00,0,0,0,0, 
11799,CAN,13,Vernon-Evans Sharone ,O,11,3,0,37.93,14,11,1,2,14,71.43,3,1,4,8,25.00,0,1,6,7,-14.29,0,0,0,0, ,4,4,8,0.00,0,0,1,1,0.00
11799,CAN,14,Loeppky Eric ,OH,0,0,0, ,0,0,0,0,0, ,0,0,0,0, ,0,0,0,0, ,0,0,0,0, ,0,0,0, ,0,0,0,0, 
11799,CAN,17,Vigrass Graham ,MB,5,4,1,29.63,10,5,0,0,5,100.00,4,2,2,8,25.00,1,0,13,14,7.14,0,0,0,0, ,1,2,4,-25.00,0,0,1,1,0.00
11799,CAN,19,Bann Blair Cameron ,L,0,0,0, ,0,0,0,0,0, ,0,0,0,0, ,0,0,0,0, ,2,0,12,14,14.29,6,3,9,33.33,0,0,3,3,0.00
11799,CAN,20,Szwarc Arthur ,O,0,0,0, ,0,0,0,0,0, ,0,0,0,0, ,0,0,0,0, ,0,0,0,0, ,0,0,0, ,0,0,0,0, 
11799,CAN,21,Walsh Brett James ,S,0,0,0, ,0,0,0,0,0, ,0,0,0,0, ,0,0,0,0, ,0,0,0,0, ,0,0,0, ,1,0,3,4,25.00
11799,NED,2,Keemink Wessel ,S,0,0,0,-25.00,0,0,0,1,1,0.00,0,1,0,1,-100.00,0,0,2,2,0.00,0,0,0,0, ,3,0,3,100.00,15,0,25,40,37.50
11799,NED,4,Ter Horst Thijs ,OH,8,0,0,-5.88,8,8,5,10,23,13.04,0,3,1,4,-75.00,0,2,5,7,-28.57,2,2,3,7,0.00,5,3,9,22.22,0,0,1,1,0.00
11799,NED,6,Dronkers Just ,L,0,0,0, ,0,0,0,0,0, ,0,0,0,0, ,0,0,0,0, ,0,0,8,8,0.00,2,1,3,33.33,0,0,2,2,0.00
11799,NED,8,Plak Fabian ,MB,1,0,0,-22.22,1,1,1,1,3,0.00,0,4,2,6,-66.67,0,0,9,9,0.00,0,0,1,1,0.00,3,1,4,50.00,0,0,0,0, 
11799,NED,10,van Zeist Maikel ,MB,0,0,0,-33.33,0,0,0,0,0, ,0,0,0,0, ,0,1,2,3,-33.33,1,0,1,2,50.00,1,0,1,100.00,0,0,0,0, 
11799,NED,12,Tuinstra Bennie Junior ,OH,7,0,0,-7.69,7,7,6,14,27,3.70,0,2,0,2,-100.00,0,2,8,10,-20.00,8,1,12,21,33.33,2,1,4,25.00,0,0,3,3,0.00
11799,NED,13,Ottevanger Steven ,L,0,0,0, ,0,0,0,0,0, ,0,0,0,0, ,0,0,0,0, ,1,2,4,7,-14.29,2,5,7,-42.86,0,0,1,1,0.00
11799,NED,15,van Solkema Gijs ,S,0,0,0, ,0,0,0,0,0, ,0,0,0,0, ,0,0,0,0, ,0,0,0,0, ,0,0,0, ,0,0,0,0, 
11799,NED,17,Parkinson Michael ,MB,5,1,0,20.00,6,5,2,1,8,37.50,1,1,1,3,0.00,0,0,4,4,0.00,0,0,1,1,0.00,1,0,1,100.00,0,0,0,0, 
11799,NED,18,Andringa Robbert ,L,4,1,0,21.43,5,4,0,5,9,44.44,1,0,0,1,100.00,0,2,2,4,-50.00,7,0,10,17,41.18,4,1,6,50.00,0,0,1,1,0.00
11799,NED,19,de Weijer Freek ,S,0,0,0,-50.00,0,0,1,0,1,-100.00,0,1,0,1,-100.00,0,0,2,2,0.00,0,0,0,0, ,2,0,2,100.00,8,1,24,33,21.21
11799,NED,21,van Schie Stijn ,OH,0,0,0,-100.00,0,0,0,0,0, ,0,0,0,0, ,0,1,0,1,-100.00,0,0,0,0, ,0,0,0, ,0,0,0,0, 
11799,NED,22,Wiltenburg Twan ,MB,1,0,0,0.00,1,1,0,0,1,100.00,0,0,0,0, ,0,1,3,4,-25.00,0,0,0,0, ,0,0,0, ,0,0,0,0, 
11799,NED,25,van Tilburg Stijn ,OH,3,1,0,11.11,4,3,2,7,12,8.33,1,0,0,1,100.00,0,0,5,5,0.00,0,0,1,1,0.00,1,0,1,100.00,0,0,2,2,0.00
11800,BRA,1,Rezende Bruno Mossa ,S,0,0,0,-17.86,0,0,0,0,0, ,0,5,5,10,-50.00,0,0,18,18,0.00,0,0,0,0, ,14,2,21,57.14,36,0,68,104,34.62
11800,BRA,3,De Barros Ferreira JoÃ£o Rafael ,OH,0,0,0,-33.33,0,0,0,0,0, ,0,0,0,0, ,0,1,2,3,-33.33,0,0,0,0, ,0,0,0, ,0,0,0,0, 
11800,BRA,5,Borges Almeida Silva Mauricio ,OH,1,0,0,100.00,1,1,0,0,1,100.00,0,0,0,0, ,0,0,0,0, ,1,0,4,5,20.00,1,0,1,100.00,1,0,0,1,100.00
11800,BRA,6,Gil Kreling Fernando ,S,0,0,0, ,0,0,0,0,0, ,0,0,0,0, ,0,0,0,0, ,0,0,0,0, ,0,0,0, ,1,0,0,1,100.00
11800,BRA,8,De Souza Wallace ,O,19,1,0,14.81,20,19,3,7,29,55.17,1,5,4,10,-40.00,0,4,11,15,-26.67,0,0,3,3,0.00,4,1,5,60.00,0,0,1,1,0.00
11800,BRA,9,Leal Hidalgo Yoandy ,OH,19,0,1,20.34,20,19,2,14,35,48.57,0,3,4,7,-42.86,1,3,13,17,-11.76,6,2,22,30,13.33,5,2,7,42.86,0,0,3,3,0.00
11800,BRA,13,De Souza Mauricio Luiz ,MB,8,0,0,4.26,8,8,2,7,17,35.29,0,4,10,14,-28.57,0,0,16,16,0.00,0,0,0,0, ,0,0,1,0.00,0,0,1,1,0.00
11800,BRA,14,Correia De Souza Douglas ,OH,0,0,0,0.00,0,0,0,0,0, ,0,0,0,0, ,0,0,1,1,0.00,0,0,0,0, ,0,0,0, ,0,0,0,0, 
11800,BRA,15,Nascimento Maique Reis ,L,0,0,0, ,0,0,0,0,0, ,0,0,0,0, ,0,0,0,0, ,0,0,0,0, ,0,0,0, ,0,0,0,0, 
11800,BRA,16,Saatkamp Lucas ,MB,5,1,1,-18.92,7,5,2,7,14,21.43,1,7,3,11,-54.55,1,5,6,12,-33.33,0,0,1,1,0.00,1,0,1,100.00,0,0,1,1,0.00
11800,BRA,17,Hoss Thales ,L,0,0,0, ,0,0,0,0,0, ,0,0,0,0, ,0,0,0,0, ,6,0,11,17,35.29,13,2,17,64.71,0,1,4,5,-20.00
11800,BRA,18,Souza Ricardo Lucarelli ,OH,15,3,3,15.87,21,15,3,10,28,42.86,3,5,6,14,-14.29,3,3,15,21,0.00,7,1,16,24,25.00,9,4,14,35.71,0,0,7,7,0.00
11800,BRA,21,Souza Alan ,O,0,0,0,0.00,0,0,0,1,1,0.00,0,0,0,0, ,0,0,0,0, ,0,0,0,0, ,0,0,0, ,0,0,0,0, 
11800,BRA,23,Resende Gualberto Flavio ,MB,0,0,0, ,0,0,0,0,0, ,0,0,0,0, ,0,0,0,0, ,0,0,0,0, ,0,0,0, ,0,0,0,0, 
11800,ITA,1,Gardini Davide ,OH,0,0,0, ,0,0,0,0,0, ,0,0,0,0, ,0,0,0,0, ,0,0,0,0, ,0,0,0, ,0,0,0,0, 
11800,ITA,7,Balaso Fabio ,L,0,0,0, ,0,0,0,0,0, ,0,0,0,0, ,0,0,0,0, ,6,1,24,31,16.13,13,6,23,30.43,0,0,6,6,0.00
11800,ITA,15,Sbertoli Riccardo ,S,0,1,0,-17.65,1,0,0,0,0, ,1,2,3,6,-16.67,0,2,9,11,-18.18,0,0,0,0, ,5,5,11,0.00,23,2,65,90,23.33
11800,ITA,18,Michieletto Alessandro ,OH,18,2,0,26.42,20,18,2,12,32,50.00,2,2,4,8,0.00,0,2,11,13,-15.38,4,2,14,20,10.00,5,1,7,57.14,0,0,2,2,0.00
11800,ITA,20,Nelli Gabriele ,O,4,0,1,-13.79,5,4,4,5,13,0.00,0,4,3,7,-57.14,1,1,7,9,0.00,0,0,0,0, ,2,2,4,0.00,0,0,1,1,0.00
11800,ITA,21,Spirito Luca ,S,1,0,0,0.00,1,1,0,0,1,100.00,0,1,0,1,-100.00,0,0,2,2,0.00,0,0,0,0, ,0,0,0, ,5,0,14,19,26.32
11800,ITA,23,Pinali Giulio ,O,11,0,1,12.90,12,11,1,5,17,58.82,0,4,1,5,-80.00,1,3,5,9,-22.22,0,0,0,0, ,5,1,6,66.67,0,0,2,2,0.00
11800,ITA,24,Cavuto Oreste ,OH,0,0,0, ,0,0,0,0,0, ,0,0,0,0, ,0,0,0,0, ,0,0,0,0, ,0,0,0, ,0,0,0,0, 
11800,ITA,25,Vitelli Marco ,MB,2,2,0,-7.14,4,2,0,3,5,40.00,2,5,3,10,-30.00,0,1,12,13,-7.69,0,0,1,1,0.00,3,1,5,40.00,0,0,0,0, 
11800,ITA,26,Cortesia Lorenzo ,MB,1,0,0,-15.38,1,1,0,2,3,33.33,0,2,4,6,-33.33,0,1,3,4,-25.00,0,0,0,0, ,2,1,3,33.33,0,0,0,0, 
11800,ITA,28,Recine Francesco ,OH,16,1,0,8.77,17,16,5,17,38,28.95,1,5,2,8,-50.00,0,2,9,11,-18.18,5,2,23,30,10.00,6,0,7,85.71,0,0,1,1,0.00
11800,ITA,29,Bottolo Mattia ,OH,2,0,1,12.50,3,2,0,2,4,50.00,0,0,0,0, ,1,2,1,4,-25.00,1,0,1,2,50.00,0,0,0, ,0,0,0,0, 
11800,ITA,30,Mosca Leandro Ausibio ,MB,6,3,0,2.17,9,6,1,4,11,45.45,3,6,7,16,-18.75,0,1,18,19,-5.26,0,0,3,3,0.00,3,0,3,100.00,0,0,0,0, 
11800,ITA,31,Federici Filippo ,L,0,0,0, ,0,0,0,0,0, ,0,0,0,0, ,0,0,0,0, ,0,0,0,0, ,0,0,0, ,0,0,0,0, 
11801,SLO,1,Å tern TonÄek ,O,15,2,1,3.92,18,15,8,5,28,25.00,2,2,0,4,0.00,1,6,12,19,-26.32,0,0,0,0, ,7,2,11,45.45,0,0,2,2,0.00
11801,SLO,2,Pajenk Alen ,MB,8,4,1,7.32,13,8,0,4,12,66.67,4,4,3,11,0.00,1,6,11,18,-27.78,0,0,3,3,0.00,2,0,2,100.00,0,0,0,0, 
11801,SLO,4,Kozamernik Jan ,MB,4,2,1,-7.14,7,4,2,3,9,22.22,2,6,6,14,-28.57,1,2,16,19,-5.26,1,0,0,1,100.00,2,1,4,25.00,0,0,1,1,0.00
11801,SLO,5,Å ket Alen ,O,0,0,0,0.00,0,0,0,1,1,0.00,0,0,0,0, ,0,0,2,2,0.00,0,0,0,0, ,0,0,1,0.00,0,0,0,0, 
11801,SLO,6,Gasparini Mitja ,O,0,0,0, ,0,0,0,0,0, ,0,0,0,0, ,0,0,0,0, ,0,0,0,0, ,0,0,0, ,0,0,0,0, 
11801,SLO,9,Vincic Dejan ,S,0,0,0, ,0,0,0,0,0, ,0,0,0,0, ,0,0,0,0, ,0,0,0,0, ,0,0,0, ,0,0,0,0, 
11801,SLO,10,Å talekar SaÅ¡o ,MB,0,0,0, ,0,0,0,0,0, ,0,0,0,0, ,0,0,0,0, ,0,0,0,0, ,0,0,0, ,0,0,0,0, 
11801,SLO,11,Å tern Å½iga ,OH,0,0,0, ,0,0,0,0,0, ,0,0,0,0, ,0,0,0,0, ,0,0,0,0, ,0,0,0, ,0,0,0,0, 
11801,SLO,13,KovaÄiÄ Jani ,L,0,0,0, ,0,0,0,0,0, ,0,0,0,0, ,0,0,0,0, ,6,1,8,15,33.33,13,3,17,58.82,1,0,5,6,16.67
11801,SLO,15,VideÄnik Matic ,MB,0,0,0, ,0,0,0,0,0, ,0,0,0,0, ,0,0,0,0, ,0,0,0,0, ,0,0,0, ,0,0,0,0, 
11801,SLO,16,Ropret Gregor ,S,1,1,1,-14.81,3,1,0,0,1,100.00,1,5,2,8,-50.00,1,2,15,18,-5.56,0,0,2,2,0.00,4,3,9,11.11,20,1,93,114,16.67
11801,SLO,17,Urnaut Tine ,OH,16,0,0,4.48,16,16,2,17,35,40.00,0,5,3,8,-62.50,0,6,18,24,-25.00,7,2,30,39,12.82,9,0,11,81.82,0,0,3,3,0.00
11801,SLO,18,Äebulj Klemen ,OH,25,2,0,24.62,27,25,5,13,43,46.51,2,3,0,5,-20.00,0,3,14,17,-17.65,6,3,22,31,9.68,4,5,11,-9.09,0,0,5,5,0.00
11801,SLO,19,MoÅ¾iÄ Rok ,OH,0,0,0, ,0,0,0,0,0, ,0,0,0,0, ,0,0,0,0, ,0,0,0,0, ,0,0,0, ,0,0,0,0, 
11801,USA,1,Anderson Matthew ,O,8,1,0,-2.50,9,8,5,11,24,12.50,1,4,1,6,-50.00,0,1,9,10,-10.00,2,0,3,5,40.00,4,3,7,14.29,0,0,3,3,0.00
11801,USA,3,Sander Taylor ,OH,16,4,1,11.48,21,16,4,13,33,36.36,4,3,2,9,11.11,1,7,11,19,-31.58,17,2,17,36,41.67,7,1,9,66.67,1,0,2,3,33.33
11801,USA,4,Jendryk II Jeffrey ,MB,0,0,0, ,0,0,0,0,0, ,0,0,0,0, ,0,0,0,0, ,0,0,0,0, ,0,0,0, ,0,0,0,0, 
11801,USA,5,Ensing Kyle ,O,5,0,0,-6.25,5,5,3,2,10,20.00,0,2,0,2,-100.00,0,1,3,4,-25.00,0,0,0,0, ,0,0,1,0.00,0,0,1,1,0.00
11801,USA,6,Stahl Mitchell ,MB,4,0,1,0.00,5,4,0,0,4,100.00,0,2,0,2,-100.00,1,3,0,4,-50.00,0,0,0,0, ,0,0,0, ,0,0,0,0, 
11801,USA,7,Shoji Kawika ,S,0,0,0, ,0,0,0,0,0, ,0,0,0,0, ,0,0,0,0, ,0,0,0,0, ,0,0,0, ,0,0,0,0, 
11801,USA,8,Defalco Torey ,OH,15,1,1,10.17,17,15,2,12,29,44.83,1,7,2,10,-60.00,1,2,17,20,-5.00,8,1,25,34,20.59,12,3,17,52.94,0,0,3,3,0.00
11801,USA,11,Christenson Micah ,S,0,1,0,-29.27,1,0,0,4,4,0.00,1,10,5,16,-56.25,0,3,18,21,-14.29,0,0,1,1,0.00,7,2,11,45.45,42,0,66,108,38.89
11801,USA,12,Holt Maxwell ,MB,9,2,1,7.69,12,9,2,4,15,46.67,2,4,2,8,-25.00,1,3,12,16,-12.50,0,0,0,0, ,5,1,6,66.67,0,0,2,2,0.00
11801,USA,15,Sander Brenden ,OH,0,0,0, ,0,0,0,0,0, ,0,0,0,0, ,0,0,0,0, ,0,0,0,0, ,0,0,0, ,0,0,0,0, 
11801,USA,17,Jaeschke Thomas ,OH,0,0,0, ,0,0,0,0,0, ,0,0,0,0, ,0,0,0,0, ,0,1,0,1,-100.00,0,0,0, ,0,0,0,0, 
11801,USA,18,Muagututia Garrett ,OH,0,0,1,-14.29,1,0,0,1,1,0.00,0,1,0,1,-100.00,1,1,3,5,0.00,0,0,1,1,0.00,1,0,1,100.00,0,0,0,0, 
11801,USA,20,Smith David ,MB,4,1,1,-13.89,6,4,4,3,11,0.00,1,6,4,11,-45.45,1,1,12,14,0.00,0,0,0,0, ,5,0,6,83.33,0,0,2,2,0.00
11801,USA,22,Shoji Erik ,L,0,0,0, ,0,0,0,0,0, ,0,0,0,0, ,0,0,0,0, ,2,0,12,14,14.29,9,0,9,100.00,0,0,7,7,0.00
11802,POL,1,Nowakowski Piotr ,MB,0,0,0, ,0,0,0,0,0, ,0,0,0,0, ,0,0,0,0, ,0,0,0,0, ,0,0,0, ,0,0,0,0, 
11802,POL,5,Kaczmarek Lukasz ,O,1,1,0,66.67,2,1,0,0,1,100.00,1,0,0,1,100.00,0,0,1,1,0.00,0,0,0,0, ,0,0,0, ,0,0,0,0, 
11802,POL,6,Kurek Bartosz ,O,9,1,2,15.00,12,9,1,10,20,40.00,1,1,5,7,0.00,2,4,7,13,-15.38,0,0,0,0, ,3,4,8,-12.50,0,0,2,2,0.00
11802,POL,10,Wojtaszek Damian ,L,0,0,0, ,0,0,0,0,0, ,0,0,0,0, ,0,0,0,0, ,0,0,0,0, ,0,0,0, ,0,0,0,0, 
11802,POL,11,Drzyzga Fabian ,S,1,0,2,13.33,3,1,0,0,1,100.00,0,1,2,3,-33.33,2,0,9,11,18.18,0,0,0,0, ,5,1,6,66.67,25,0,39,64,39.06
11802,POL,12,Lomacz Grzegorz ,S,0,0,0, ,0,0,0,0,0, ,0,0,0,0, ,0,0,0,0, ,0,0,0,0, ,0,0,0, ,1,0,2,3,33.33
11802,POL,13,Kubiak Michal ,OH,9,0,1,0.00,10,9,1,5,15,53.33,0,6,1,7,-85.71,1,3,10,14,-14.29,3,1,12,16,12.50,8,1,10,70.00,0,0,3,3,0.00
11802,POL,14,Sliwka Aleksander ,OH,0,0,0, ,0,0,0,0,0, ,0,0,0,0, ,0,0,0,0, ,0,0,0,0, ,0,0,0, ,0,0,0,0, 
11802,POL,16,Semeniuk Kamil ,OH,13,0,0,10.00,13,13,3,9,25,40.00,0,2,1,3,-66.67,0,4,8,12,-33.33,2,0,14,16,12.50,5,1,9,44.44,0,0,3,3,0.00
11802,POL,17,Zatorski Pawel ,L,0,0,0, ,0,0,0,0,0, ,0,0,0,0, ,0,0,0,0, ,6,0,8,14,42.86,6,1,8,62.50,0,0,3,3,0.00
11802,POL,20,Bieniek Mateusz ,MB,5,0,2,-8.33,7,5,0,5,10,50.00,0,6,6,12,-50.00,2,4,8,14,-14.29,0,0,0,0, ,2,0,2,100.00,0,0,0,0, 
11802,POL,21,Fornal Tomasz ,OH,0,0,0, ,0,0,0,0,0, ,0,0,0,0, ,0,0,0,0, ,0,0,0,0, ,0,0,0, ,0,0,0,0, 
11802,POL,22,Bednorz Bartosz ,OH,0,0,0, ,0,0,0,0,0, ,0,0,0,0, ,0,0,0,0, ,0,0,0,0, ,0,0,0, ,0,0,0,0, 
11802,POL,77,Klos Karol ,MB,6,1,0,8.70,7,6,1,1,8,62.50,1,4,2,7,-42.86,0,0,8,8,0.00,0,0,0,0, ,2,0,3,66.67,0,0,0,0, 
11802,ARG,2,Pereyra Federico ,O,10,0,0,16.00,10,10,3,3,16,43.75,0,1,0,1,-100.00,0,2,6,8,-25.00,0,0,0,0, ,2,1,5,20.00,0,0,1,1,0.00
11802,ARG,3,Martinez Franchi Jan ,OH,0,0,0, ,0,0,0,0,0, ,0,0,0,0, ,0,0,0,0, ,0,0,0,0, ,0,0,0, ,0,0,0,0, 
11802,ARG,5,Uriarte Nicolas ,S,0,1,0,0.00,1,0,0,0,0, ,1,0,1,2,50.00,0,1,4,5,-20.00,0,0,0,0, ,1,1,2,0.00,16,0,26,42,38.10
11802,ARG,6,Poglajen Cristian ,OH,7,0,0,14.29,7,7,0,8,15,46.67,0,0,3,3,0.00,0,3,7,10,-30.00,3,3,7,13,0.00,3,3,7,0.00,0,0,1,1,0.00
11802,ARG,7,Conte Facundo ,OH,4,0,0,-12.90,4,4,2,10,16,12.50,0,3,1,4,-75.00,0,3,8,11,-27.27,7,2,16,25,20.00,8,2,10,60.00,0,0,0,0, 
11802,ARG,8,Loser Agustin ,MB,4,0,1,-21.21,5,4,0,4,8,50.00,0,7,7,14,-50.00,1,5,5,11,-36.36,0,0,0,0, ,0,0,1,0.00,0,0,2,2,0.00
11802,ARG,9,Danani Santiago ,L,0,0,0, ,0,0,0,0,0, ,0,0,0,0, ,0,0,0,0, ,2,2,13,17,0.00,4,4,9,0.00,0,0,1,1,0.00
11802,ARG,10,Lazo NicolÃ¡s ,OH,0,0,0, ,0,0,0,0,0, ,0,0,0,0, ,0,0,0,0, ,0,0,0,0, ,0,0,0, ,0,0,0,0, 
11802,ARG,12,Lima Bruno ,O,4,0,0,7.14,4,4,1,3,8,37.50,0,1,0,1,-100.00,0,1,4,5,-20.00,0,0,0,0, ,1,1,2,0.00,0,0,0,0, 
11802,ARG,13,Palacios Ezequiel ,OH,0,0,0, ,0,0,0,0,0, ,0,0,0,0, ,0,0,0,0, ,0,0,0,0, ,0,0,0, ,0,0,0,0, 
11802,ARG,15,De Cecco Luciano ,S,0,0,0,0.00,0,0,0,0,0, ,0,0,0,0, ,0,0,2,2,0.00,0,0,0,0, ,0,0,0, ,10,0,16,26,38.46
11802,ARG,17,Mendez Nicolas ,OH,0,0,0, ,0,0,0,0,0, ,0,0,0,0, ,0,0,0,0, ,0,0,0,0, ,0,0,0, ,0,0,0,0, 
11802,ARG,18,Ramos Martin ,MB,8,0,0,3.23,8,8,0,2,10,80.00,0,5,5,10,-50.00,0,2,9,11,-18.18,1,0,2,3,33.33,3,3,8,0.00,0,0,0,0, 
11802,ARG,19,Massimino Franco ,L,0,0,0, ,0,0,0,0,0, ,0,0,0,0, ,0,0,0,0, ,0,0,0,0, ,0,0,0, ,0,0,0,0, 
11803,GER,1,Fromm Christian ,OH,0,0,0,0.00,0,0,0,1,1,0.00,0,0,0,0, ,0,0,0,0, ,0,0,0,0, ,0,0,0, ,0,0,1,1,0.00
11803,GER,3,Schott Ruben ,OH,0,0,0,-40.00,0,0,0,0,0, ,0,0,0,0, ,0,2,3,5,-40.00,0,0,0,0, ,0,0,0, ,0,0,0,0, 
11803,GER,5,Reichert Moritz ,OH,12,0,0,2.04,12,12,4,13,29,27.59,0,4,2,6,-66.67,0,3,11,14,-21.43,8,3,13,24,20.83,3,1,5,40.00,0,0,5,5,0.00
11803,GER,6,Kaliberda Denys ,OH,9,1,0,5.26,10,9,1,7,17,47.06,1,3,1,5,-40.00,0,4,12,16,-25.00,8,2,19,29,20.69,6,1,10,50.00,0,0,5,5,0.00
11803,GER,7,Sossenheimer David ,OH,0,0,0,-50.00,0,0,0,0,0, ,0,0,0,0, ,0,1,1,2,-50.00,0,0,0,0, ,0,0,0, ,0,0,0,0, 
11803,GER,8,BÃ¶hme Marcus ,MB,0,0,0, ,0,0,0,0,0, ,0,0,0,0, ,0,0,0,0, ,0,0,0,0, ,0,0,0, ,0,0,0,0, 
11803,GER,10,Zenger Julian ,L,0,0,0, ,0,0,0,0,0, ,0,0,0,0, ,0,0,0,0, ,7,2,11,20,25.00,8,2,11,54.55,0,0,4,4,0.00
11803,GER,13,Hirsch Simon ,O,9,1,0,2.22,10,9,5,13,27,14.81,1,3,2,6,-33.33,0,1,11,12,-8.33,1,0,0,1,100.00,7,2,9,55.56,0,0,2,2,0.00
11803,GER,16,BurggrÃ¤f Eric ,S,0,0,0,0.00,0,0,0,0,0, ,0,0,0,0, ,0,0,1,1,0.00,0,0,0,0, ,1,0,1,100.00,0,0,7,7,0.00
11803,GER,17,Zimmermann Jan ,S,0,0,0,-36.84,0,0,0,2,2,0.00,0,4,2,6,-66.67,0,3,8,11,-27.27,0,0,0,0, ,5,5,11,0.00,20,1,51,72,26.39
11803,GER,18,Krage Florian ,MB,2,4,0,4.76,6,2,3,2,7,-14.29,4,2,0,6,33.33,0,0,8,8,0.00,0,1,0,1,-100.00,1,0,1,100.00,0,0,0,0, 
11803,GER,19,RÃ¶hrs Erik ,OH,0,0,0, ,0,0,0,0,0, ,0,0,0,0, ,0,0,0,0, ,0,0,0,0, ,0,0,0, ,0,0,0,0, 
11803,GER,20,Weber Linus ,O,0,0,0,-50.00,0,0,1,1,2,-50.00,0,0,0,0, ,0,0,0,0, ,0,0,0,0, ,1,0,1,100.00,0,0,0,0, 
11803,GER,21,Krick Tobias ,MB,10,1,0,12.90,11,10,1,2,13,69.23,1,4,5,10,-30.00,0,2,6,8,-25.00,0,0,2,2,0.00,2,0,2,100.00,0,0,1,1,0.00
11803,RUS,1,Podlesnykh Yaroslav ,OH,0,0,1,-12.50,1,0,0,0,0, ,0,0,0,0, ,1,2,5,8,-12.50,0,0,0,0, ,0,0,0, ,0,0,0,0, 
11803,RUS,2,Vlasov Ilia ,MB,8,1,1,-3.33,10,8,0,2,10,80.00,1,7,3,11,-54.55,1,4,4,9,-33.33,0,0,1,1,0.00,1,0,1,100.00,0,0,2,2,0.00
11803,RUS,4,Volvich Artem ,MB,0,0,0, ,0,0,0,0,0, ,0,0,0,0, ,0,0,0,0, ,0,0,0,0, ,0,0,0, ,0,0,0,0, 
11803,RUS,6,Baranov Evgeny ,L,0,0,0, ,0,0,0,0,0, ,0,0,0,0, ,0,0,0,0, ,0,0,0,0, ,0,0,0, ,0,0,0,0, 
11803,RUS,7,Volkov Dmitry ,OH,11,1,2,11.63,14,11,2,4,17,52.94,1,3,3,7,-28.57,2,4,13,19,-10.53,6,0,17,23,26.09,6,2,8,50.00,0,0,1,1,0.00
11803,RUS,9,Iakovlev Ivan ,MB,0,0,0, ,0,0,0,0,0, ,0,0,0,0, ,0,0,0,0, ,0,0,0,0, ,0,0,0, ,0,0,0,0, 
11803,RUS,10,Bogdan Denis ,OH,0,0,0,-33.33,0,0,0,0,0, ,0,0,0,0, ,0,1,2,3,-33.33,0,0,0,0, ,0,0,0, ,0,0,1,1,0.00
11803,RUS,11,Pankov Pavel ,S,0,0,0, ,0,0,0,0,0, ,0,0,0,0, ,0,0,0,0, ,0,0,0,0, ,0,0,0, ,0,0,0,0, 
11803,RUS,15,Poletaev Victor ,O,0,0,0, ,0,0,0,0,0, ,0,0,0,0, ,0,0,0,0, ,0,0,0,0, ,0,0,0, ,0,0,0,0, 
11803,RUS,17,Mikhaylov Maxim ,O,17,0,1,24.49,18,17,4,11,32,40.62,0,0,5,5,0.00,1,2,9,12,-8.33,0,0,1,1,0.00,7,1,9,66.67,0,0,2,2,0.00
11803,RUS,18,Kliuka Egor ,OH,11,1,2,10.20,14,11,6,9,26,19.23,1,1,2,4,0.00,2,2,15,19,0.00,3,0,14,17,17.65,5,0,5,100.00,1,0,2,3,33.33
11803,RUS,20,Kurkaev Ilyas ,MB,9,4,0,23.33,13,9,0,2,11,81.82,4,3,6,13,7.69,0,3,3,6,-50.00,1,0,1,2,50.00,0,0,0, ,0,0,2,2,0.00
11803,RUS,24,Kobzar Igor ,S,2,2,1,0.00,5,2,0,1,3,66.67,2,3,3,8,-12.50,1,2,18,21,-4.76,0,0,0,0, ,8,2,11,54.55,27,1,53,81,32.10
11803,RUS,27,Golubev Valentin ,L,0,0,0, ,0,0,0,0,0, ,0,0,0,0, ,0,0,0,0, ,6,0,11,17,35.29,10,4,14,42.86,0,0,6,6,0.00
11804,CAN,2,Perrin John Gordon ,OH,0,0,0, ,0,0,0,0,0, ,0,0,0,0, ,0,0,0,0, ,0,0,0,0, ,0,0,0, ,0,0,0,0, 
11804,CAN,3,Marshall Steven ,OH,2,0,0,-15.38,2,2,1,1,4,25.00,0,2,0,2,-100.00,0,1,6,7,-14.29,1,0,2,3,33.33,2,0,2,100.00,0,0,1,1,0.00
11804,CAN,4,Hoag Nicholas ,OH,4,0,2,21.74,6,4,1,3,8,37.50,0,0,3,3,0.00,2,0,10,12,16.67,4,0,6,10,40.00,5,1,7,57.14,0,0,3,3,0.00
11804,CAN,7,Maar Stephen Timothy ,OH,10,2,1,16.22,13,10,1,9,20,45.00,2,1,2,5,20.00,1,5,6,12,-33.33,5,0,4,9,55.56,5,0,5,100.00,0,0,3,3,0.00
11804,CAN,8,Blankenau Jay ,S,2,0,0,0.00,2,2,0,2,4,50.00,0,1,2,3,-33.33,0,1,10,11,-9.09,0,0,0,0, ,8,3,12,41.67,22,1,30,53,39.62
11804,CAN,10,Sclater Ryan Joseph ,O,12,2,2,22.73,16,12,1,9,22,50.00,2,3,3,8,-12.50,2,2,10,14,0.00,0,0,0,0, ,7,0,7,100.00,0,0,0,0, 
11804,CAN,11,Jansen Vandoorn Daniel ,MB,7,2,0,28.00,9,7,0,1,8,87.50,2,1,6,9,11.11,0,1,7,8,-12.50,1,0,0,1,100.00,0,1,2,-50.00,0,0,0,0, 
11804,CAN,12,Van Berkel Lucas ,MB,0,0,0, ,0,0,0,0,0, ,0,0,0,0, ,0,0,0,0, ,0,0,0,0, ,0,0,0, ,0,0,0,0, 
11804,CAN,13,Vernon-Evans Sharone ,O,0,0,0, ,0,0,0,0,0, ,0,0,0,0, ,0,0,0,0, ,0,0,0,0, ,0,0,0, ,0,0,0,0, 
11804,CAN,14,Loeppky Eric ,OH,0,0,0, ,0,0,0,0,0, ,0,0,0,0, ,0,0,0,0, ,0,0,0,0, ,0,0,0, ,0,0,0,0, 
11804,CAN,17,Vigrass Graham ,MB,0,0,0, ,0,0,0,0,0, ,0,0,0,0, ,0,0,0,0, ,0,0,0,0, ,0,0,0, ,0,0,0,0, 
11804,CAN,19,Bann Blair Cameron ,L,0,0,0, ,0,0,0,0,0, ,0,0,0,0, ,0,0,0,0, ,6,2,3,11,36.36,11,2,14,64.29,0,0,5,5,0.00
11804,CAN,20,Szwarc Arthur ,O,4,3,0,0.00,7,4,0,4,8,50.00,3,2,6,11,9.09,0,5,4,9,-55.56,0,0,0,0, ,2,0,3,66.67,0,0,0,0, 
11804,CAN,21,Walsh Brett James ,S,0,1,0,100.00,1,0,0,0,0, ,1,0,0,1,100.00,0,0,0,0, ,0,0,0,0, ,0,0,0, ,0,0,4,4,0.00
11804,AUS,1,Graham Beau ,MB,3,0,0,-11.11,3,3,2,7,12,8.33,0,2,1,3,-66.67,0,1,2,3,-33.33,0,0,0,0, ,2,1,5,20.00,0,1,2,3,-33.33
11804,AUS,2,Dosanjh Arshdeep ,S,1,0,0,-27.27,1,1,1,1,3,0.00,0,2,0,2,-100.00,0,1,5,6,-16.67,0,0,0,0, ,3,1,6,33.33,9,1,39,49,16.33
11804,AUS,3,Macdonald Steven ,MB,0,0,0, ,0,0,0,0,0, ,0,0,0,0, ,0,0,0,0, ,0,0,0,0, ,0,0,0, ,0,0,0,0, 
11804,AUS,7,Weir James ,MB,1,0,0,-22.22,1,1,1,5,7,0.00,0,2,1,3,-66.67,0,2,6,8,-25.00,0,0,0,0, ,1,0,2,50.00,0,0,2,2,0.00
11804,AUS,8,O'Dea Trent ,MB,2,0,0,-16.67,2,2,0,2,4,50.00,0,2,2,4,-50.00,0,2,2,4,-50.00,0,0,2,2,0.00,1,0,1,100.00,0,0,0,0, 
11804,AUS,11,Perry Luke ,L,0,0,0, ,0,0,0,0,0, ,0,0,0,0, ,0,0,0,0, ,3,0,7,10,30.00,7,2,13,38.46,0,0,9,9,0.00
11804,AUS,12,Mote Nehemiah ,MB,2,0,1,-5.00,3,2,0,6,8,25.00,0,3,2,5,-60.00,1,1,5,7,0.00,0,0,1,1,0.00,3,0,3,100.00,0,0,0,0, 
11804,AUS,21,Butler Nicholas ,S,1,1,0,25.00,2,1,0,0,1,100.00,1,1,0,2,0.00,0,0,1,1,0.00,0,0,0,0, ,0,0,0, ,2,0,9,11,18.18
11804,AUS,27,Senica Max ,OH,2,0,1,-5.26,3,2,2,6,10,0.00,0,0,1,1,0.00,1,2,5,8,-12.50,9,1,13,23,34.78,8,1,11,63.64,0,0,1,1,0.00
11804,AUS,28,Taylor Tim ,OH,0,0,0, ,0,0,0,0,0, ,0,0,0,0, ,0,0,0,0, ,0,0,0,0, ,0,0,0, ,0,0,0,0, 
11804,AUS,29,Garrett Ethan ,OH,0,0,0,-50.00,0,0,3,3,6,-50.00,0,3,1,4,-75.00,0,1,3,4,-25.00,1,0,5,6,16.67,0,0,1,0.00,0,0,2,2,0.00
11804,AUS,31,Aubrey Matthew ,O,0,0,0, ,0,0,0,0,0, ,0,0,0,0, ,0,0,0,0, ,0,0,0,0, ,0,0,0, ,0,0,0,0, 
11804,AUS,32,Azeez Oluwatobi Elliot ,OH,10,0,0,2.63,10,10,5,12,27,18.52,0,1,4,5,-20.00,0,3,3,6,-50.00,2,4,10,16,-12.50,1,2,4,-25.00,0,0,0,0, 
11804,AUS,34,Greber Billy ,L,0,0,0, ,0,0,0,0,0, ,0,0,0,0, ,0,0,0,0, ,0,0,0,0, ,0,0,0, ,0,0,0,0, 
11805,SRB,3,Kapur Milorad ,L,0,0,0, ,0,0,0,0,0, ,0,0,0,0, ,0,0,0,0, ,0,0,0,0, ,2,4,7,-28.57,0,0,2,2,0.00
11805,SRB,6,Pekovic Nikola ,L,0,0,0, ,0,0,0,0,0, ,0,0,0,0, ,0,0,0,0, ,6,1,11,18,27.78,7,2,9,55.56,0,0,2,2,0.00
11805,SRB,7,Krsmanovic Petar ,MB,8,1,3,10.87,12,8,0,4,12,66.67,1,6,7,14,-35.71,3,1,16,20,10.00,0,1,0,1,-100.00,3,1,5,40.00,0,1,1,2,-50.00
11805,SRB,8,Ivovic Marko ,OH,11,0,1,13.89,12,11,1,5,17,58.82,0,2,0,2,-100.00,1,4,12,17,-17.65,11,2,20,33,27.27,2,1,3,33.33,0,0,10,10,0.00
11805,SRB,9,Jovovic Nikola ,S,0,0,0,-28.57,0,0,0,0,0, ,0,2,2,4,-50.00,0,2,8,10,-20.00,0,0,0,0, ,2,2,5,0.00,22,1,44,67,31.34
11805,SRB,10,KujundÅ¾iÄ Miran ,OH,10,2,0,10.81,12,10,1,7,18,50.00,2,4,2,8,-25.00,0,3,8,11,-27.27,8,0,10,18,44.44,1,2,4,-25.00,0,0,0,0, 
11805,SRB,11,Batak Aleksa ,S,0,0,0, ,0,0,0,0,0, ,0,0,0,0, ,0,0,0,0, ,0,0,0,0, ,0,0,0, ,0,0,0,0, 
11805,SRB,12,Peric Pavle ,OH,6,1,0,10.53,7,6,2,2,10,40.00,1,0,1,2,50.00,0,3,4,7,-42.86,1,2,9,12,-8.33,2,1,4,25.00,0,0,0,0, 
11805,SRB,14,Atanasijevic Aleksandar ,O,0,0,0, ,0,0,0,0,0, ,0,0,0,0, ,0,0,0,0, ,0,0,0,0, ,0,0,0, ,0,0,0,0, 
11805,SRB,16,Luburic Drazen ,O,24,1,8,19.48,33,24,8,10,42,38.10,1,6,1,8,-62.50,8,4,15,27,14.81,0,0,0,0, ,3,2,5,20.00,0,0,2,2,0.00
11805,SRB,18,Podrascanin Marko ,MB,5,0,0,-14.71,5,5,4,2,11,9.09,0,5,6,11,-45.45,0,1,11,12,-8.33,1,0,1,2,50.00,5,1,6,66.67,0,0,1,1,0.00
11805,SRB,21,Todorovic Vuk ,S,0,0,0,-20.00,0,0,0,0,0, ,0,1,0,1,-100.00,0,0,4,4,0.00,0,0,0,0, ,1,0,1,100.00,6,0,18,24,25.00
11805,SRB,23,Vucicevic Bozidar ,O,0,0,0, ,0,0,0,0,0, ,0,0,0,0, ,0,0,0,0, ,0,0,0,0, ,0,0,0, ,0,0,0,0, 
11805,SRB,26,Kovac Davide ,OH,0,0,0, ,0,0,0,0,0, ,0,0,0,0, ,0,0,0,0, ,0,0,3,3,0.00,0,0,0, ,0,0,0,0, 
11805,NED,2,Keemink Wessel ,S,1,4,0,4.17,5,1,0,2,3,33.33,4,3,0,7,14.29,0,1,13,14,-7.14,0,0,0,0, ,4,2,6,33.33,18,0,60,78,23.08
11805,NED,4,Ter Horst Thijs ,OH,15,0,2,12.24,17,15,3,7,25,48.00,0,4,1,5,-80.00,2,4,13,19,-10.53,5,1,16,22,18.18,4,4,8,0.00,0,0,5,5,0.00
11805,NED,5,van der Ent Luuc ,MB,7,2,1,15.62,10,7,0,3,10,70.00,2,4,4,10,-20.00,1,1,10,12,0.00,0,0,0,0, ,2,2,6,0.00,0,0,1,1,0.00
11805,NED,6,Dronkers Just ,L,0,0,0, ,0,0,0,0,0, ,0,0,0,0, ,0,0,0,0, ,11,6,15,32,15.62,13,5,18,44.44,0,0,3,3,0.00
11805,NED,8,Plak Fabian ,MB,1,0,1,11.11,2,1,0,1,2,50.00,0,1,1,2,-50.00,1,0,4,5,20.00,0,0,0,0, ,2,1,3,33.33,0,0,1,1,0.00
11805,NED,10,van Zeist Maikel ,MB,1,0,0,100.00,1,1,0,0,1,100.00,0,0,0,0, ,0,0,0,0, ,0,0,0,0, ,0,0,0, ,0,0,0,0, 
11805,NED,12,Tuinstra Bennie Junior ,OH,8,1,0,9.68,9,8,3,8,19,26.32,1,1,0,2,0.00,0,2,8,10,-20.00,9,2,11,22,31.82,2,2,5,0.00,0,1,1,2,-50.00
11805,NED,13,Ottevanger Steven ,L,0,0,0, ,0,0,0,0,0, ,0,0,0,0, ,0,0,0,0, ,0,0,0,0, ,0,0,0, ,0,0,0,0, 
11805,NED,15,van Solkema Gijs ,S,0,0,0, ,0,0,0,0,0, ,0,0,0,0, ,0,0,0,0, ,0,0,0,0, ,0,0,0, ,0,0,0,0, 
11805,NED,18,Andringa Robbert ,L,3,1,1,-16.67,5,3,2,2,7,14.29,1,2,0,3,-33.33,1,4,3,8,-37.50,2,1,7,10,10.00,0,0,0, ,0,0,2,2,0.00
11805,NED,19,de Weijer Freek ,S,0,0,0,0.00,0,0,0,0,0, ,0,0,1,1,0.00,0,0,1,1,0.00,0,0,0,0, ,0,0,0, ,6,0,6,12,50.00
11805,NED,21,van Schie Stijn ,OH,1,1,0,100.00,2,1,0,0,1,100.00,1,0,0,1,100.00,0,0,0,0, ,0,0,0,0, ,0,0,0, ,0,0,0,0, 
11805,NED,22,Wiltenburg Twan ,MB,3,1,1,-12.50,5,3,1,2,6,33.33,1,6,5,12,-41.67,1,3,18,22,-9.09,1,1,0,2,0.00,1,0,1,100.00,0,0,0,0, 
11805,NED,25,van Tilburg Stijn ,OH,20,1,0,16.36,21,20,5,7,32,46.88,1,4,4,9,-33.33,0,3,11,14,-21.43,0,1,1,2,-50.00,4,3,11,9.09,0,0,2,2,0.00
11806,BUL,1,Karyagin Denis ,O,0,0,0,-50.00,0,0,3,2,5,-60.00,0,0,0,0, ,0,0,1,1,0.00,0,0,0,0, ,1,0,1,100.00,0,1,0,1,-100.00
11806,BUL,2,Chavdarov Stefan ,MB,4,0,0,-4.55,4,4,0,2,6,66.67,0,4,6,10,-40.00,0,1,5,6,-16.67,0,0,2,2,0.00,4,1,5,60.00,0,0,0,0, 
11806,BUL,3,Kolev Nikolay ,MB,5,0,0,3.70,5,5,0,2,7,71.43,0,4,4,8,-50.00,0,0,12,12,0.00,0,0,0,0, ,3,0,4,75.00,0,0,2,2,0.00
11806,BUL,4,Atanasov Martin ,OH,0,0,0, ,0,0,0,0,0, ,0,0,0,0, ,0,0,0,0, ,0,0,0,0, ,0,0,0, ,0,0,0,0, 
11806,BUL,6,Stankov Vladimir ,S,0,1,0,-33.33,1,0,1,0,1,-100.00,1,1,1,3,0.00,0,4,7,11,-36.36,0,0,0,0, ,3,1,5,40.00,11,1,49,61,16.39
11806,BUL,9,Seganov Georgi ,S,0,0,0, ,0,0,0,0,0, ,0,0,0,0, ,0,0,0,0, ,0,0,0,0, ,0,1,1,-100.00,1,0,12,13,7.69
11806,BUL,12,Petrov Georgi ,OH,7,0,0,13.79,7,7,1,8,16,37.50,0,2,4,6,-33.33,0,0,7,7,0.00,5,1,11,17,23.53,3,0,3,100.00,0,0,0,0, 
11806,BUL,14,Asparuhov Asparuh ,OH,2,0,0,50.00,2,2,0,1,3,66.67,0,0,0,0, ,0,0,1,1,0.00,0,0,4,4,0.00,0,0,0, ,0,0,0,0, 
11806,BUL,15,Lyutskanov Gordan ,OH,8,1,0,0.00,9,8,5,7,20,15.00,1,2,0,3,-33.33,0,2,5,7,-28.57,5,2,12,19,15.79,1,1,3,0.00,0,0,1,1,0.00
11806,BUL,16,Ivanov Vladislav ,L,0,0,0, ,0,0,0,0,0, ,0,0,0,0, ,0,0,0,0, ,0,0,0,0, ,0,0,0, ,0,0,0,0, 
11806,BUL,22,Kartev Nikolay ,MB,0,0,0, ,0,0,0,0,0, ,0,0,0,0, ,0,0,0,0, ,0,0,0,0, ,0,0,0, ,0,0,0,0, 
11806,BUL,24,Ivanov Martin ,L,0,0,0, ,0,0,0,0,0, ,0,0,0,0, ,0,0,0,0, ,4,1,14,19,15.79,5,3,9,22.22,0,0,1,1,0.00
11806,BUL,25,Parapunov Radoslav ,O,4,0,0,-30.56,4,4,9,8,21,-23.81,0,4,3,7,-57.14,0,2,6,8,-25.00,0,0,0,0, ,2,2,4,0.00,0,0,1,1,0.00
11806,BUL,26,Ivanov Svetoslav ,OH,0,0,0,0.00,0,0,0,1,1,0.00,0,0,0,0, ,0,0,0,0, ,0,1,1,2,-50.00,0,0,0, ,0,0,0,0, 
11806,USA,1,Anderson Matthew ,O,0,0,0, ,0,0,0,0,0, ,0,0,0,0, ,0,0,0,0, ,0,0,0,0, ,0,0,0, ,0,0,0,0, 
11806,USA,4,Jendryk II Jeffrey ,MB,6,4,0,29.63,10,6,1,3,10,50.00,4,1,3,8,37.50,0,0,9,9,0.00,0,0,3,3,0.00,2,0,2,100.00,0,0,0,0, 
11806,USA,5,Ensing Kyle ,O,8,0,0,-3.12,8,8,4,3,15,26.67,0,4,2,6,-66.67,0,1,10,11,-9.09,0,0,0,0, ,6,2,8,50.00,0,0,1,1,0.00
11806,USA,6,Stahl Mitchell ,MB,3,1,3,3.12,7,3,1,2,6,33.33,1,3,8,12,-16.67,3,2,9,14,7.14,0,0,0,0, ,1,0,1,100.00,0,0,0,0, 
11806,USA,7,Shoji Kawika ,S,2,0,1,-5.26,3,2,0,0,2,100.00,0,3,1,4,-75.00,1,1,11,13,0.00,0,0,0,0, ,3,0,4,75.00,22,0,45,67,32.84
11806,USA,8,Defalco Torey ,OH,0,0,0, ,0,0,0,0,0, ,0,0,0,0, ,0,0,0,0, ,0,0,0,0, ,0,0,0, ,0,0,0,0, 
11806,USA,9,Hanes Jake ,O,2,0,0,0.00,2,2,0,1,3,66.67,0,1,0,1,-100.00,0,1,6,7,-14.29,0,0,0,0, ,0,0,1,0.00,0,0,1,1,0.00
11806,USA,11,Christenson Micah ,S,0,0,0, ,0,0,0,0,0, ,0,0,0,0, ,0,0,0,0, ,0,0,0,0, ,0,0,0, ,0,0,0,0, 
11806,USA,12,Holt Maxwell ,MB,0,0,0, ,0,0,0,0,0, ,0,0,0,0, ,0,0,0,0, ,0,0,0,0, ,0,0,0, ,0,0,0,0, 
11806,USA,15,Sander Brenden ,OH,0,0,0, ,0,0,0,0,0, ,0,0,0,0, ,0,0,0,0, ,0,0,0,0, ,0,0,0, ,0,0,0,0, 
11806,USA,17,Jaeschke Thomas ,OH,7,2,1,11.11,10,7,1,10,18,33.33,2,2,3,7,0.00,1,3,7,11,-18.18,6,0,11,17,35.29,9,5,14,28.57,0,0,2,2,0.00
11806,USA,18,Muagututia Garrett ,OH,13,0,0,22.86,13,13,2,8,23,47.83,0,0,3,3,0.00,0,3,6,9,-33.33,7,0,7,14,50.00,6,1,8,62.50,0,0,1,1,0.00
11806,USA,20,Smith David ,MB,0,0,0, ,0,0,0,0,0, ,0,0,0,0, ,0,0,0,0, ,0,0,0,0, ,0,0,0, ,0,0,0,0, 
11806,USA,22,Shoji Erik ,L,0,0,0, ,0,0,0,0,0, ,0,0,0,0, ,0,0,0,0, ,3,0,7,10,30.00,8,3,11,45.45,0,0,6,6,0.00
11807,IRI,2,Ebadipour Ghara H. Milad ,OH,0,0,0, ,0,0,0,0,0, ,0,0,0,0, ,0,0,0,0, ,0,0,0,0, ,0,0,0, ,0,0,0,0, 
11807,IRI,3,Abedini Reza ,MB,0,1,0,33.33,1,0,0,0,0, ,1,0,0,1,100.00,0,0,2,2,0.00,0,0,0,0, ,0,0,0, ,0,0,1,1,0.00
11807,IRI,4,Marouflakrani Mir Saeid ,S,0,0,0, ,0,0,0,0,0, ,0,0,0,0, ,0,0,0,0, ,0,0,0,0, ,3,0,3,100.00,3,0,9,12,25.00
11807,IRI,6,Mousavi Eraghi Seyed Mohammad ,MB,0,0,0, ,0,0,0,0,0, ,0,0,0,0, ,0,0,0,0, ,0,0,0,0, ,0,0,0, ,0,0,0,0, 
11807,IRI,8,Hazratpourtalatappeh Mohammadreza ,L,0,0,0, ,0,0,0,0,0, ,0,0,0,0, ,0,0,0,0, ,0,0,0,0, ,0,0,0, ,0,0,0,0, 
11807,IRI,9,Gholami Masoud ,MB,1,0,0,-26.09,1,1,1,5,7,0.00,0,4,4,8,-50.00,0,2,6,8,-25.00,1,0,0,1,100.00,0,0,0, ,0,1,0,1,-100.00
11807,IRI,10,Ghafour Amir ,O,1,0,0,-9.09,1,1,1,2,4,0.00,0,1,1,2,-50.00,0,0,5,5,0.00,0,0,0,0, ,0,0,0, ,1,0,7,8,12.50
11807,IRI,12,Sharifi Morteza ,OH,10,1,0,14.29,11,10,3,10,23,30.43,1,1,1,3,0.00,0,2,7,9,-22.22,5,5,21,31,0.00,8,0,8,100.00,0,1,0,1,-100.00
11807,IRI,15,Mojarad Aliasghar ,MB,3,1,0,-15.00,4,3,0,3,6,50.00,1,5,1,7,-57.14,0,2,5,7,-28.57,0,0,2,2,0.00,2,0,2,100.00,0,0,3,3,0.00
11807,IRI,17,Salehi Meisam ,OH,0,0,0, ,0,0,0,0,0, ,0,0,0,0, ,0,0,0,0, ,0,0,0,0, ,0,0,0, ,0,0,0,0, 
11807,IRI,21,Salehi Arman ,L,0,0,0, ,0,0,0,0,0, ,0,0,0,0, ,0,0,0,0, ,5,0,11,16,31.25,8,2,11,54.55,0,1,11,12,-8.33
11807,IRI,22,Esfandiar Amirhossein ,OH,6,1,0,-17.65,7,6,7,7,20,-5.00,1,2,1,4,-25.00,0,4,6,10,-40.00,1,1,14,16,0.00,5,1,7,57.14,0,0,0,0, 
11807,IRI,23,Saadat Bardia ,O,6,0,2,-11.43,8,6,7,8,21,-4.76,0,2,1,3,-66.67,2,3,6,11,-9.09,0,0,0,0, ,2,0,2,100.00,0,0,0,0, 
11807,IRI,24,Karimisouchelmaei Javad ,S,0,1,1,0.00,2,0,0,1,1,0.00,1,0,2,3,33.33,1,2,3,6,-16.67,0,0,0,0, ,6,1,8,62.50,9,0,42,51,17.65
11807,POL,1,Nowakowski Piotr ,MB,4,2,2,3.12,8,4,1,3,8,37.50,2,5,7,14,-21.43,2,1,7,10,10.00,0,0,0,0, ,1,0,1,100.00,0,0,0,0, 
11807,POL,2,Muzaj Maciej ,O,1,2,0,-13.33,3,1,3,2,6,-33.33,2,2,2,6,0.00,0,0,3,3,0.00,0,0,0,0, ,2,0,2,100.00,0,0,1,1,0.00
11807,POL,4,Komenda Marcin ,S,0,0,0, ,0,0,0,0,0, ,0,0,0,0, ,0,0,0,0, ,0,0,0,0, ,0,0,0, ,0,0,0,0, 
11807,POL,5,Kaczmarek Lukasz ,O,5,1,0,9.09,6,5,3,2,10,20.00,1,1,3,5,0.00,0,0,7,7,0.00,0,0,0,0, ,2,0,4,50.00,0,0,0,0, 
11807,POL,9,Leon Venero Wilfredo ,OH,0,0,0, ,0,0,0,0,0, ,0,0,0,0, ,0,0,0,0, ,0,0,0,0, ,0,0,0, ,0,0,0,0, 
11807,POL,10,Wojtaszek Damian ,L,0,0,0, ,0,0,0,0,0, ,0,0,0,0, ,0,0,0,0, ,5,0,10,15,33.33,7,1,10,60.00,0,0,2,2,0.00
11807,POL,11,Drzyzga Fabian ,S,0,0,0, ,0,0,0,0,0, ,0,0,0,0, ,0,0,0,0, ,0,0,0,0, ,0,0,0, ,0,0,0,0, 
11807,POL,12,Lomacz Grzegorz ,S,0,1,0,-10.53,1,0,0,0,0, ,1,2,5,8,-12.50,0,1,10,11,-9.09,0,1,0,1,-100.00,4,0,5,80.00,18,1,41,60,28.33
11807,POL,14,Sliwka Aleksander ,OH,8,1,1,13.64,10,8,1,9,18,38.89,1,1,2,4,0.00,1,2,19,22,-4.55,5,1,6,12,33.33,4,2,6,33.33,0,0,1,1,0.00
11807,POL,15,Kochanowski Jakub ,MB,9,1,2,15.15,12,9,0,3,12,75.00,1,5,3,9,-44.44,2,2,8,12,0.00,0,0,3,3,0.00,3,0,3,100.00,0,0,1,1,0.00
11807,POL,17,Zatorski Pawel ,L,0,0,0, ,0,0,0,0,0, ,0,0,0,0, ,0,0,0,0, ,0,0,0,0, ,0,0,0, ,0,0,0,0, 
11807,POL,21,Fornal Tomasz ,OH,0,0,0, ,0,0,0,0,0, ,0,0,0,0, ,0,0,0,0, ,0,0,0,0, ,0,0,0, ,0,0,0,0, 
11807,POL,22,Bednorz Bartosz ,OH,4,3,1,-3.70,8,4,7,3,14,-21.43,3,1,1,5,40.00,1,1,6,8,0.00,3,1,8,12,16.67,6,1,7,71.43,0,0,3,3,0.00
11807,POL,99,Huber Norbert ,MB,0,0,0, ,0,0,0,0,0, ,0,0,0,0, ,0,0,0,0, ,0,0,0,0, ,0,0,0, ,0,0,0,0, 
11808,JPN,1,Shimizu Kunihiro ,O,12,0,0,-2.44,12,12,10,7,29,6.90,0,2,0,2,-100.00,0,1,9,10,-10.00,0,0,1,1,0.00,1,1,2,0.00,0,0,0,0, 
11808,JPN,2,Onodera Taishi ,MB,0,0,0, ,0,0,0,0,0, ,0,0,0,0, ,0,0,0,0, ,0,0,0,0, ,0,0,0, ,0,0,0,0, 
11808,JPN,5,Fukuzawa Tatsuya ,OH,2,0,0,-16.67,2,2,1,1,4,25.00,0,1,0,1,-100.00,0,1,0,1,-100.00,3,0,5,8,37.50,1,0,1,100.00,0,0,0,0, 
11808,JPN,6,Yamauchi Akihiro ,MB,0,2,0,-6.67,2,0,1,2,3,-33.33,2,2,1,5,0.00,0,0,7,7,0.00,1,0,0,1,100.00,1,1,2,0.00,0,0,2,2,0.00
11808,JPN,11,Nishida Yuji ,O,5,1,0,26.67,6,5,0,4,9,55.56,1,1,1,3,0.00,0,1,2,3,-33.33,0,0,0,0, ,0,1,1,-100.00,0,0,1,1,0.00
11808,JPN,12,Sekita Masahiro ,S,1,0,0,0.00,1,1,0,0,1,100.00,0,0,1,1,0.00,0,1,1,2,-50.00,0,0,0,0, ,1,2,3,-33.33,6,0,25,31,19.35
11808,JPN,13,Oya Masaki ,S,0,0,0,-25.00,0,0,0,0,0, ,0,1,0,1,-100.00,0,0,3,3,0.00,0,0,0,0, ,3,1,4,50.00,14,2,32,48,25.00
11808,JPN,14,Ishikawa Yuki ,OH,1,0,0,0.00,1,1,1,3,5,0.00,0,0,0,0, ,0,0,3,3,0.00,4,0,1,5,80.00,1,0,1,100.00,0,0,0,0, 
11808,JPN,15,Ri Haku ,MB,1,0,1,-16.67,2,1,2,4,7,-14.29,0,4,1,5,-80.00,1,0,11,12,8.33,0,0,0,0, ,3,2,5,20.00,0,0,0,0, 
11808,JPN,17,Takanashi Kenta ,OH,11,1,1,34.62,13,11,3,2,16,50.00,1,0,0,1,100.00,1,1,7,9,0.00,8,2,13,23,26.09,2,1,3,33.33,0,0,3,3,0.00
11808,JPN,19,Otsuka Tatsunori ,OH,5,0,0,4.17,5,5,1,8,14,28.57,0,1,0,1,-100.00,0,2,7,9,-22.22,2,1,13,16,6.25,4,2,6,33.33,0,0,0,0, 
11808,JPN,20,Yamamoto Tomohiro ,L,0,0,0, ,0,0,0,0,0, ,0,0,0,0, ,0,0,0,0, ,0,1,2,3,-33.33,0,2,2,-100.00,0,0,2,2,0.00
11808,JPN,21,Takahashi Ran ,OH,0,0,0, ,0,0,0,0,0, ,0,0,0,0, ,0,0,0,0, ,0,0,0,0, ,0,0,0, ,0,0,0,0, 
11808,JPN,24,Ogawa Tomohiro ,L,0,0,0, ,0,0,0,0,0, ,0,0,0,0, ,0,0,0,0, ,6,1,4,11,45.45,4,1,5,60.00,0,0,3,3,0.00
11808,SLO,1,Å tern TonÄek ,O,11,2,1,16.67,14,11,2,7,20,45.00,2,3,1,6,-16.67,1,3,6,10,-20.00,0,0,1,1,0.00,5,0,5,100.00,0,0,0,0, 
11808,SLO,2,Pajenk Alen ,MB,3,0,1,21.43,4,3,0,0,3,100.00,0,1,0,1,-100.00,1,0,9,10,10.00,0,0,0,0, ,0,0,0, ,0,0,0,0, 
11808,SLO,4,Kozamernik Jan ,MB,6,3,0,25.00,9,6,0,0,6,100.00,3,2,1,6,16.67,0,1,11,12,-8.33,0,0,0,0, ,0,1,1,-100.00,1,0,1,2,50.00
11808,SLO,5,Å ket Alen ,O,0,0,0, ,0,0,0,0,0, ,0,0,0,0, ,0,0,0,0, ,0,0,0,0, ,0,0,0, ,0,0,0,0, 
11808,SLO,6,Gasparini Mitja ,O,0,0,0, ,0,0,0,0,0, ,0,0,0,0, ,0,0,0,0, ,0,0,0,0, ,0,0,0, ,0,0,0,0, 
11808,SLO,9,Vincic Dejan ,S,0,0,0, ,0,0,0,0,0, ,0,0,0,0, ,0,0,0,0, ,0,0,0,0, ,0,0,0, ,0,0,0,0, 
11808,SLO,11,Å tern Å½iga ,OH,5,1,0,6.25,6,5,4,4,13,7.69,1,1,0,2,0.00,0,0,1,1,0.00,1,2,5,8,-12.50,2,0,2,100.00,0,0,3,3,0.00
11808,SLO,12,MoÅ¾iÄ Rok ,OH,0,0,0, ,0,0,0,0,0, ,0,0,0,0, ,0,0,0,0, ,0,0,0,0, ,0,1,1,-100.00,0,0,1,1,0.00
11808,SLO,13,KovaÄiÄ Jani ,L,0,0,0, ,0,0,0,0,0, ,0,0,0,0, ,0,0,0,0, ,6,0,10,16,37.50,2,4,6,-33.33,0,0,2,2,0.00
11808,SLO,15,VideÄnik Matic ,MB,2,0,1,22.22,3,2,0,0,2,100.00,0,1,1,2,-50.00,1,0,4,5,20.00,0,0,0,0, ,0,0,0, ,0,0,0,0, 
11808,SLO,16,Ropret Gregor ,S,0,2,1,11.76,3,0,0,1,1,0.00,2,0,0,2,100.00,1,1,12,14,0.00,0,0,0,0, ,7,1,8,75.00,21,1,42,64,31.25
11808,SLO,17,Urnaut Tine ,OH,12,2,0,23.08,14,12,1,6,19,57.89,2,2,1,5,0.00,0,2,13,15,-13.33,3,0,13,16,18.75,3,0,3,100.00,0,0,5,5,0.00
11808,SLO,18,Äebulj Klemen ,OH,6,0,1,3.70,7,6,1,8,15,33.33,0,3,0,3,-100.00,1,2,6,9,-11.11,5,0,6,11,45.45,2,2,4,0.00,0,0,1,1,0.00
11808,SLO,19,Klobucar Jan ,L,0,0,0,0.00,0,0,0,1,1,0.00,0,0,0,0, ,0,0,1,1,0.00,0,0,0,0, ,0,0,0, ,0,0,0,0, 
11809,FRA,1,Chinenyeze BarthÃ©lÃ©my ,MB,7,0,2,6.25,9,7,1,1,9,66.67,0,6,1,7,-85.71,2,0,14,16,12.50,1,0,0,1,100.00,4,2,6,33.33,0,0,0,0, 
11809,FRA,2,Grebennikov Jenia ,L,0,0,0, ,0,0,0,0,0, ,0,0,0,0, ,0,0,0,0, ,5,0,6,11,45.45,12,2,14,71.43,0,0,6,6,0.00
11809,FRA,4,Patry Jean ,O,12,1,1,12.20,14,12,7,8,27,18.52,1,1,1,3,0.00,1,1,9,11,0.00,0,0,0,0, ,3,2,6,16.67,0,0,1,1,0.00
11809,FRA,6,Toniutti Benjamin ,S,0,0,0, ,0,0,0,0,0, ,0,0,0,0, ,0,0,0,0, ,0,0,0,0, ,0,0,0, ,0,0,0,0, 
11809,FRA,7,Tillie Kevin ,OH,0,0,0, ,0,0,0,0,0, ,0,0,0,0, ,0,0,0,0, ,0,0,0,0, ,0,0,0, ,0,0,0,0, 
11809,FRA,9,Ngapeth Earvin ,OH,0,0,0, ,0,0,0,0,0, ,0,0,0,0, ,0,0,0,0, ,0,0,0,0, ,0,0,0, ,0,0,0,0, 
11809,FRA,11,Brizard Antoine ,S,3,2,2,13.04,7,3,0,2,5,60.00,2,1,1,4,25.00,2,3,9,14,-7.14,0,0,2,2,0.00,5,2,7,42.86,24,2,44,70,31.43
11809,FRA,12,Boyer Stephen ,O,0,0,0, ,0,0,0,0,0, ,0,0,0,0, ,0,0,0,0, ,0,0,0,0, ,0,0,0, ,0,0,0,0, 
11809,FRA,14,Le Goff Nicolas ,MB,0,0,0, ,0,0,0,0,0, ,0,0,0,0, ,0,0,0,0, ,0,0,0,0, ,0,0,0, ,0,0,0,0, 
11809,FRA,16,Bultor Daryl ,MB,6,2,0,14.29,8,6,0,2,8,75.00,2,1,2,5,20.00,0,4,4,8,-50.00,0,0,1,1,0.00,2,0,2,100.00,0,0,0,0, 
11809,FRA,17,Clevenot Trevor ,OH,8,1,0,-2.63,9,8,4,7,19,21.05,1,3,4,8,-25.00,0,3,8,11,-27.27,4,0,16,20,20.00,3,2,6,16.67,0,0,1,1,0.00
11809,FRA,19,Louati Yacine ,OH,5,2,1,9.68,8,5,3,7,15,13.33,2,0,0,2,100.00,1,2,11,14,-7.14,5,0,13,18,27.78,4,1,5,60.00,0,0,2,2,0.00
11809,FRA,20,Diez Benjamin ,L,0,0,0, ,0,0,0,0,0, ,0,0,0,0, ,0,0,0,0, ,0,0,0,0, ,0,0,0, ,0,0,0,0, 
11809,FRA,24,Gueye Mousse ,MB,0,0,0, ,0,0,0,0,0, ,0,0,0,0, ,0,0,0,0, ,0,0,0,0, ,0,0,0, ,0,0,0,0, 
11809,ARG,1,Sanchez Matias ,S,0,0,0,0.00,0,0,0,0,0, ,0,0,0,0, ,0,0,1,1,0.00,0,0,0,0, ,0,0,0, ,2,0,5,7,28.57
11809,ARG,2,Pereyra Federico ,O,2,0,0,40.00,2,2,0,1,3,66.67,0,0,0,0, ,0,0,2,2,0.00,0,0,0,0, ,0,1,1,-100.00,0,0,0,0, 
11809,ARG,3,Martinez Franchi Jan ,OH,0,0,0, ,0,0,0,0,0, ,0,0,0,0, ,0,0,0,0, ,0,0,0,0, ,0,0,0, ,0,0,0,0, 
11809,ARG,6,Poglajen Cristian ,OH,1,0,0,-18.18,1,1,1,4,6,0.00,0,0,0,0, ,0,2,3,5,-40.00,2,2,12,16,0.00,4,1,5,60.00,0,0,2,2,0.00
11809,ARG,7,Conte Facundo ,OH,4,3,0,4.35,7,4,2,4,10,20.00,3,2,0,5,20.00,0,2,6,8,-25.00,4,0,12,16,25.00,2,1,5,20.00,0,0,1,1,0.00
11809,ARG,8,Loser Agustin ,MB,8,0,0,-3.45,8,8,1,3,12,58.33,0,6,3,9,-66.67,0,2,6,8,-25.00,0,0,0,0, ,3,0,3,100.00,0,0,1,1,0.00
11809,ARG,9,Danani Santiago ,L,0,0,0, ,0,0,0,0,0, ,0,0,0,0, ,0,0,0,0, ,1,1,6,8,0.00,7,4,13,23.08,0,0,6,6,0.00
11809,ARG,12,Lima Bruno ,O,10,1,0,5.88,11,10,4,5,19,31.58,1,2,1,4,-25.00,0,3,8,11,-27.27,0,0,0,0, ,3,0,3,100.00,0,0,1,1,0.00
11809,ARG,13,Palacios Ezequiel ,OH,4,2,0,11.76,6,4,1,4,9,33.33,2,0,1,3,66.67,0,3,2,5,-60.00,3,1,4,8,25.00,0,1,1,-100.00,0,0,1,1,0.00
11809,ARG,15,De Cecco Luciano ,S,0,0,0,-15.38,0,0,0,0,0, ,0,2,1,3,-66.67,0,0,10,10,0.00,0,0,1,1,0.00,4,0,4,100.00,23,1,32,56,39.29
11809,ARG,16,Palonsky Luciano ,OH,0,0,0, ,0,0,0,0,0, ,0,0,0,0, ,0,0,0,0, ,0,0,0,0, ,0,0,0, ,0,0,0,0, 
11809,ARG,17,Mendez Nicolas ,OH,5,1,0,5.00,6,5,1,3,9,44.44,1,2,0,3,-33.33,0,2,6,8,-25.00,2,2,7,11,0.00,2,0,3,66.67,0,0,2,2,0.00
11809,ARG,18,Ramos Martin ,MB,3,0,0,-13.04,3,3,2,2,7,14.29,0,2,3,5,-40.00,0,2,9,11,-18.18,0,0,1,1,0.00,1,0,1,100.00,0,0,0,0, 
11809,ARG,19,Massimino Franco ,L,0,0,0, ,0,0,0,0,0, ,0,0,0,0, ,0,0,0,0, ,0,0,0,0, ,0,0,0, ,0,0,0,0, 
11810,BRA,1,Rezende Bruno Mossa ,S,0,0,0, ,0,0,0,0,0, ,0,0,0,0, ,0,0,0,0, ,0,0,0,0, ,0,0,0, ,1,0,1,2,50.00
11810,BRA,3,De Barros Ferreira JoÃ£o Rafael ,OH,0,0,0,0.00,0,0,0,0,0, ,0,0,0,0, ,0,0,1,1,0.00,0,0,0,0, ,0,0,0, ,0,0,0,0, 
11810,BRA,5,Borges Almeida Silva Mauricio ,OH,8,2,1,8.82,11,8,5,6,19,15.79,2,0,0,2,100.00,1,3,9,13,-15.38,8,2,8,18,33.33,7,0,7,100.00,0,0,2,2,0.00
11810,BRA,6,Gil Kreling Fernando ,S,1,0,0,-28.57,1,1,0,0,1,100.00,0,4,1,5,-80.00,0,1,7,8,-12.50,0,0,0,0, ,4,2,6,33.33,23,0,50,73,31.51
11810,BRA,8,De Souza Wallace ,O,0,0,0, ,0,0,0,0,0, ,0,0,0,0, ,0,0,0,0, ,0,0,0,0, ,0,0,0, ,0,0,0,0, 
11810,BRA,11,Kavalkievicz Gabriel ,OH,0,0,0,-100.00,0,0,0,0,0, ,0,1,0,1,-100.00,0,0,0,0, ,0,0,0,0, ,0,0,0, ,0,0,0,0, 
11810,BRA,12,Santos Isac ,MB,7,1,0,4.00,8,7,0,4,11,63.64,1,3,0,4,-50.00,0,4,6,10,-40.00,0,0,0,0, ,1,1,2,0.00,0,0,0,0, 
11810,BRA,13,De Souza Mauricio Luiz ,MB,0,0,0, ,0,0,0,0,0, ,0,0,0,0, ,0,0,0,0, ,0,0,0,0, ,0,0,0, ,0,0,0,0, 
11810,BRA,14,Correia De Souza Douglas ,OH,8,1,2,8.89,11,8,3,12,23,21.74,1,1,2,4,0.00,2,3,13,18,-5.56,8,0,8,16,50.00,6,0,6,100.00,0,0,4,4,0.00
11810,BRA,15,Nascimento Maique Reis ,L,0,0,0, ,0,0,0,0,0, ,0,0,0,0, ,0,0,0,0, ,0,0,0,0, ,0,0,0, ,0,0,0,0, 
11810,BRA,16,Saatkamp Lucas ,MB,1,0,0,-30.00,1,1,0,4,5,20.00,0,1,0,1,-100.00,0,3,1,4,-75.00,0,0,0,0, ,0,0,0, ,0,0,0,0, 
11810,BRA,17,Hoss Thales ,L,0,0,0, ,0,0,0,0,0, ,0,0,0,0, ,0,0,0,0, ,7,1,6,14,42.86,10,2,12,66.67,0,0,3,3,0.00
11810,BRA,21,Souza Alan ,O,13,1,0,17.95,14,13,2,7,22,50.00,1,3,1,5,-40.00,0,2,10,12,-16.67,1,0,1,2,50.00,4,1,5,60.00,0,0,0,0, 
11810,BRA,23,Resende Gualberto Flavio ,MB,5,0,0,18.75,5,5,1,2,8,50.00,0,1,0,1,-100.00,0,0,7,7,0.00,0,0,0,0, ,1,1,2,0.00,0,0,1,1,0.00
11810,GER,1,Fromm Christian ,OH,3,0,0,-9.68,3,3,3,13,19,0.00,0,1,1,2,-50.00,0,2,8,10,-20.00,3,2,11,16,6.25,1,2,3,-33.33,0,0,3,3,0.00
11810,GER,3,Schott Ruben ,OH,12,0,1,13.51,13,12,0,10,22,54.55,0,4,1,5,-80.00,1,4,5,10,-30.00,10,1,10,21,42.86,1,5,6,-66.67,0,0,5,5,0.00
11810,GER,5,Reichert Moritz ,OH,0,0,0,0.00,0,0,0,0,0, ,0,0,0,0, ,0,0,1,1,0.00,1,0,1,2,50.00,0,0,0, ,0,0,1,1,0.00
11810,GER,6,Kaliberda Denys ,OH,0,0,0, ,0,0,0,0,0, ,0,0,0,0, ,0,0,0,0, ,0,0,0,0, ,0,0,0, ,0,0,0,0, 
11810,GER,7,Sossenheimer David ,OH,0,0,0,0.00,0,0,0,0,0, ,0,0,0,0, ,0,0,1,1,0.00,0,0,0,0, ,0,0,0, ,0,0,0,0, 
11810,GER,8,BÃ¶hme Marcus ,MB,0,0,0, ,0,0,0,0,0, ,0,0,0,0, ,0,0,0,0, ,0,0,0,0, ,0,0,0, ,0,0,0,0, 
11810,GER,10,Zenger Julian ,L,0,0,0, ,0,0,0,0,0, ,0,0,0,0, ,0,0,0,0, ,5,0,10,15,33.33,8,2,11,54.55,0,0,4,4,0.00
11810,GER,13,Hirsch Simon ,O,1,0,0,50.00,1,1,0,1,2,50.00,0,0,0,0, ,0,0,0,0, ,0,0,0,0, ,0,0,0, ,0,0,0,0, 
11810,GER,16,BurggrÃ¤f Eric ,S,0,0,1,-20.00,1,0,0,0,0, ,0,0,0,0, ,1,2,2,5,-20.00,0,0,0,0, ,0,0,0, ,1,0,5,6,16.67
11810,GER,17,Zimmermann Jan ,S,0,0,0,-20.00,0,0,0,0,0, ,0,0,1,1,0.00,0,2,7,9,-22.22,0,0,2,2,0.00,4,1,5,60.00,10,0,50,60,16.67
11810,GER,18,Krage Florian ,MB,2,3,1,-8.33,6,2,0,1,3,66.67,3,7,0,10,-40.00,1,1,9,11,0.00,1,0,0,1,100.00,1,1,2,0.00,0,0,0,0, 
11810,GER,19,RÃ¶hrs Erik ,OH,0,0,0, ,0,0,0,0,0, ,0,0,0,0, ,0,0,0,0, ,0,0,0,0, ,0,0,0, ,0,0,0,0, 
11810,GER,20,Weber Linus ,O,10,2,0,2.78,12,10,6,8,24,16.67,2,2,0,4,0.00,0,3,5,8,-37.50,0,0,0,0, ,1,1,3,0.00,0,0,0,0, 
11810,GER,21,Krick Tobias ,MB,6,0,0,0.00,6,6,1,2,9,55.56,0,2,3,5,-40.00,0,3,9,12,-25.00,0,0,0,0, ,0,0,0, ,0,0,1,1,0.00
11811,RUS,1,Podlesnykh Yaroslav ,OH,0,0,0,0.00,0,0,0,0,0, ,0,0,0,0, ,0,0,5,5,0.00,0,0,0,0, ,0,0,0, ,0,0,0,0, 
11811,RUS,2,Vlasov Ilia ,MB,0,0,0, ,0,0,0,0,0, ,0,0,0,0, ,0,0,0,0, ,0,0,0,0, ,0,0,0, ,0,0,0,0, 
11811,RUS,4,Volvich Artem ,MB,5,0,0,11.54,5,5,1,2,8,50.00,0,1,3,4,-25.00,0,0,14,14,0.00,0,0,0,0, ,0,0,0, ,0,0,0,0, 
11811,RUS,6,Baranov Evgeny ,L,0,0,0, ,0,0,0,0,0, ,0,0,0,0, ,0,0,0,0, ,0,0,0,0, ,0,0,0, ,0,0,0,0, 
11811,RUS,7,Volkov Dmitry ,OH,13,2,1,5.88,16,13,7,10,30,20.00,2,4,1,7,-28.57,1,2,11,14,-7.14,4,1,23,28,10.71,6,4,11,18.18,0,0,2,2,0.00
11811,RUS,10,Bogdan Denis ,OH,0,0,0,-33.33,0,0,0,0,0, ,0,0,0,0, ,0,3,6,9,-33.33,0,0,0,0, ,1,0,1,100.00,0,0,0,0, 
11811,RUS,11,Pankov Pavel ,S,0,1,1,-15.38,2,0,0,0,0, ,1,2,4,7,-14.29,1,2,3,6,-16.67,0,0,0,0, ,2,0,3,66.67,16,0,43,59,27.12
11811,RUS,15,Poletaev Victor ,O,14,0,1,11.36,15,14,5,5,24,37.50,0,4,1,5,-80.00,1,1,13,15,0.00,0,0,0,0, ,1,0,2,50.00,0,0,1,1,0.00
11811,RUS,17,Mikhaylov Maxim ,O,5,2,0,0.00,7,5,2,2,9,33.33,2,3,2,7,-14.29,0,2,4,6,-33.33,0,0,0,0, ,2,1,3,33.33,0,0,0,0, 
11811,RUS,18,Kliuka Egor ,OH,11,1,1,6.12,13,11,2,12,25,36.00,1,4,0,5,-60.00,1,4,14,19,-15.79,11,6,22,39,12.82,6,0,7,85.71,0,0,4,4,0.00
11811,RUS,20,Kurkaev Ilyas ,MB,8,3,1,32.00,12,8,1,0,9,77.78,3,2,4,9,11.11,1,1,5,7,0.00,0,0,0,0, ,1,1,2,0.00,0,0,0,0, 
11811,RUS,24,Kobzar Igor ,S,0,0,0,-70.00,0,0,0,0,0, ,0,5,0,5,-100.00,0,2,3,5,-40.00,0,0,0,0, ,0,0,0, ,12,0,20,32,37.50
11811,RUS,27,Golubev Valentin ,L,0,0,0, ,0,0,0,0,0, ,0,0,0,0, ,0,0,0,0, ,6,1,11,18,27.78,11,3,15,53.33,0,0,6,6,0.00
11811,ITA,1,Gardini Davide ,OH,0,0,0, ,0,0,0,0,0, ,0,0,0,0, ,0,0,0,0, ,0,0,0,0, ,0,0,0, ,0,0,0,0, 
11811,ITA,7,Balaso Fabio ,L,0,0,0, ,0,0,0,0,0, ,0,0,0,0, ,0,0,0,0, ,6,3,12,21,14.29,10,3,15,46.67,0,0,11,11,0.00
11811,ITA,15,Sbertoli Riccardo ,S,0,0,0,0.00,0,0,0,0,0, ,0,0,0,0, ,0,0,1,1,0.00,0,0,0,0, ,1,1,2,0.00,3,0,6,9,33.33
11811,ITA,18,Michieletto Alessandro ,OH,4,0,0,37.50,4,4,0,1,5,80.00,0,0,1,1,0.00,0,1,1,2,-50.00,2,0,6,8,25.00,4,0,4,100.00,0,0,1,1,0.00
11811,ITA,20,Nelli Gabriele ,O,5,1,1,-3.85,7,5,2,7,14,21.43,1,3,1,5,-40.00,1,3,3,7,-28.57,0,0,0,0, ,1,2,3,-33.33,0,0,1,1,0.00
11811,ITA,21,Spirito Luca ,S,0,1,1,-5.00,2,0,2,2,4,-50.00,1,0,1,2,50.00,1,1,12,14,0.00,0,0,1,1,0.00,3,3,7,0.00,18,2,64,84,19.05
11811,ITA,23,Pinali Giulio ,O,8,0,2,30.00,10,8,2,1,11,54.55,0,0,0,0, ,2,2,5,9,0.00,0,0,0,0, ,0,4,4,-100.00,0,0,1,1,0.00
11811,ITA,24,Cavuto Oreste ,OH,6,0,0,30.77,6,6,0,2,8,75.00,0,2,1,3,-66.67,0,0,2,2,0.00,0,0,8,8,0.00,1,0,1,100.00,0,0,1,1,0.00
11811,ITA,25,Vitelli Marco ,MB,2,0,0,0.00,2,2,0,0,2,100.00,0,1,2,3,-33.33,0,1,4,5,-20.00,0,0,0,0, ,1,0,1,100.00,0,0,0,0, 
11811,ITA,26,Cortesia Lorenzo ,MB,6,6,0,19.44,12,6,1,2,9,55.56,6,4,3,13,15.38,0,0,14,14,0.00,0,0,0,0, ,8,2,10,60.00,0,0,1,1,0.00
11811,ITA,28,Recine Francesco ,OH,10,1,0,5.88,11,10,6,9,25,16.00,1,1,0,2,0.00,0,2,5,7,-28.57,6,0,21,27,22.22,6,0,6,100.00,0,0,1,1,0.00
11811,ITA,29,Bottolo Mattia ,OH,10,0,4,0.00,14,10,7,12,29,10.34,0,2,0,2,-100.00,4,5,23,32,-3.12,5,2,10,17,17.65,6,2,8,50.00,0,0,3,3,0.00
11811,ITA,30,Mosca Leandro Ausibio ,MB,6,1,0,37.50,7,6,0,0,6,100.00,1,1,1,3,0.00,0,0,7,7,0.00,0,0,1,1,0.00,1,0,1,100.00,0,0,0,0, 
11811,ITA,31,Federici Filippo ,L,0,0,0, ,0,0,0,0,0, ,0,0,0,0, ,0,0,0,0, ,0,0,0,0, ,0,0,0, ,0,0,0,0, 
11812,AUS,1,Graham Beau ,MB,0,0,0,-55.56,0,0,3,1,4,-75.00,0,1,0,1,-100.00,0,1,3,4,-25.00,0,0,0,0, ,1,0,1,100.00,0,0,0,0, 
11812,AUS,2,Dosanjh Arshdeep ,S,2,2,0,18.75,4,2,1,1,4,25.00,2,0,1,3,66.67,0,0,9,9,0.00,0,0,0,0, ,3,3,6,0.00,13,0,41,54,24.07
11812,AUS,3,Macdonald Steven ,MB,0,0,0, ,0,0,0,0,0, ,0,0,0,0, ,0,0,0,0, ,0,0,0,0, ,0,0,0, ,0,0,0,0, 
11812,AUS,7,Weir James ,MB,0,0,0, ,0,0,0,0,0, ,0,0,0,0, ,0,0,0,0, ,0,0,0,0, ,0,0,0, ,0,0,0,0, 
11812,AUS,8,O'Dea Trent ,MB,4,0,0,0.00,4,4,0,6,10,40.00,0,4,3,7,-57.14,0,0,8,8,0.00,0,0,1,1,0.00,0,2,2,-100.00,0,0,3,3,0.00
11812,AUS,11,Perry Luke ,L,0,0,0, ,0,0,0,0,0, ,0,0,0,0, ,0,0,0,0, ,3,0,2,5,60.00,8,3,11,45.45,0,0,5,5,0.00
11812,AUS,12,Mote Nehemiah ,MB,8,2,0,11.11,10,8,2,0,10,60.00,2,4,0,6,-33.33,0,1,10,11,-9.09,0,0,2,2,0.00,2,1,3,33.33,0,0,0,0, 
11812,AUS,21,Butler Nicholas ,S,0,0,0, ,0,0,0,0,0, ,0,0,0,0, ,0,0,0,0, ,0,0,0,0, ,0,0,0, ,0,0,0,0, 
11812,AUS,27,Senica Max ,OH,4,1,1,-6.45,6,4,2,5,11,18.18,1,4,0,5,-60.00,1,2,12,15,-6.67,12,2,12,26,38.46,3,3,6,0.00,0,0,1,1,0.00
11812,AUS,28,Taylor Tim ,OH,0,0,0, ,0,0,0,0,0, ,0,0,0,0, ,0,0,0,0, ,0,0,0,0, ,0,0,0, ,0,0,0,0, 
11812,AUS,29,Garrett Ethan ,OH,0,0,0, ,0,0,0,0,0, ,0,0,0,0, ,0,0,0,0, ,1,1,1,3,0.00,1,1,2,0.00,0,0,0,0, 
11812,AUS,31,Aubrey Matthew ,O,5,0,0,15.38,5,5,1,3,9,44.44,0,0,0,0, ,0,2,2,4,-50.00,0,0,0,0, ,1,0,1,100.00,0,0,0,0, 
11812,AUS,32,Azeez Oluwatobi Elliot ,OH,10,1,0,3.03,11,10,5,4,19,26.32,1,1,0,2,0.00,0,4,8,12,-33.33,8,5,7,20,15.00,0,0,0, ,0,0,0,0, 
11812,AUS,34,Greber Billy ,L,0,0,0, ,0,0,0,0,0, ,0,0,0,0, ,0,0,0,0, ,0,0,0,0, ,0,0,0, ,0,0,0,0, 
11812,NED,2,Keemink Wessel ,S,0,0,0,0.00,0,0,0,0,0, ,0,0,0,0, ,0,0,2,2,0.00,0,0,0,0, ,0,2,2,-100.00,0,0,2,2,0.00
11812,NED,4,Ter Horst Thijs ,OH,0,0,0, ,0,0,0,0,0, ,0,0,0,0, ,0,0,0,0, ,0,0,0,0, ,0,0,0, ,0,0,0,0, 
11812,NED,5,van der Ent Luuc ,MB,0,0,0, ,0,0,0,0,0, ,0,0,0,0, ,0,0,0,0, ,0,0,0,0, ,0,0,0, ,0,0,0,0, 
11812,NED,6,Dronkers Just ,L,0,0,0, ,0,0,0,0,0, ,0,0,0,0, ,0,0,0,0, ,8,0,5,13,61.54,6,1,7,71.43,0,0,5,5,0.00
11812,NED,8,Plak Fabian ,MB,2,0,0,0.00,2,2,1,1,4,25.00,0,1,0,1,-100.00,0,0,1,1,0.00,0,0,0,0, ,0,0,0, ,0,0,0,0, 
11812,NED,12,Tuinstra Bennie Junior ,OH,12,0,3,19.51,15,12,2,4,18,55.56,0,2,0,2,-100.00,3,3,15,21,0.00,10,1,8,19,47.37,3,2,5,20.00,0,0,2,2,0.00
11812,NED,13,Ottevanger Steven ,L,0,0,0, ,0,0,0,0,0, ,0,0,0,0, ,0,0,0,0, ,0,0,0,0, ,0,0,0, ,0,0,0,0, 
11812,NED,14,Abdel-Aziz Nimir ,O,12,1,4,16.67,17,12,5,11,28,25.00,1,1,0,2,0.00,4,4,4,12,0.00,0,0,0,0, ,0,1,1,-100.00,0,0,1,1,0.00
11812,NED,17,Parkinson Michael ,MB,5,4,1,15.38,10,5,1,1,7,57.14,4,3,1,8,12.50,1,2,8,11,-9.09,0,0,0,0, ,2,0,4,50.00,0,0,0,0, 
11812,NED,18,Andringa Robbert ,L,8,1,0,23.81,9,8,2,2,12,50.00,1,0,0,1,100.00,0,2,6,8,-25.00,10,0,7,17,58.82,2,1,3,33.33,0,0,2,2,0.00
11812,NED,19,de Weijer Freek ,S,0,2,0,-14.29,2,0,0,0,0, ,2,3,2,7,-14.29,0,1,6,7,-14.29,0,0,2,2,0.00,3,1,5,40.00,18,0,43,61,29.51
11812,NED,21,van Schie Stijn ,OH,0,0,0, ,0,0,0,0,0, ,0,0,0,0, ,0,0,0,0, ,0,0,0,0, ,0,0,0, ,0,0,0,0, 
11812,NED,22,Wiltenburg Twan ,MB,3,0,0,0.00,3,3,0,1,4,75.00,0,0,2,2,0.00,0,3,7,10,-30.00,0,0,2,2,0.00,1,0,2,50.00,0,0,0,0, 
11812,NED,25,van Tilburg Stijn ,OH,0,0,0,-100.00,0,0,0,0,0, ,0,0,0,0, ,0,1,0,1,-100.00,0,0,0,0, ,0,0,0, ,0,0,0,0, 
11813,CAN,2,Perrin John Gordon ,OH,11,2,1,6.25,14,11,3,16,30,26.67,2,4,5,11,-18.18,1,3,19,23,-8.70,10,4,15,29,20.69,9,2,11,63.64,0,0,4,4,0.00
11813,CAN,3,Marshall Steven ,OH,1,6,0,9.68,7,1,3,10,14,-14.29,6,0,2,8,75.00,0,1,8,9,-11.11,3,1,4,8,25.00,9,0,9,100.00,0,0,4,4,0.00
11813,CAN,4,Hoag Nicholas ,OH,0,0,0, ,0,0,0,0,0, ,0,0,0,0, ,0,0,0,0, ,0,0,0,0, ,0,0,0, ,0,0,1,1,0.00
11813,CAN,7,Maar Stephen Timothy ,OH,2,1,0,-5.26,3,2,2,8,12,0.00,1,2,1,4,-25.00,0,0,3,3,0.00,4,3,6,13,7.69,1,0,2,50.00,0,1,3,4,-25.00
11813,CAN,8,Blankenau Jay ,S,0,0,0,-17.86,0,0,1,4,5,-20.00,0,4,1,5,-80.00,0,0,18,18,0.00,0,0,0,0, ,9,2,13,53.85,20,0,79,99,20.20
11813,CAN,10,Sclater Ryan Joseph ,O,16,1,0,14.00,17,16,4,9,29,41.38,1,5,6,12,-33.33,0,1,8,9,-11.11,0,0,1,1,0.00,8,1,11,63.64,0,0,0,0, 
11813,CAN,11,Jansen Vandoorn Daniel ,MB,0,0,0, ,0,0,0,0,0, ,0,0,0,0, ,0,0,0,0, ,0,0,0,0, ,0,0,0, ,0,0,0,0, 
11813,CAN,12,Van Berkel Lucas ,MB,4,5,0,4.76,9,4,1,3,8,37.50,5,5,2,12,0.00,0,1,21,22,-4.55,1,0,0,1,100.00,0,0,0, ,1,0,2,3,33.33
11813,CAN,13,Vernon-Evans Sharone ,O,7,2,0,11.11,9,7,2,7,16,31.25,2,1,1,4,25.00,0,3,4,7,-42.86,0,0,1,1,0.00,0,4,4,-100.00,0,0,2,2,0.00
11813,CAN,14,Loeppky Eric ,OH,0,0,0, ,0,0,0,0,0, ,0,0,0,0, ,0,0,0,0, ,0,0,0,0, ,0,0,0, ,0,0,0,0, 
11813,CAN,17,Vigrass Graham ,MB,5,2,0,-11.43,7,5,1,4,10,40.00,2,7,5,14,-35.71,0,3,8,11,-27.27,0,0,0,0, ,4,1,5,60.00,0,0,0,0, 
11813,CAN,19,Bann Blair Cameron ,L,0,0,0, ,0,0,0,0,0, ,0,0,0,0, ,0,0,0,0, ,7,0,16,23,30.43,17,3,21,66.67,0,0,6,6,0.00
11813,CAN,20,Szwarc Arthur ,O,1,0,0,-25.00,1,1,0,1,2,50.00,0,1,3,4,-25.00,0,2,0,2,-100.00,0,0,0,0, ,0,0,0, ,0,0,0,0, 
11813,CAN,21,Walsh Brett James ,S,0,0,0, ,0,0,0,0,0, ,0,0,0,0, ,0,0,0,0, ,0,0,0,0, ,0,0,0, ,0,0,1,1,0.00
11813,SRB,3,Kapur Milorad ,L,0,0,0, ,0,0,0,0,0, ,0,0,0,0, ,0,0,0,0, ,0,0,0,0, ,4,2,7,28.57,0,0,2,2,0.00
11813,SRB,6,Pekovic Nikola ,L,0,0,0, ,0,0,0,0,0, ,0,0,0,0, ,0,0,0,0, ,8,0,18,26,30.77,8,0,9,88.89,0,0,10,10,0.00
11813,SRB,7,Krsmanovic Petar ,MB,10,4,0,1.89,14,10,2,4,16,50.00,4,6,9,19,-10.53,0,5,13,18,-27.78,2,0,2,4,50.00,5,0,6,83.33,0,0,1,1,0.00
11813,SRB,8,Ivovic Marko ,OH,13,2,5,11.11,20,13,4,16,33,27.27,2,3,5,10,-10.00,5,5,19,29,0.00,10,0,16,26,38.46,11,2,14,64.29,1,1,7,9,0.00
11813,SRB,9,Jovovic Nikola ,S,0,0,0, ,0,0,0,0,0, ,0,0,0,0, ,0,0,0,0, ,0,0,0,0, ,0,0,0, ,0,0,0,0, 
11813,SRB,10,KujundÅ¾iÄ Miran ,OH,13,0,2,12.28,15,13,6,15,34,20.59,0,1,4,5,-20.00,2,1,15,18,5.56,9,1,21,31,25.81,14,1,16,81.25,0,0,3,3,0.00
11813,SRB,11,Batak Aleksa ,S,0,0,0, ,0,0,0,0,0, ,0,0,0,0, ,0,0,0,0, ,0,0,0,0, ,0,0,0, ,0,0,0,0, 
11813,SRB,12,Peric Pavle ,OH,0,0,0, ,0,0,0,0,0, ,0,0,0,0, ,0,0,0,0, ,0,0,0,0, ,0,0,0, ,0,0,0,0, 
11813,SRB,14,Atanasijevic Aleksandar ,O,12,0,0,-6.82,12,12,8,9,29,13.79,0,3,5,8,-37.50,0,4,3,7,-57.14,0,0,0,0, ,8,1,10,70.00,0,0,2,2,0.00
11813,SRB,16,Luburic Drazen ,O,7,1,1,-3.57,9,7,6,6,19,5.26,1,0,2,3,33.33,1,4,1,6,-50.00,0,0,0,0, ,1,0,1,100.00,0,0,2,2,0.00
11813,SRB,18,Podrascanin Marko ,MB,6,2,0,-6.25,8,6,2,1,9,44.44,2,2,7,11,0.00,0,6,6,12,-50.00,1,0,1,2,50.00,1,1,2,0.00,0,0,3,3,0.00
11813,SRB,21,Todorovic Vuk ,S,1,0,0,-11.11,1,1,0,0,1,100.00,0,1,3,4,-25.00,0,2,11,13,-15.38,0,0,1,1,0.00,7,2,9,55.56,28,1,84,113,23.89
11813,SRB,23,Vucicevic Bozidar ,O,0,0,0, ,0,0,0,0,0, ,0,0,0,0, ,0,0,0,0, ,0,0,0,0, ,0,0,0, ,0,0,0,0, 
11813,SRB,26,Kovac Davide ,OH,0,0,0, ,0,0,0,0,0, ,0,0,0,0, ,0,0,0,0, ,0,0,0,0, ,0,0,0, ,0,0,0,0, 
11814,USA,1,Anderson Matthew ,O,11,0,1,20.00,12,11,1,7,19,52.63,0,0,0,0, ,1,5,5,11,-36.36,0,0,0,0, ,5,3,8,25.00,0,0,1,1,0.00
11814,USA,4,Jendryk II Jeffrey ,MB,0,0,0, ,0,0,0,0,0, ,0,0,0,0, ,0,0,0,0, ,0,0,0,0, ,0,0,0, ,0,0,0,0, 
11814,USA,5,Ensing Kyle ,O,0,0,0, ,0,0,0,0,0, ,0,0,0,0, ,0,0,0,0, ,0,0,0,0, ,0,0,0, ,0,0,0,0, 
11814,USA,6,Stahl Mitchell ,MB,0,0,0, ,0,0,0,0,0, ,0,0,0,0, ,0,0,0,0, ,0,0,0,0, ,0,0,0, ,0,0,0,0, 
11814,USA,7,Shoji Kawika ,S,0,0,0, ,0,0,0,0,0, ,0,0,0,0, ,0,0,0,0, ,0,0,0,0, ,0,0,0, ,0,0,0,0, 
11814,USA,8,Defalco Torey ,OH,11,4,0,13.89,15,11,3,6,20,40.00,4,3,0,7,14.29,0,4,5,9,-44.44,5,0,7,12,41.67,0,3,3,-100.00,0,0,5,5,0.00
11814,USA,9,Hanes Jake ,O,0,0,0, ,0,0,0,0,0, ,0,0,0,0, ,0,0,0,0, ,0,0,0,0, ,0,0,0, ,0,0,0,0, 
11814,USA,11,Christenson Micah ,S,3,1,1,11.54,5,3,1,2,6,33.33,1,0,1,2,50.00,1,1,16,18,0.00,0,0,0,0, ,9,2,12,58.33,22,0,33,55,40.00
11814,USA,12,Holt Maxwell ,MB,6,4,0,10.00,10,6,1,0,7,71.43,4,4,1,9,0.00,0,2,12,14,-14.29,0,0,0,0, ,1,0,1,100.00,0,0,1,1,0.00
11814,USA,15,Sander Brenden ,OH,0,0,0, ,0,0,0,0,0, ,0,0,0,0, ,0,0,0,0, ,0,0,0,0, ,0,0,0, ,0,0,0,0, 
11814,USA,17,Jaeschke Thomas ,OH,0,0,0, ,0,0,0,0,0, ,0,0,0,0, ,0,0,0,0, ,0,0,0,0, ,0,0,0, ,0,0,0,0, 
11814,USA,18,Muagututia Garrett ,OH,12,0,0,25.93,12,12,1,3,16,68.75,0,2,0,2,-100.00,0,2,7,9,-22.22,13,1,12,26,46.15,4,6,10,-20.00,0,0,3,3,0.00
11814,USA,20,Smith David ,MB,5,1,0,-6.67,6,5,0,6,11,45.45,1,4,2,7,-42.86,0,4,8,12,-33.33,0,0,0,0, ,3,0,3,100.00,0,0,4,4,0.00
11814,USA,22,Shoji Erik ,L,0,0,0, ,0,0,0,0,0, ,0,0,0,0, ,0,0,0,0, ,6,1,8,15,33.33,1,0,3,33.33,0,0,4,4,0.00
11814,JPN,1,Shimizu Kunihiro ,O,0,0,0,-50.00,0,0,0,1,1,0.00,0,0,0,0, ,0,1,0,1,-100.00,0,0,0,0, ,0,0,0, ,0,0,0,0, 
11814,JPN,2,Onodera Taishi ,MB,2,1,0,-13.64,3,2,1,6,9,11.11,1,3,1,5,-40.00,0,2,6,8,-25.00,1,0,0,1,100.00,1,1,2,0.00,0,0,0,0, 
11814,JPN,3,Fujii Naonobu ,S,0,0,0,-16.67,0,0,0,0,0, ,0,0,0,0, ,0,1,5,6,-16.67,0,0,0,0, ,2,2,4,0.00,9,0,40,49,18.37
11814,JPN,6,Yamauchi Akihiro ,MB,5,0,0,14.29,5,5,1,5,11,36.36,0,1,0,1,-100.00,0,0,9,9,0.00,0,0,0,0, ,2,1,3,33.33,0,0,0,0, 
11814,JPN,11,Nishida Yuji ,O,9,1,0,11.43,10,9,5,10,24,16.67,1,0,1,2,50.00,0,1,8,9,-11.11,0,0,0,0, ,1,0,1,100.00,0,0,0,0, 
11814,JPN,12,Sekita Masahiro ,S,0,0,0,0.00,0,0,0,0,0, ,0,0,0,0, ,0,0,4,4,0.00,0,0,0,0, ,1,2,3,-33.33,3,0,23,26,11.54
11814,JPN,13,Oya Masaki ,S,0,0,0, ,0,0,0,0,0, ,0,0,0,0, ,0,0,0,0, ,0,0,0,0, ,0,0,0, ,0,0,0,0, 
11814,JPN,14,Ishikawa Yuki ,OH,12,1,1,14.63,14,12,3,11,26,34.62,1,1,0,2,0.00,1,4,8,13,-23.08,6,0,8,14,42.86,3,3,6,0.00,0,0,2,2,0.00
11814,JPN,15,Ri Haku ,MB,0,0,0,0.00,0,0,0,0,0, ,0,0,0,0, ,0,0,2,2,0.00,0,0,0,0, ,0,0,0, ,0,0,1,1,0.00
11814,JPN,17,Takanashi Kenta ,OH,0,0,0, ,0,0,0,0,0, ,0,0,0,0, ,0,0,0,0, ,0,0,0,0, ,0,0,0, ,0,0,0,0, 
11814,JPN,19,Otsuka Tatsunori ,OH,0,0,0, ,0,0,0,0,0, ,0,0,0,0, ,0,0,0,0, ,0,0,0,0, ,0,0,0, ,0,0,0,0, 
11814,JPN,20,Yamamoto Tomohiro ,L,0,0,0, ,0,0,0,0,0, ,0,0,0,0, ,0,0,0,0, ,8,1,11,20,35.00,11,5,16,37.50,0,0,3,3,0.00
11814,JPN,21,Takahashi Ran ,OH,7,0,1,0.00,8,7,2,8,17,29.41,0,2,1,3,-66.67,1,4,9,14,-21.43,9,1,10,20,40.00,2,3,6,-16.67,0,0,3,3,0.00
11814,JPN,24,Ogawa Tomohiro ,L,0,0,0, ,0,0,0,0,0, ,0,0,0,0, ,0,0,0,0, ,0,0,0,0, ,0,0,0, ,0,0,0,0, 
11815,FRA,1,Chinenyeze BarthÃ©lÃ©my ,MB,6,0,0,-2.70,6,6,1,5,12,41.67,0,3,2,5,-60.00,0,3,17,20,-15.00,0,0,0,0, ,2,0,2,100.00,0,0,1,1,0.00
11815,FRA,2,Grebennikov Jenia ,L,0,0,0, ,0,0,0,0,0, ,0,0,0,0, ,0,0,0,0, ,10,1,10,21,42.86,12,2,14,71.43,0,0,2,2,0.00
11815,FRA,4,Patry Jean ,O,6,1,2,-7.69,9,6,6,7,19,0.00,1,5,3,9,-44.44,2,1,8,11,9.09,0,0,0,0, ,8,1,11,63.64,0,0,0,0, 
11815,FRA,6,Toniutti Benjamin ,S,0,0,1,-8.33,1,0,0,0,0, ,0,1,2,3,-33.33,1,1,7,9,0.00,0,0,0,0, ,3,0,3,100.00,4,1,47,52,5.77
11815,FRA,7,Tillie Kevin ,OH,4,2,0,-7.69,6,4,4,6,14,0.00,2,1,0,3,33.33,0,3,6,9,-33.33,5,0,13,18,27.78,2,3,6,-16.67,0,0,2,2,0.00
11815,FRA,9,Ngapeth Earvin ,OH,15,2,1,10.00,18,15,6,7,28,32.14,2,2,1,5,0.00,1,5,11,17,-23.53,14,2,15,31,38.71,7,2,9,55.56,0,0,12,12,0.00
11815,FRA,11,Brizard Antoine ,S,3,1,1,20.00,5,3,0,0,3,100.00,1,0,2,3,33.33,1,2,6,9,-11.11,0,0,0,0, ,2,2,4,0.00,17,0,31,48,35.42
11815,FRA,12,Boyer Stephen ,O,5,3,0,12.50,8,5,4,3,12,8.33,3,0,2,5,60.00,0,1,6,7,-14.29,0,0,0,0, ,3,0,3,100.00,0,0,0,0, 
11815,FRA,14,Le Goff Nicolas ,MB,8,2,0,0.00,10,8,1,7,16,43.75,2,7,11,20,-25.00,0,2,14,16,-12.50,0,0,0,0, ,3,0,3,100.00,0,0,1,1,0.00
11815,FRA,16,Bultor Daryl ,MB,0,0,0, ,0,0,0,0,0, ,0,0,0,0, ,0,0,0,0, ,0,0,0,0, ,0,0,0, ,0,0,0,0, 
11815,FRA,17,Clevenot Trevor ,OH,10,0,0,17.86,10,10,2,6,18,44.44,0,2,1,3,-66.67,0,1,6,7,-14.29,5,0,4,9,55.56,2,0,2,100.00,0,0,1,1,0.00
11815,FRA,19,Louati Yacine ,OH,0,0,0,-50.00,0,0,0,0,0, ,0,0,0,0, ,0,1,1,2,-50.00,0,0,0,0, ,0,0,1,0.00,0,0,0,0, 
11815,FRA,20,Diez Benjamin ,L,0,0,0, ,0,0,0,0,0, ,0,0,0,0, ,0,0,0,0, ,0,0,0,0, ,0,0,0, ,0,0,0,0, 
11815,FRA,24,Gueye Mousse ,MB,0,0,0, ,0,0,0,0,0, ,0,0,0,0, ,0,0,0,0, ,0,0,0,0, ,0,0,0, ,0,0,0,0, 
11815,POL,1,Nowakowski Piotr ,MB,5,4,0,2.56,9,5,1,1,7,57.14,4,5,4,13,-7.69,0,2,17,19,-10.53,0,0,1,1,0.00,3,0,3,100.00,0,0,0,0, 
11815,POL,2,Muzaj Maciej ,O,0,0,0,-100.00,0,0,0,0,0, ,0,2,0,2,-100.00,0,0,0,0, ,0,0,0,0, ,1,0,1,100.00,0,0,0,0, 
11815,POL,6,Kurek Bartosz ,O,14,1,0,-9.43,15,14,7,8,29,24.14,1,6,3,10,-50.00,0,7,7,14,-50.00,0,0,0,0, ,6,3,10,30.00,0,0,5,5,0.00
11815,POL,9,Leon Venero Wilfredo ,OH,12,3,3,12.00,18,12,3,11,26,34.62,3,2,0,5,20.00,3,7,9,19,-21.05,12,1,15,28,39.29,3,2,6,16.67,0,0,2,2,0.00
11815,POL,10,Wojtaszek Damian ,L,0,0,0, ,0,0,0,0,0, ,0,0,0,0, ,0,0,0,0, ,6,2,12,20,20.00,9,4,13,38.46,0,0,7,7,0.00
11815,POL,11,Drzyzga Fabian ,S,0,1,0,-19.23,1,0,1,1,2,-50.00,1,2,4,7,-14.29,0,3,14,17,-17.65,0,0,1,1,0.00,7,0,10,70.00,29,1,67,97,28.87
11815,POL,12,Lomacz Grzegorz ,S,0,0,0, ,0,0,0,0,0, ,0,0,0,0, ,0,0,0,0, ,0,0,0,0, ,0,0,0, ,0,0,0,0, 
11815,POL,13,Kubiak Michal ,OH,10,2,0,5.66,12,10,4,11,25,24.00,2,2,4,8,0.00,0,3,17,20,-15.00,16,1,13,30,50.00,2,3,5,-20.00,0,0,4,4,0.00
11815,POL,14,Sliwka Aleksander ,OH,0,0,0, ,0,0,0,0,0, ,0,0,0,0, ,0,0,0,0, ,1,0,1,2,50.00,3,0,3,100.00,0,0,0,0, 
11815,POL,15,Kochanowski Jakub ,MB,0,0,0, ,0,0,0,0,0, ,0,0,0,0, ,0,0,0,0, ,0,0,0,0, ,0,0,0, ,0,0,0,0, 
11815,POL,16,Semeniuk Kamil ,OH,2,0,0,25.00,2,2,1,1,4,25.00,0,0,0,0, ,0,0,0,0, ,1,1,3,5,0.00,0,0,0, ,0,0,0,0, 
11815,POL,17,Zatorski Pawel ,L,0,0,0, ,0,0,0,0,0, ,0,0,0,0, ,0,0,0,0, ,0,0,0,0, ,0,0,0, ,0,0,0,0, 
11815,POL,20,Bieniek Mateusz ,MB,9,4,0,8.70,13,9,2,5,16,43.75,4,4,7,15,0.00,0,3,12,15,-20.00,0,0,0,0, ,2,0,3,66.67,0,0,1,1,0.00
11815,POL,77,Klos Karol ,MB,0,0,0, ,0,0,0,0,0, ,0,0,0,0, ,0,0,0,0, ,0,0,0,0, ,0,0,0, ,0,0,0,0, 
11816,IRI,2,Ebadipour Ghara H. Milad ,OH,12,1,2,8.51,15,12,2,9,23,43.48,1,5,2,8,-50.00,2,4,10,16,-12.50,4,1,10,15,20.00,3,0,3,100.00,0,0,2,2,0.00
11816,IRI,3,Abedini Reza ,MB,0,0,0, ,0,0,0,0,0, ,0,0,0,0, ,0,0,0,0, ,0,0,0,0, ,0,0,0, ,0,0,0,0, 
11816,IRI,4,Marouflakrani Mir Saeid ,S,1,0,0,-16.67,1,1,0,0,1,100.00,0,2,2,4,-50.00,0,1,6,7,-14.29,0,0,0,0, ,1,0,1,100.00,18,1,31,50,34.00
11816,IRI,6,Mousavi Eraghi Seyed Mohammad ,MB,7,3,0,-8.11,10,7,1,1,9,66.67,3,8,3,14,-35.71,0,4,10,14,-28.57,0,0,1,1,0.00,2,1,4,25.00,0,1,1,2,-50.00
11816,IRI,7,Fayazi D. Purya ,OH,0,0,0, ,0,0,0,0,0, ,0,0,0,0, ,0,0,0,0, ,0,0,0,0, ,0,0,0, ,0,0,0,0, 
11816,IRI,8,Hazratpourtalatappeh Mohammadreza ,L,0,0,0, ,0,0,0,0,0, ,0,0,0,0, ,0,0,0,0, ,8,0,8,16,50.00,8,3,12,41.67,0,0,4,4,0.00
11816,IRI,9,Gholami Masoud ,MB,5,3,1,11.43,9,5,2,1,8,37.50,3,3,2,8,0.00,1,0,18,19,5.26,0,0,1,1,0.00,1,2,3,-33.33,1,1,0,2,0.00
11816,IRI,10,Ghafour Amir ,O,12,1,0,9.38,13,12,5,2,19,36.84,1,1,2,4,0.00,0,4,5,9,-44.44,1,0,3,4,25.00,1,2,5,-20.00,0,0,3,3,0.00
11816,IRI,11,Kazemi Saber ,O,7,0,1,13.79,8,7,3,6,16,25.00,0,0,1,1,0.00,1,1,10,12,0.00,0,0,1,1,0.00,2,3,7,-14.29,0,0,2,2,0.00
11816,IRI,12,Sharifi Morteza ,OH,1,0,0,-22.22,1,1,0,4,5,20.00,0,2,0,2,-100.00,0,1,1,2,-50.00,0,0,2,2,0.00,0,0,0, ,0,0,1,1,0.00
11816,IRI,17,Salehi Meisam ,OH,13,0,0,-1.89,13,13,8,7,28,17.86,0,4,2,6,-66.67,0,2,17,19,-10.53,9,2,22,33,21.21,5,4,11,9.09,0,1,0,1,-100.00
11816,IRI,21,Salehi Arman ,L,0,0,0, ,0,0,0,0,0, ,0,0,0,0, ,0,0,0,0, ,5,0,10,15,33.33,2,4,7,-28.57,0,0,3,3,0.00
11816,IRI,23,Saadat Bardia ,O,0,0,0,0.00,0,0,0,0,0, ,0,0,1,1,0.00,0,0,0,0, ,0,0,0,0, ,0,0,0, ,0,0,1,1,0.00
11816,IRI,24,Karimisouchelmaei Javad ,S,1,1,1,10.00,3,1,0,1,2,50.00,1,0,0,1,100.00,1,2,4,7,-14.29,0,0,1,1,0.00,2,0,2,100.00,13,0,29,42,30.95
11816,ARG,1,Sanchez Matias ,S,0,0,0, ,0,0,0,0,0, ,0,0,0,0, ,0,0,0,0, ,0,0,0,0, ,1,0,1,100.00,2,0,2,4,50.00
11816,ARG,2,Pereyra Federico ,O,2,1,0,100.00,3,2,0,0,2,100.00,1,0,0,1,100.00,0,0,0,0, ,0,0,0,0, ,0,0,0, ,0,0,0,0, 
11816,ARG,3,Martinez Franchi Jan ,OH,0,0,0, ,0,0,0,0,0, ,0,0,0,0, ,0,0,0,0, ,0,0,0,0, ,0,0,0, ,0,0,0,0, 
11816,ARG,6,Poglajen Cristian ,OH,10,2,0,0.00,12,10,5,14,29,17.24,2,3,3,8,-12.50,0,4,17,21,-19.05,3,1,16,20,10.00,8,0,9,88.89,0,0,1,1,0.00
11816,ARG,7,Conte Facundo ,OH,9,2,0,0.00,11,9,5,4,18,22.22,2,2,2,6,0.00,0,4,10,14,-28.57,8,2,24,34,17.65,8,2,10,60.00,0,0,2,2,0.00
11816,ARG,8,Loser Agustin ,MB,10,2,0,10.00,12,10,1,2,13,69.23,2,3,3,8,-12.50,0,4,15,19,-21.05,0,1,2,3,-33.33,1,2,4,-25.00,0,0,0,0, 
11816,ARG,9,Danani Santiago ,L,0,0,0, ,0,0,0,0,0, ,0,0,0,0, ,0,0,0,0, ,10,1,15,26,34.62,6,5,13,7.69,0,0,6,6,0.00
11816,ARG,12,Lima Bruno ,O,23,0,1,11.48,24,23,3,9,35,57.14,0,8,2,10,-80.00,1,6,9,16,-31.25,0,0,1,1,0.00,6,1,8,62.50,0,0,1,1,0.00
11816,ARG,13,Palacios Ezequiel ,OH,0,0,0, ,0,0,0,0,0, ,0,0,0,0, ,0,0,0,0, ,0,0,0,0, ,0,0,0, ,0,0,0,0, 
11816,ARG,15,De Cecco Luciano ,S,1,2,1,0.00,4,1,0,0,1,100.00,2,2,0,4,0.00,1,2,14,17,-5.88,0,0,1,1,0.00,2,1,3,33.33,40,1,57,98,39.80
11816,ARG,16,Palonsky Luciano ,OH,0,0,0, ,0,0,0,0,0, ,0,0,0,0, ,0,0,0,0, ,0,0,0,0, ,0,0,0, ,0,0,0,0, 
11816,ARG,17,Mendez Nicolas ,OH,0,0,0, ,0,0,0,0,0, ,0,0,0,0, ,0,0,0,0, ,0,0,0,0, ,0,0,0, ,0,0,0,0, 
11816,ARG,18,Ramos Martin ,MB,10,3,1,8.16,14,10,1,3,14,64.29,3,6,1,10,-30.00,1,3,21,25,-8.00,0,0,1,1,0.00,3,0,4,75.00,0,0,1,1,0.00
11816,ARG,19,Massimino Franco ,L,0,0,0, ,0,0,0,0,0, ,0,0,0,0, ,0,0,0,0, ,0,0,0,0, ,0,0,0, ,0,0,0,0, 
11817,SLO,1,Å tern TonÄek ,O,12,1,0,16.67,13,12,3,4,19,47.37,1,3,1,5,-40.00,0,1,11,12,-8.33,0,0,0,0, ,1,0,1,100.00,0,0,0,0, 
11817,SLO,2,Pajenk Alen ,MB,5,0,1,14.29,6,5,2,0,7,42.86,0,1,1,2,-50.00,1,0,11,12,8.33,0,0,0,0, ,2,0,2,100.00,0,0,0,0, 
11817,SLO,4,Kozamernik Jan ,MB,2,1,0,-5.00,3,2,0,0,2,100.00,1,1,4,6,0.00,0,3,9,12,-25.00,0,0,0,0, ,5,1,6,66.67,0,0,2,2,0.00
11817,SLO,5,Å ket Alen ,O,0,0,0, ,0,0,0,0,0, ,0,0,0,0, ,0,0,0,0, ,0,0,0,0, ,0,0,0, ,0,0,0,0, 
11817,SLO,6,Gasparini Mitja ,O,0,0,0, ,0,0,0,0,0, ,0,0,0,0, ,0,0,0,0, ,0,0,0,0, ,0,0,0, ,0,0,0,0, 
11817,SLO,9,Vincic Dejan ,S,0,0,0, ,0,0,0,0,0, ,0,0,0,0, ,0,0,0,0, ,0,0,0,0, ,0,0,0, ,0,0,0,0, 
11817,SLO,10,Å talekar SaÅ¡o ,MB,0,0,0,-33.33,0,0,0,1,1,0.00,0,0,0,0, ,0,1,1,2,-50.00,0,0,1,1,0.00,0,0,0, ,0,0,0,0, 
11817,SLO,11,Å tern Å½iga ,OH,0,0,0, ,0,0,0,0,0, ,0,0,0,0, ,0,0,0,0, ,0,0,0,0, ,0,0,0, ,0,0,0,0, 
11817,SLO,12,Klobucar Jan ,L,0,0,0, ,0,0,0,0,0, ,0,0,0,0, ,0,0,0,0, ,0,1,2,3,-33.33,1,0,1,100.00,0,0,1,1,0.00
11817,SLO,13,KovaÄiÄ Jani ,L,0,0,0, ,0,0,0,0,0, ,0,0,0,0, ,0,0,0,0, ,7,0,7,14,50.00,6,5,11,9.09,0,0,2,2,0.00
11817,SLO,16,Ropret Gregor ,S,0,0,1,-5.88,1,0,0,1,1,0.00,0,0,3,3,0.00,1,2,10,13,-7.69,0,0,0,0, ,3,2,6,16.67,18,0,36,54,33.33
11817,SLO,17,Urnaut Tine ,OH,3,0,1,0.00,4,3,2,1,6,16.67,0,2,0,2,-100.00,1,0,6,7,14.29,0,0,2,2,0.00,1,1,2,0.00,0,0,4,4,0.00
11817,SLO,18,Äebulj Klemen ,OH,6,1,0,-7.89,7,6,4,9,19,10.53,1,5,4,10,-40.00,0,1,8,9,-11.11,5,1,10,16,25.00,9,2,12,58.33,0,0,2,2,0.00
11817,SLO,19,MoÅ¾iÄ Rok ,OH,8,2,0,22.73,10,8,1,1,10,70.00,2,3,0,5,-20.00,0,1,6,7,-14.29,0,0,5,5,0.00,1,0,2,50.00,0,0,1,1,0.00
11817,BUL,1,Karyagin Denis ,O,8,1,1,0.00,10,8,5,7,20,15.00,1,3,1,5,-40.00,1,2,10,13,-7.69,0,0,0,0, ,0,0,0, ,0,0,1,1,0.00
11817,BUL,2,Chavdarov Stefan ,MB,3,3,0,-11.11,6,3,0,0,3,100.00,3,5,1,9,-22.22,0,3,3,6,-50.00,0,0,0,0, ,1,0,2,50.00,0,0,0,0, 
11817,BUL,3,Kolev Nikolay ,MB,4,2,0,16.67,6,4,0,0,4,100.00,2,3,2,7,-14.29,0,0,7,7,0.00,0,0,1,1,0.00,0,0,1,0.00,0,0,2,2,0.00
11817,BUL,4,Atanasov Martin ,OH,0,0,0, ,0,0,0,0,0, ,0,0,0,0, ,0,0,0,0, ,0,0,0,0, ,0,0,0, ,0,0,0,0, 
11817,BUL,6,Stankov Vladimir ,S,0,0,0,-50.00,0,0,0,0,0, ,0,0,0,0, ,0,1,1,2,-50.00,0,0,0,0, ,0,0,0, ,0,0,0,0, 
11817,BUL,9,Seganov Georgi ,S,2,1,1,-5.88,4,2,1,1,4,25.00,1,2,2,5,-20.00,1,2,5,8,-12.50,0,0,0,0, ,1,2,6,-16.67,27,2,32,61,40.98
11817,BUL,10,Stankov Svetoslav ,S,0,0,0, ,0,0,0,0,0, ,0,0,0,0, ,0,0,0,0, ,0,0,0,0, ,0,0,0, ,0,0,0,0, 
11817,BUL,12,Petrov Georgi ,OH,5,0,0,5.26,5,5,1,7,13,30.77,0,1,0,1,-100.00,0,2,3,5,-40.00,5,1,14,20,20.00,1,1,2,0.00,0,0,0,0, 
11817,BUL,14,Asparuhov Asparuh ,OH,10,0,0,-6.90,10,10,6,1,17,23.53,0,2,1,3,-66.67,0,4,5,9,-44.44,10,1,14,25,36.00,1,1,3,0.00,0,0,1,1,0.00
11817,BUL,15,Lyutskanov Gordan ,OH,1,0,0,-18.18,1,1,0,6,7,14.29,0,1,0,1,-100.00,0,2,1,3,-66.67,2,1,8,11,9.09,1,0,1,100.00,0,0,0,0, 
11817,BUL,16,Ivanov Vladislav ,L,0,0,0, ,0,0,0,0,0, ,0,0,0,0, ,0,0,0,0, ,1,0,7,8,12.50,5,1,6,66.67,0,0,6,6,0.00
11817,BUL,22,Kartev Nikolay ,MB,1,1,0,-18.18,2,1,1,2,4,0.00,1,3,0,4,-50.00,0,0,3,3,0.00,0,0,0,0, ,1,0,2,50.00,0,0,0,0, 
11817,BUL,24,Ivanov Martin ,L,0,0,0, ,0,0,0,0,0, ,0,0,0,0, ,0,0,0,0, ,0,0,0,0, ,0,0,0, ,0,0,0,0, 
11817,BUL,25,Parapunov Radoslav ,O,0,0,0,-75.00,0,0,2,0,2,-100.00,0,0,0,0, ,0,1,1,2,-50.00,0,0,0,0, ,0,0,0, ,0,0,0,0, 
11818,ITA,7,Balaso Fabio ,L,0,0,0, ,0,0,0,0,0, ,0,0,0,0, ,0,0,0,0, ,5,3,15,23,8.70,12,4,17,47.06,0,0,12,12,0.00
11818,ITA,15,Sbertoli Riccardo ,S,1,1,0,-11.11,2,1,0,2,3,33.33,1,3,8,12,-16.67,0,2,10,12,-16.67,0,0,0,0, ,8,1,10,70.00,21,2,44,67,28.36
11818,ITA,18,Michieletto Alessandro ,OH,17,3,2,17.46,22,17,5,13,35,34.29,3,2,2,7,14.29,2,4,15,21,-9.52,5,0,15,20,25.00,13,2,16,68.75,0,0,4,4,0.00
11818,ITA,20,Nelli Gabriele ,O,10,2,0,-2.17,12,10,3,11,24,29.17,2,5,5,12,-25.00,0,5,5,10,-50.00,0,0,0,0, ,13,1,16,75.00,0,0,3,3,0.00
11818,ITA,21,Spirito Luca ,S,0,0,0,0.00,0,0,0,1,1,0.00,0,0,2,2,0.00,0,0,4,4,0.00,0,0,0,0, ,2,0,2,100.00,9,0,25,34,26.47
11818,ITA,23,Pinali Giulio ,O,2,1,1,-12.50,4,2,3,4,9,-11.11,1,0,0,1,100.00,1,3,2,6,-33.33,0,0,0,0, ,2,0,2,100.00,0,0,0,0, 
11818,ITA,24,Cavuto Oreste ,OH,3,0,1,33.33,4,3,0,2,5,60.00,0,0,1,1,0.00,1,1,1,3,0.00,3,0,7,10,30.00,0,1,1,-100.00,0,0,0,0, 
11818,ITA,25,Vitelli Marco ,MB,1,0,0,-9.09,1,1,0,0,1,100.00,0,0,0,0, ,0,2,8,10,-20.00,0,0,0,0, ,0,0,0, ,0,0,0,0, 
11818,ITA,26,Cortesia Lorenzo ,MB,3,3,0,2.86,6,3,0,1,4,75.00,3,5,2,10,-20.00,0,0,21,21,0.00,0,0,0,0, ,0,2,2,-100.00,0,0,3,3,0.00
11818,ITA,27,Scanferla Leonardo ,L,0,0,0, ,0,0,0,0,0, ,0,0,0,0, ,0,0,0,0, ,0,0,0,0, ,0,0,0, ,0,0,0,0, 
11818,ITA,28,Recine Francesco ,OH,0,0,0, ,0,0,0,0,0, ,0,0,0,0, ,0,0,0,0, ,0,1,0,1,-100.00,0,0,0, ,0,0,0,0, 
11818,ITA,29,Bottolo Mattia ,OH,12,1,1,9.09,14,12,5,13,30,23.33,1,1,1,3,0.00,1,4,6,11,-27.27,4,1,15,20,15.00,4,1,5,60.00,0,0,0,0, 
11818,ITA,30,Mosca Leandro Ausibio ,MB,9,4,0,13.16,13,9,1,3,13,61.54,4,6,4,14,-14.29,0,1,10,11,-9.09,0,0,4,4,0.00,2,0,2,100.00,0,0,0,0, 
11818,ITA,31,Federici Filippo ,L,0,0,0, ,0,0,0,0,0, ,0,0,0,0, ,0,0,0,0, ,0,0,0,0, ,0,0,0, ,0,0,0,0, 
11818,GER,1,Fromm Christian ,OH,0,0,0, ,0,0,0,0,0, ,0,0,0,0, ,0,0,0,0, ,0,0,0,0, ,0,0,0, ,0,0,0,0, 
11818,GER,3,Schott Ruben ,OH,10,1,3,1.72,14,10,5,16,31,16.13,1,5,0,6,-66.67,3,3,15,21,0.00,15,2,26,43,30.23,10,1,12,75.00,0,1,8,9,-11.11
11818,GER,5,Reichert Moritz ,OH,6,2,1,0.00,9,6,6,9,21,0.00,2,0,2,4,50.00,1,3,9,13,-15.38,4,1,6,11,27.27,6,3,9,33.33,0,0,2,2,0.00
11818,GER,6,Kaliberda Denys ,OH,0,0,0, ,0,0,0,0,0, ,0,0,0,0, ,0,0,0,0, ,0,0,0,0, ,0,0,0, ,0,0,0,0, 
11818,GER,7,Sossenheimer David ,OH,1,0,0,-30.00,1,1,2,5,8,-12.50,0,1,2,3,-33.33,0,4,5,9,-44.44,0,1,8,9,-11.11,2,0,3,66.67,0,0,2,2,0.00
11818,GER,8,BÃ¶hme Marcus ,MB,4,0,0,-15.79,4,4,1,2,7,42.86,0,5,0,5,-100.00,0,1,6,7,-14.29,0,0,1,1,0.00,1,0,2,50.00,0,0,0,0, 
11818,GER,10,Zenger Julian ,L,0,0,0, ,0,0,0,0,0, ,0,0,0,0, ,0,0,0,0, ,8,1,13,22,31.82,11,6,20,25.00,0,0,7,7,0.00
11818,GER,13,Hirsch Simon ,O,12,2,1,12.28,15,12,6,15,33,18.18,2,1,2,5,20.00,1,1,17,19,0.00,0,0,1,1,0.00,8,2,10,60.00,0,0,4,4,0.00
11818,GER,15,BaxpÃ¶hler Noah ,MB,2,1,0,7.14,3,2,0,2,4,50.00,1,1,3,5,0.00,0,1,4,5,-20.00,0,0,0,0, ,2,0,2,100.00,0,0,0,0, 
11818,GER,16,BurggrÃ¤f Eric ,S,0,0,0, ,0,0,0,0,0, ,0,0,0,0, ,0,0,0,0, ,0,0,0,0, ,0,0,0, ,0,0,0,0, 
11818,GER,17,Zimmermann Jan ,S,2,0,0,-29.17,2,2,0,0,2,100.00,0,5,3,8,-62.50,0,4,10,14,-28.57,0,0,0,0, ,9,2,12,58.33,33,0,74,107,30.84
11818,GER,19,RÃ¶hrs Erik ,OH,0,0,0, ,0,0,0,0,0, ,0,0,0,0, ,0,0,0,0, ,0,0,0,0, ,0,0,0, ,0,0,0,0, 
11818,GER,20,Weber Linus ,O,2,0,0,-18.18,2,2,3,4,9,-11.11,0,0,0,0, ,0,1,1,2,-50.00,0,0,0,0, ,0,1,2,-50.00,0,0,0,0, 
11818,GER,21,Krick Tobias ,MB,13,3,0,17.14,16,13,2,1,16,68.75,3,5,2,10,-20.00,0,3,6,9,-33.33,0,0,0,0, ,4,0,4,100.00,0,0,0,0, 
11819,BRA,1,Rezende Bruno Mossa ,S,0,0,0,-22.22,0,0,0,0,0, ,0,1,1,2,-50.00,0,1,6,7,-14.29,0,0,0,0, ,2,5,10,-30.00,15,0,27,42,35.71
11819,BRA,5,Borges Almeida Silva Mauricio ,OH,3,0,0,-11.11,3,3,3,0,6,0.00,0,0,0,0, ,0,1,2,3,-33.33,0,1,2,3,-33.33,2,0,2,100.00,0,0,0,0, 
11819,BRA,6,Gil Kreling Fernando ,S,0,0,0,-20.00,0,0,0,0,0, ,0,0,1,1,0.00,0,1,3,4,-25.00,0,0,0,0, ,1,0,1,100.00,3,0,15,18,16.67
11819,BRA,8,De Souza Wallace ,O,6,2,2,7.69,10,6,3,2,11,27.27,2,2,2,6,0.00,2,3,4,9,-11.11,0,0,0,0, ,4,0,5,80.00,0,0,0,0, 
11819,BRA,9,Leal Hidalgo Yoandy ,OH,6,0,0,-11.11,6,6,6,5,17,0.00,0,3,0,3,-100.00,0,0,7,7,0.00,1,3,7,11,-18.18,3,0,3,100.00,0,0,1,1,0.00
11819,BRA,12,Santos Isac ,MB,1,0,0,-33.33,1,1,1,2,4,0.00,0,2,1,3,-66.67,0,1,1,2,-50.00,0,0,0,0, ,0,0,0, ,0,0,1,1,0.00
11819,BRA,13,De Souza Mauricio Luiz ,MB,3,1,0,11.11,4,3,0,3,6,50.00,1,2,2,5,-20.00,0,0,7,7,0.00,0,0,0,0, ,0,0,0, ,0,0,2,2,0.00
11819,BRA,14,Correia De Souza Douglas ,OH,2,0,1,0.00,3,2,1,1,4,25.00,0,0,1,1,0.00,1,2,2,5,-20.00,1,0,10,11,9.09,2,0,3,66.67,0,0,1,1,0.00
11819,BRA,15,Nascimento Maique Reis ,L,0,0,0, ,0,0,0,0,0, ,0,0,0,0, ,0,0,0,0, ,0,0,0,0, ,0,0,0, ,0,0,0,0, 
11819,BRA,16,Saatkamp Lucas ,MB,4,0,0,-11.11,4,4,1,1,6,50.00,0,5,3,8,-62.50,0,0,4,4,0.00,0,0,0,0, ,0,0,0, ,0,0,0,0, 
11819,BRA,17,Hoss Thales ,L,0,0,0, ,0,0,0,0,0, ,0,0,0,0, ,0,0,0,0, ,5,1,11,17,23.53,4,3,7,14.29,0,0,4,4,0.00
11819,BRA,18,Souza Ricardo Lucarelli ,OH,6,0,1,9.52,7,6,3,1,10,30.00,0,0,1,1,0.00,1,2,7,10,-10.00,4,2,13,19,10.53,5,2,7,42.86,0,0,3,3,0.00
11819,BRA,21,Souza Alan ,O,4,1,0,25.00,5,4,0,2,6,66.67,1,1,1,3,0.00,0,0,7,7,0.00,0,0,0,0, ,0,0,0, ,0,0,0,0, 
11819,BRA,23,Resende Gualberto Flavio ,MB,1,0,0,16.67,1,1,0,1,2,50.00,0,0,0,0, ,0,0,4,4,0.00,0,0,0,0, ,0,0,0, ,0,0,1,1,0.00
11819,RUS,1,Podlesnykh Yaroslav ,OH,10,2,0,9.52,12,10,4,11,25,24.00,2,1,0,3,33.33,0,3,11,14,-21.43,1,2,12,15,-6.67,3,2,7,14.29,0,0,1,1,0.00
11819,RUS,2,Vlasov Ilia ,MB,3,3,1,-4.55,7,3,0,0,3,100.00,3,6,3,12,-25.00,1,2,4,7,-14.29,0,0,0,0, ,1,0,1,100.00,0,0,0,0, 
11819,RUS,4,Volvich Artem ,MB,3,2,1,23.81,6,3,0,3,6,50.00,2,0,2,4,50.00,1,1,9,11,0.00,1,0,0,1,100.00,0,0,1,0.00,0,0,0,0, 
11819,RUS,6,Baranov Evgeny ,L,0,0,0, ,0,0,0,0,0, ,0,0,0,0, ,0,0,0,0, ,0,0,0,0, ,0,0,0, ,0,0,0,0, 
11819,RUS,7,Volkov Dmitry ,OH,0,0,0,-33.33,0,0,0,0,0, ,0,0,0,0, ,0,1,2,3,-33.33,0,0,0,0, ,0,0,0, ,0,0,0,0, 
11819,RUS,9,Iakovlev Ivan ,MB,0,0,0, ,0,0,0,0,0, ,0,0,0,0, ,0,0,0,0, ,0,0,0,0, ,0,0,0, ,0,0,0,0, 
11819,RUS,10,Bogdan Denis ,OH,0,0,0,-100.00,0,0,0,0,0, ,0,0,0,0, ,0,2,0,2,-100.00,0,0,0,0, ,0,0,0, ,0,0,0,0, 
11819,RUS,11,Pankov Pavel ,S,0,0,0, ,0,0,0,0,0, ,0,0,0,0, ,0,0,0,0, ,0,0,0,0, ,0,0,0, ,0,0,0,0, 
11819,RUS,15,Poletaev Victor ,O,0,0,0, ,0,0,0,0,0, ,0,0,0,0, ,0,0,0,0, ,0,0,0,0, ,0,0,0, ,0,0,0,0, 
11819,RUS,17,Mikhaylov Maxim ,O,11,1,2,23.53,14,11,1,4,16,62.50,1,2,0,3,-33.33,2,3,10,15,-6.67,0,0,1,1,0.00,6,0,7,85.71,0,0,2,2,0.00
11819,RUS,18,Kliuka Egor ,OH,11,1,1,21.88,13,11,3,5,19,42.11,1,3,0,4,-50.00,1,0,8,9,11.11,4,0,14,18,22.22,2,1,3,33.33,0,0,2,2,0.00
11819,RUS,20,Kurkaev Ilyas ,MB,1,0,0,0.00,1,1,1,1,3,0.00,0,0,1,1,0.00,0,0,2,2,0.00,0,0,0,0, ,0,0,0, ,0,0,1,1,0.00
11819,RUS,24,Kobzar Igor ,S,1,0,2,-10.00,3,1,0,2,3,33.33,0,2,2,4,-50.00,2,3,8,13,-7.69,0,0,0,0, ,2,1,3,33.33,21,2,38,61,31.15
11819,RUS,27,Golubev Valentin ,L,0,0,0, ,0,0,0,0,0, ,0,0,0,0, ,0,0,0,0, ,5,2,16,23,13.04,5,6,11,-9.09,0,0,5,5,0.00
11950,BRA,2,De Oliveira Saad Gattaz Caroline ,MB,4,3,1,6.52,8,4,1,9,14,21.43,3,4,6,13,-7.69,1,0,18,19,5.26,0,0,0,0, ,6,0,6,100.00,0,0,3,3,0.00
11950,BRA,5,Da Silva Adenizia ,MB,0,0,0, ,0,0,0,0,0, ,0,0,0,0, ,0,0,0,0, ,0,0,0,0, ,0,0,0, ,0,0,0,0, 
11950,BRA,6,Alexandre Costa Nunes Nyeme Victoria ,L,0,0,0, ,0,0,0,0,0, ,0,0,0,0, ,0,0,0,0, ,0,0,0,0, ,0,0,0, ,0,0,0,0, 
11950,BRA,7,Montibeller Rosamaria ,OH,4,1,0,62.50,5,4,0,2,6,66.67,1,0,1,2,50.00,0,0,0,0, ,0,0,0,0, ,0,0,0, ,0,0,0,0, 
11950,BRA,8,Silva Carneiro Macris Fernanda ,S,0,1,0,-9.52,1,0,0,1,1,0.00,1,3,3,7,-28.57,0,0,13,13,0.00,0,0,0,0, ,12,2,14,71.43,34,1,75,110,30.00
11950,BRA,9,Ratzke Roberta Silva ,S,0,0,0,0.00,0,0,0,0,0, ,0,0,0,0, ,0,0,2,2,0.00,0,0,0,0, ,2,0,2,100.00,3,0,11,14,21.43
11950,BRA,10,Braga Guimaraes Gabriela ,OH,17,0,1,19.64,18,17,3,11,31,45.16,0,3,1,4,-75.00,1,1,19,21,0.00,11,0,23,34,32.35,14,1,18,72.22,0,0,2,2,0.00
11950,BRA,11,Caixeta Tandara ,OH,22,1,0,21.33,23,22,4,21,47,38.30,1,3,9,13,-15.38,0,0,15,15,0.00,0,0,0,0, ,15,3,20,60.00,0,0,2,2,0.00
11950,BRA,12,Pereira Natalia ,OH,5,1,0,10.53,6,5,1,6,12,33.33,1,3,0,4,-50.00,0,0,3,3,0.00,6,0,3,9,66.67,3,0,5,60.00,0,0,2,2,0.00
11950,BRA,13,Castro De Paula Blassioli Sheilla ,O,0,0,0, ,0,0,0,0,0, ,0,0,0,0, ,0,0,0,0, ,0,0,0,0, ,0,0,0, ,0,0,0,0, 
11950,BRA,15,Da Silva Ana Carolina ,MB,2,2,0,27.27,4,2,0,1,3,66.67,2,1,1,4,25.00,0,0,4,4,0.00,0,0,0,0, ,0,0,0, ,0,0,0,0, 
11950,BRA,16,Rodrigues Fernanda ,OH,12,1,0,15.56,13,12,3,15,30,30.00,1,2,1,4,-25.00,0,1,10,11,-9.09,3,0,7,10,30.00,10,1,14,64.29,0,0,0,0, 
11950,BRA,18,Brait Camila ,L,0,0,0, ,0,0,0,0,0, ,0,0,0,0, ,0,0,0,0, ,8,4,17,29,13.79,10,3,14,50.00,0,0,15,15,0.00
11950,BRA,20,Correa Ana Beatriz ,MB,3,3,1,-2.94,7,3,1,3,7,28.57,3,5,4,12,-16.67,1,2,12,15,-6.67,0,0,0,0, ,5,0,5,100.00,0,0,2,2,0.00
11950,JPN,1,Kurogo Ai ,OH,15,0,2,9.09,17,15,6,22,43,20.93,0,3,3,6,-50.00,2,2,13,17,0.00,2,0,6,8,25.00,19,3,25,64.00,0,0,6,6,0.00
11950,JPN,2,Koga Sarina ,OH,16,0,2,12.16,18,16,6,28,50,20.00,0,3,4,7,-42.86,2,0,15,17,11.76,20,1,17,38,50.00,13,3,21,47.62,0,0,3,3,0.00
11950,JPN,3,Shimamura Haruyo ,MB,7,1,0,2.56,8,7,3,8,18,22.22,1,4,8,13,-23.08,0,0,8,8,0.00,0,0,0,0, ,4,0,6,66.67,0,0,2,2,0.00
11950,JPN,5,Araki Erika ,MB,5,1,0,-11.43,6,5,1,4,10,40.00,1,8,3,12,-58.33,0,1,12,13,-7.69,0,0,0,0, ,1,0,1,100.00,0,0,2,2,0.00
11950,JPN,7,Ishii Yuki ,OH,0,0,0, ,0,0,0,0,0, ,0,0,0,0, ,0,0,0,0, ,0,0,0,0, ,0,0,0, ,0,0,0,0, 
11950,JPN,8,Ishikawa Mayu ,OH,17,1,0,11.48,18,17,8,17,42,21.43,1,2,1,4,-25.00,0,1,14,15,-6.67,17,0,21,38,44.74,9,4,13,38.46,0,0,5,5,0.00
11950,JPN,9,Tashiro Kanami ,S,0,0,0,0.00,0,0,0,0,0, ,0,0,0,0, ,0,0,3,3,0.00,0,0,0,0, ,1,1,2,0.00,2,0,3,5,40.00
11950,JPN,11,Nabeya Yurie ,OH,0,0,0,0.00,0,0,0,0,0, ,0,0,0,0, ,0,0,3,3,0.00,0,0,0,0, ,0,0,0, ,0,0,0,0, 
11950,JPN,13,Okumura Mai ,MB,0,0,0, ,0,0,0,0,0, ,0,0,0,0, ,0,0,0,0, ,0,0,0,0, ,0,0,0, ,0,0,0,0, 
11950,JPN,14,Kobata Mako ,L,0,0,0, ,0,0,0,0,0, ,0,0,0,0, ,0,0,0,0, ,7,2,6,15,33.33,15,2,19,68.42,0,0,9,9,0.00
11950,JPN,15,Inoue Kotoe ,L,0,0,0, ,0,0,0,0,0, ,0,0,0,0, ,0,0,0,0, ,0,0,0,0, ,0,0,0, ,0,0,0,0, 
11950,JPN,19,Yamada Nichika ,MB,0,0,0, ,0,0,0,0,0, ,0,0,0,0, ,0,0,0,0, ,0,0,0,0, ,0,0,0, ,0,0,0,0, 
11950,JPN,21,Hayashi Kotona ,OH,0,0,0,0.00,0,0,0,0,0, ,0,0,0,0, ,0,0,3,3,0.00,0,0,0,0, ,0,0,0, ,0,0,0,0, 
11950,JPN,24,Momii Aki ,S,2,2,0,-13.64,4,2,1,1,4,25.00,2,6,3,11,-36.36,0,0,7,7,0.00,0,0,0,0, ,13,3,16,62.50,38,2,93,133,27.07
11951,USA,1,Hancock Micha ,S,0,0,0, ,0,0,0,0,0, ,0,0,0,0, ,0,0,0,0, ,0,0,0,0, ,0,0,0, ,0,0,0,0, 
11951,USA,2,Poulter Jordyn ,S,1,3,1,3.03,5,1,0,2,3,33.33,3,3,3,9,0.00,1,1,19,21,0.00,0,0,0,0, ,7,1,8,75.00,13,1,77,91,13.19
11951,USA,4,Wong-Orantes Justine ,L,0,0,0, ,0,0,0,0,0, ,0,0,0,0, ,0,0,0,0, ,5,1,12,18,22.22,14,3,21,52.38,0,0,7,7,0.00
11951,USA,10,Larson Jordan ,OH,2,0,0,-4.76,2,2,2,11,15,0.00,0,1,1,2,-50.00,0,0,4,4,0.00,1,1,8,10,0.00,6,1,7,71.43,0,0,2,2,0.00
11951,USA,11,Drews Andrea ,O,7,0,2,25.00,9,7,2,2,11,45.45,0,2,1,3,-66.67,2,0,4,6,33.33,0,0,0,0, ,5,1,7,57.14,0,0,0,0, 
11951,USA,12,Thompson Jordan ,O,4,1,0,-4.17,5,4,3,10,17,5.88,1,1,1,3,0.00,0,2,2,4,-50.00,0,0,0,0, ,1,2,3,-33.33,0,0,0,0, 
11951,USA,14,Bartsch-Hackley Michelle ,OH,7,1,0,0.00,8,7,2,14,23,21.74,1,5,3,9,-44.44,0,1,10,11,-9.09,11,1,12,24,41.67,11,1,14,71.43,0,0,3,3,0.00
11951,USA,15,Hill Kimberly ,OH,0,0,0,-25.00,0,0,0,0,0, ,0,0,0,0, ,0,1,3,4,-25.00,0,0,0,0, ,0,0,0, ,0,0,0,0, 
11951,USA,16,Akinradewo Foluke ,MB,6,2,0,10.71,8,6,1,3,10,50.00,2,4,5,11,-18.18,0,0,7,7,0.00,0,0,0,0, ,3,0,4,75.00,0,0,0,0, 
11951,USA,22,Washington Haleigh ,MB,6,0,1,10.71,7,6,0,4,10,60.00,0,4,3,7,-57.14,1,0,10,11,9.09,0,0,0,0, ,2,2,4,0.00,0,0,1,1,0.00
11951,USA,23,Robinson Kelsey ,OH,7,0,0,20.00,7,7,3,5,15,26.67,0,0,0,0, ,0,0,5,5,0.00,1,0,2,3,33.33,4,1,5,60.00,0,0,1,1,0.00
11951,USA,24,Ogbogu Chiaka ,MB,0,0,0, ,0,0,0,0,0, ,0,0,0,0, ,0,0,0,0, ,0,0,0,0, ,0,0,0, ,0,0,0,0, 
11951,TUR,2,Akoz Simge Sebnem ,L,0,0,0, ,0,0,0,0,0, ,0,0,0,0, ,0,0,0,0, ,9,3,4,16,37.50,12,4,16,50.00,0,0,9,9,0.00
11951,TUR,3,Ãzbay Cansu ,S,3,0,1,0.00,4,3,0,1,4,75.00,0,2,2,4,-50.00,1,2,7,10,-10.00,0,0,1,1,0.00,15,0,16,93.75,10,0,83,93,10.75
11951,TUR,4,Senoglu Tugba ,OH,3,0,0,-14.81,3,3,3,5,11,0.00,0,3,2,5,-60.00,0,1,10,11,-9.09,3,1,8,12,16.67,4,0,4,100.00,0,0,0,0, 
11951,TUR,5,Ercan Seyma ,OH,0,0,0, ,0,0,0,0,0, ,0,0,0,0, ,0,0,0,0, ,0,0,0,0, ,0,0,0, ,0,0,0,0, 
11951,TUR,6,Caliskan Kubra ,MB,4,1,0,-10.34,5,4,1,4,9,33.33,1,4,2,7,-42.86,0,3,10,13,-23.08,1,0,1,2,50.00,1,0,1,100.00,0,0,2,2,0.00
11951,TUR,7,Baladin Hande ,OH,7,1,1,-2.94,9,7,6,7,20,5.00,1,2,0,3,-33.33,1,2,8,11,-9.09,11,0,17,28,39.29,6,1,7,71.43,0,0,4,4,0.00
11951,TUR,9,Ismailoglu Meliha ,OH,0,0,0,-33.33,0,0,4,3,7,-57.14,0,0,1,1,0.00,0,0,4,4,0.00,3,0,6,9,33.33,5,0,6,83.33,0,0,2,2,0.00
11951,TUR,12,Unal Buse ,S,0,0,0,0.00,0,0,0,0,0, ,0,0,0,0, ,0,0,1,1,0.00,0,0,0,0, ,0,0,0, ,0,0,0,0, 
11951,TUR,13,Boz Meryem ,O,1,0,0,12.50,1,1,0,6,7,14.29,0,0,1,1,0.00,0,0,0,0, ,0,0,0,0, ,0,0,0, ,0,0,0,0, 
11951,TUR,14,Erdem DÃ¼ndar Eda ,MB,9,1,1,16.22,11,9,2,7,18,38.89,1,3,6,10,-20.00,1,0,8,9,11.11,0,0,0,0, ,2,1,3,33.33,0,0,0,0, 
11951,TUR,19,Kalac Asli ,MB,1,0,0,0.00,1,1,0,1,2,50.00,0,1,0,1,-100.00,0,0,0,0, ,0,0,0,0, ,0,0,0, ,0,0,0,0, 
11951,TUR,20,Cebecioglu Derya ,OH,0,0,0, ,0,0,0,0,0, ,0,0,0,0, ,0,0,0,0, ,0,0,0,0, ,0,0,0, ,0,0,0,0, 
11951,TUR,22,Aydin Ä°lkin ,OH,0,0,0, ,0,0,0,0,0, ,0,0,0,0, ,0,0,0,0, ,0,0,0,0, ,0,0,0, ,0,0,0,0, 
11951,TUR,99,Karakurt Ebrar ,OH,14,3,0,17.86,17,14,3,19,36,30.56,3,1,9,13,15.38,0,3,4,7,-42.86,0,0,0,0, ,7,3,11,36.36,0,0,0,0, 
11952,JPN,1,Kurogo Ai ,OH,8,0,0,0.00,8,8,6,14,28,7.14,0,2,1,3,-66.67,0,0,9,9,0.00,1,0,5,6,16.67,9,2,11,63.64,0,0,3,3,0.00
11952,JPN,2,Koga Sarina ,OH,10,0,1,14.29,11,10,5,11,26,19.23,0,1,0,1,-100.00,1,0,7,8,12.50,7,2,8,17,29.41,4,2,6,33.33,0,0,2,2,0.00
11952,JPN,3,Shimamura Haruyo ,MB,2,1,0,-5.26,3,2,1,3,6,16.67,1,2,2,5,-20.00,0,1,7,8,-12.50,0,0,0,0, ,1,0,1,100.00,0,0,1,1,0.00
11952,JPN,5,Araki Erika ,MB,3,2,0,8.00,5,3,0,7,10,30.00,2,3,0,5,-20.00,0,0,10,10,0.00,0,0,0,0, ,0,2,3,-66.67,0,0,1,1,0.00
11952,JPN,7,Ishii Yuki ,OH,1,0,0,-20.00,1,1,0,0,1,100.00,0,1,0,1,-100.00,0,1,2,3,-33.33,4,0,5,9,44.44,1,1,2,0.00,0,0,0,0, 
11952,JPN,8,Ishikawa Mayu ,OH,6,0,0,0.00,6,6,5,8,19,5.26,0,0,0,0, ,0,1,6,7,-14.29,11,0,12,23,47.83,2,1,6,16.67,0,0,0,0, 
11952,JPN,9,Tashiro Kanami ,S,0,0,0,0.00,0,0,0,0,0, ,0,0,0,0, ,0,0,2,2,0.00,0,0,0,0, ,0,0,0, ,2,0,13,15,13.33
11952,JPN,11,Nabeya Yurie ,OH,0,0,0,0.00,0,0,0,0,0, ,0,0,0,0, ,0,0,1,1,0.00,0,0,0,0, ,0,0,0, ,0,0,1,1,0.00
11952,JPN,13,Okumura Mai ,MB,0,0,0, ,0,0,0,0,0, ,0,0,0,0, ,0,0,0,0, ,0,0,0,0, ,0,0,0, ,0,0,0,0, 
11952,JPN,14,Kobata Mako ,L,0,0,0, ,0,0,0,0,0, ,0,0,0,0, ,0,0,0,0, ,7,0,3,10,70.00,6,3,11,27.27,0,0,6,6,0.00
11952,JPN,15,Inoue Kotoe ,L,0,0,0, ,0,0,0,0,0, ,0,0,0,0, ,0,0,0,0, ,0,0,0,0, ,0,0,0, ,0,0,0,0, 
11952,JPN,19,Yamada Nichika ,MB,0,0,0, ,0,0,0,0,0, ,0,0,0,0, ,0,0,0,0, ,0,0,0,0, ,0,0,0, ,0,0,0,0, 
11952,JPN,21,Hayashi Kotona ,OH,0,0,0,-100.00,0,0,0,0,0, ,0,0,0,0, ,0,1,0,1,-100.00,1,0,0,1,100.00,0,0,0, ,0,0,0,0, 
11952,JPN,24,Momii Aki ,S,0,0,0,-25.00,0,0,0,1,1,0.00,0,1,2,3,-33.33,0,1,3,4,-25.00,0,0,0,0, ,3,5,8,-25.00,10,1,53,64,14.06
11952,TUR,2,Akoz Simge Sebnem ,L,0,0,0, ,0,0,0,0,0, ,0,0,0,0, ,0,0,0,0, ,1,0,1,2,50.00,5,1,7,57.14,0,0,5,5,0.00
11952,TUR,3,Ãzbay Cansu ,S,1,0,0,-9.09,1,1,0,1,2,50.00,0,3,1,4,-75.00,0,0,16,16,0.00,0,0,0,0, ,7,3,10,40.00,18,0,54,72,25.00
11952,TUR,4,Senoglu Tugba ,OH,4,3,0,4.17,7,4,2,4,10,20.00,3,2,1,6,16.67,0,2,6,8,-25.00,7,0,5,12,58.33,4,1,5,60.00,0,0,0,0, 
11952,TUR,5,Ercan Seyma ,OH,0,0,0, ,0,0,0,0,0, ,0,0,0,0, ,0,0,0,0, ,0,0,0,0, ,0,0,0, ,0,0,0,0, 
11952,TUR,6,Caliskan Kubra ,MB,2,0,0,-12.90,2,2,1,1,4,25.00,0,3,6,9,-33.33,0,2,16,18,-11.11,0,0,0,0, ,3,1,4,50.00,0,0,3,3,0.00
11952,TUR,7,Baladin Hande ,OH,0,0,0, ,0,0,0,0,0, ,0,0,0,0, ,0,0,0,0, ,0,0,0,0, ,0,0,0, ,0,0,0,0, 
11952,TUR,9,Ismailoglu Meliha ,OH,0,0,0,0.00,0,0,0,0,0, ,0,0,0,0, ,0,0,2,2,0.00,0,0,0,0, ,0,0,0, ,0,0,0,0, 
11952,TUR,12,Unal Buse ,S,0,0,0, ,0,0,0,0,0, ,0,0,0,0, ,0,0,0,0, ,0,0,0,0, ,0,0,0, ,0,0,0,0, 
11952,TUR,13,Boz Meryem ,O,0,0,0, ,0,0,0,0,0, ,0,0,0,0, ,0,0,0,0, ,0,0,0,0, ,0,0,0, ,0,0,0,0, 
11952,TUR,14,Erdem DÃ¼ndar Eda ,MB,9,3,1,15.00,13,9,2,4,15,46.67,3,3,7,13,0.00,1,2,9,12,-8.33,0,0,0,0, ,3,0,3,100.00,0,0,1,1,0.00
11952,TUR,19,Kalac Asli ,MB,0,0,0, ,0,0,0,0,0, ,0,0,0,0, ,0,0,0,0, ,0,0,0,0, ,0,0,0, ,0,0,0,0, 
11952,TUR,20,Cebecioglu Derya ,OH,0,0,0, ,0,0,0,0,0, ,0,0,0,0, ,0,0,0,0, ,0,0,0,0, ,0,0,0, ,0,0,0,0, 
11952,TUR,22,Aydin Ä°lkin ,OH,9,0,0,9.38,9,9,2,5,16,43.75,0,3,3,6,-50.00,0,1,9,10,-10.00,19,1,14,34,52.94,12,1,13,84.62,0,0,1,1,0.00
11952,TUR,99,Karakurt Ebrar ,OH,24,4,1,38.89,29,24,4,9,37,54.05,4,3,2,9,11.11,1,1,6,8,0.00,0,0,0,0, ,4,0,6,66.67,0,0,0,0, 
11953,BRA,2,De Oliveira Saad Gattaz Caroline ,MB,9,3,0,20.51,12,9,0,3,12,75.00,3,4,7,14,-7.14,0,0,13,13,0.00,0,0,0,0, ,3,0,5,60.00,0,0,2,2,0.00
11953,BRA,3,Rodrigues Lins Dos Santos Danielle ,S,0,0,0,-50.00,0,0,0,0,0, ,0,0,0,0, ,0,1,1,2,-50.00,0,0,0,0, ,0,2,2,-100.00,1,0,12,13,7.69
11953,BRA,6,Alexandre Costa Nunes Nyeme Victoria ,L,0,0,0, ,0,0,0,0,0, ,0,0,0,0, ,0,0,0,0, ,0,0,0,0, ,0,0,0, ,0,0,0,0, 
11953,BRA,7,Montibeller Rosamaria ,OH,2,0,0,14.29,2,2,1,3,6,16.67,0,0,1,1,0.00,0,0,0,0, ,0,0,0,0, ,0,0,0, ,0,0,0,0, 
11953,BRA,8,Silva Carneiro Macris Fernanda ,S,0,0,0,-10.53,0,0,0,0,0, ,0,2,3,5,-40.00,0,0,14,14,0.00,0,1,0,1,-100.00,10,2,14,57.14,21,2,81,104,18.27
11953,BRA,10,Braga Guimaraes Gabriela ,OH,16,2,0,8.22,18,16,6,19,41,24.39,2,4,2,8,-25.00,0,2,22,24,-8.33,7,0,8,15,46.67,10,4,16,37.50,0,0,0,0, 
11953,BRA,11,Caixeta Tandara ,OH,15,2,0,7.02,17,15,7,14,36,22.22,2,6,1,9,-44.44,0,0,12,12,0.00,0,0,1,1,0.00,6,3,13,23.08,0,0,2,2,0.00
11953,BRA,12,Pereira Natalia ,OH,3,0,0,-5.00,3,3,2,5,10,10.00,0,2,1,3,-66.67,0,0,7,7,0.00,9,0,16,25,36.00,2,0,4,50.00,0,0,1,1,0.00
11953,BRA,15,Da Silva Ana Carolina ,MB,9,8,0,11.54,17,9,3,4,16,37.50,8,6,8,22,9.09,0,2,12,14,-14.29,0,0,0,0, ,0,1,1,-100.00,0,0,2,2,0.00
11953,BRA,16,Rodrigues Fernanda ,OH,6,0,0,-6.25,6,6,4,8,18,11.11,0,3,1,4,-75.00,0,1,9,10,-10.00,11,1,21,33,30.30,6,3,11,27.27,0,0,0,0, 
11953,BRA,17,Menezes Oliveira de Souza Ana Cristina ,OH,0,0,0,-100.00,0,0,0,0,0, ,0,1,0,1,-100.00,0,0,0,0, ,0,0,0,0, ,0,0,0, ,0,0,1,1,0.00
11953,BRA,18,Brait Camila ,L,0,0,0, ,0,0,0,0,0, ,0,0,0,0, ,0,0,0,0, ,4,1,12,17,17.65,17,1,19,84.21,0,0,13,13,0.00
11953,BRA,20,Correa Ana Beatriz ,MB,0,0,0, ,0,0,0,0,0, ,0,0,0,0, ,0,0,0,0, ,0,0,0,0, ,0,0,0, ,0,0,0,0, 
11953,BRA,28,Araujo De Souza Mayany Cristina ,MB,0,0,0, ,0,0,0,0,0, ,0,0,0,0, ,0,0,0,0, ,0,0,0,0, ,0,0,0, ,0,0,0,0, 
11953,USA,1,Hancock Micha ,S,0,0,0,-66.67,0,0,0,0,0, ,0,0,0,0, ,0,2,1,3,-66.67,0,0,0,0, ,3,1,4,50.00,3,0,10,13,23.08
11953,USA,2,Poulter Jordyn ,S,2,4,0,9.68,6,2,0,4,6,33.33,4,3,3,10,10.00,0,0,15,15,0.00,0,0,0,0, ,10,3,14,50.00,33,2,85,120,25.83
11953,USA,4,Wong-Orantes Justine ,L,0,0,0, ,0,0,0,0,0, ,0,0,0,0, ,0,0,0,0, ,7,0,16,23,30.43,14,6,20,40.00,0,0,9,9,0.00
11953,USA,10,Larson Jordan ,OH,10,1,0,10.42,11,10,3,16,29,24.14,1,3,1,5,-40.00,0,0,14,14,0.00,7,0,7,14,50.00,10,2,13,61.54,0,0,8,8,0.00
11953,USA,11,Drews Andrea ,O,12,0,0,18.75,12,12,5,8,25,28.00,0,0,2,2,0.00,0,1,4,5,-20.00,0,0,0,0, ,5,0,5,100.00,0,0,0,0, 
11953,USA,12,Thompson Jordan ,O,12,2,2,3.77,16,12,8,11,31,12.90,2,5,2,9,-33.33,2,1,10,13,7.69,0,0,0,0, ,8,3,12,41.67,0,0,1,1,0.00
11953,USA,14,Bartsch-Hackley Michelle ,OH,18,3,1,15.79,22,18,5,21,44,29.55,3,4,2,9,-11.11,1,1,21,23,0.00,23,0,30,53,43.40,11,2,14,64.29,0,0,4,4,0.00
11953,USA,16,Akinradewo Foluke ,MB,5,2,0,-8.82,7,5,2,5,12,25.00,2,7,1,10,-50.00,0,1,11,12,-8.33,0,0,0,0, ,4,0,5,80.00,0,0,0,0, 
11953,USA,22,Washington Haleigh ,MB,7,1,0,-2.63,8,7,2,5,14,35.71,1,5,5,11,-36.36,0,2,11,13,-15.38,0,0,0,0, ,3,2,5,20.00,0,0,0,0, 
11953,USA,23,Robinson Kelsey ,OH,0,0,0,0.00,0,0,0,0,0, ,0,0,0,0, ,0,0,2,2,0.00,0,0,0,0, ,0,0,0, ,0,0,0,0, 
11953,USA,24,Ogbogu Chiaka ,MB,0,0,0, ,0,0,0,0,0, ,0,0,0,0, ,0,0,0,0, ,0,0,0,0, ,0,0,0, ,0,0,0,0, 
11820,BRA,1,Rezende Bruno Mossa ,S,0,1,0,-6.67,1,0,0,0,0, ,1,2,3,6,-16.67,0,0,9,9,0.00,0,0,0,0, ,4,1,5,60.00,18,1,48,67,25.37
11820,BRA,5,Borges Almeida Silva Mauricio ,OH,0,0,0, ,0,0,0,0,0, ,0,0,0,0, ,0,0,0,0, ,0,0,0,0, ,0,0,0, ,0,0,0,0, 
11820,BRA,6,Gil Kreling Fernando ,S,0,0,0, ,0,0,0,0,0, ,0,0,0,0, ,0,0,0,0, ,0,0,0,0, ,0,0,0, ,0,0,0,0, 
11820,BRA,8,De Souza Wallace ,O,11,1,1,30.56,13,11,2,6,19,47.37,1,0,4,5,20.00,1,0,11,12,8.33,0,0,0,0, ,2,0,2,100.00,0,0,1,1,0.00
11820,BRA,9,Leal Hidalgo Yoandy ,OH,18,0,2,27.08,20,18,1,8,27,62.96,0,2,4,6,-33.33,2,4,9,15,-13.33,5,1,11,17,23.53,8,1,9,77.78,0,0,1,1,0.00
11820,BRA,12,Santos Isac ,MB,1,0,0,-28.57,1,1,0,0,1,100.00,0,1,1,2,-50.00,0,2,2,4,-50.00,0,0,0,0, ,0,0,0, ,0,0,0,0, 
11820,BRA,13,De Souza Mauricio Luiz ,MB,3,5,0,0.00,8,3,0,1,4,75.00,5,7,4,16,-12.50,0,1,9,10,-10.00,0,0,0,0, ,1,0,1,100.00,0,0,0,0, 
11820,BRA,14,Correia De Souza Douglas ,OH,0,0,0, ,0,0,0,0,0, ,0,0,0,0, ,0,0,0,0, ,0,0,0,0, ,0,0,0, ,0,0,0,0, 
11820,BRA,15,Nascimento Maique Reis ,L,0,0,0, ,0,0,0,0,0, ,0,0,0,0, ,0,0,0,0, ,0,0,0,0, ,0,0,0, ,0,0,0,0, 
11820,BRA,16,Saatkamp Lucas ,MB,3,2,0,3.57,5,3,1,3,7,28.57,2,1,4,7,14.29,0,2,12,14,-14.29,0,0,0,0, ,2,0,3,66.67,0,0,0,0, 
11820,BRA,17,Hoss Thales ,L,0,0,0, ,0,0,0,0,0, ,0,0,0,0, ,0,0,0,0, ,4,1,6,11,27.27,8,2,10,60.00,0,0,5,5,0.00
11820,BRA,18,Souza Ricardo Lucarelli ,OH,9,0,0,0.00,9,9,5,3,17,23.53,0,1,2,3,-33.33,0,3,6,9,-33.33,3,0,18,21,14.29,3,3,6,0.00,0,0,1,1,0.00
11820,BRA,21,Souza Alan ,O,0,0,0, ,0,0,0,0,0, ,0,0,0,0, ,0,0,0,0, ,0,0,0,0, ,0,0,0, ,0,0,0,0, 
11820,BRA,23,Resende Gualberto Flavio ,MB,0,0,0, ,0,0,0,0,0, ,0,0,0,0, ,0,0,0,0, ,0,0,0,0, ,0,0,0, ,0,0,0,0, 
11820,FRA,1,Chinenyeze BarthÃ©lÃ©my ,MB,5,0,0,-7.69,5,5,2,1,8,37.50,0,5,3,8,-62.50,0,0,10,10,0.00,0,0,1,1,0.00,1,1,2,0.00,1,0,1,2,50.00
11820,FRA,2,Grebennikov Jenia ,L,0,0,0, ,0,0,0,0,0, ,0,0,0,0, ,0,0,0,0, ,3,1,9,13,15.38,6,5,13,7.69,0,0,2,2,0.00
11820,FRA,4,Patry Jean ,O,11,1,0,15.62,12,11,0,8,19,57.89,1,5,1,7,-57.14,0,2,4,6,-33.33,0,0,0,0, ,3,0,4,75.00,0,0,0,0, 
11820,FRA,6,Toniutti Benjamin ,S,0,0,0,0.00,0,0,0,0,0, ,0,0,0,0, ,0,0,6,6,0.00,0,0,0,0, ,1,0,1,100.00,7,0,30,37,18.92
11820,FRA,7,Tillie Kevin ,OH,3,0,0,0.00,3,3,3,5,11,0.00,0,0,0,0, ,0,0,3,3,0.00,1,0,4,5,20.00,3,0,3,100.00,0,0,1,1,0.00
11820,FRA,9,Ngapeth Earvin ,OH,4,0,1,-18.75,5,4,5,7,16,-6.25,0,2,1,3,-66.67,1,4,8,13,-23.08,9,1,14,24,33.33,8,0,8,100.00,0,0,5,5,0.00
11820,FRA,11,Brizard Antoine ,S,0,1,1,12.50,2,0,0,2,2,0.00,1,0,0,1,100.00,1,1,3,5,0.00,0,0,0,0, ,2,0,2,100.00,8,0,22,30,26.67
11820,FRA,12,Boyer Stephen ,O,2,0,0,14.29,2,2,1,2,5,20.00,0,0,1,1,0.00,0,0,1,1,0.00,0,0,0,0, ,0,1,1,-100.00,0,0,0,0, 
11820,FRA,14,Le Goff Nicolas ,MB,3,1,0,0.00,4,3,2,1,6,16.67,1,1,1,3,0.00,0,1,6,7,-14.29,0,0,0,0, ,1,2,4,-25.00,0,0,0,0, 
11820,FRA,16,Bultor Daryl ,MB,0,0,0, ,0,0,0,0,0, ,0,0,0,0, ,0,0,0,0, ,0,0,0,0, ,0,0,0, ,0,0,0,0, 
11820,FRA,17,Clevenot Trevor ,OH,3,0,0,-15.00,3,3,3,6,12,0.00,0,2,0,2,-100.00,0,1,5,6,-16.67,6,1,11,18,27.78,1,2,3,-33.33,0,0,0,0, 
11820,FRA,19,Louati Yacine ,OH,0,0,0,-50.00,0,0,0,0,0, ,0,0,0,0, ,0,1,1,2,-50.00,0,0,0,0, ,0,0,0, ,0,0,0,0, 
11820,FRA,20,Diez Benjamin ,L,0,0,0, ,0,0,0,0,0, ,0,0,0,0, ,0,0,0,0, ,0,0,0,0, ,0,0,0, ,0,0,0,0, 
11820,FRA,24,Gueye Mousse ,MB,0,0,0, ,0,0,0,0,0, ,0,0,0,0, ,0,0,0,0, ,0,0,0,0, ,0,0,0, ,0,0,0,0, 
11821,POL,1,Nowakowski Piotr ,MB,3,3,1,21.05,7,3,0,0,3,100.00,3,2,2,7,14.29,1,1,7,9,0.00,0,0,0,0, ,0,0,0, ,0,0,1,1,0.00
11821,POL,5,Kaczmarek Lukasz ,O,0,0,0,-33.33,0,0,0,0,0, ,0,0,1,1,0.00,0,1,1,2,-50.00,0,0,0,0, ,0,0,1,0.00,0,0,1,1,0.00
11821,POL,6,Kurek Bartosz ,O,14,3,0,23.08,17,14,3,6,23,47.83,3,3,0,6,0.00,0,2,8,10,-20.00,0,0,0,0, ,4,1,6,50.00,0,0,1,1,0.00
11821,POL,9,Leon Venero Wilfredo ,OH,11,0,2,14.63,13,11,3,7,21,38.10,0,2,1,3,-66.67,2,2,13,17,0.00,6,2,14,22,18.18,3,2,6,16.67,0,0,1,1,0.00
11821,POL,10,Wojtaszek Damian ,L,0,0,0, ,0,0,0,0,0, ,0,0,0,0, ,0,0,0,0, ,0,0,0,0, ,0,0,0, ,0,0,0,0, 
11821,POL,11,Drzyzga Fabian ,S,0,4,2,10.00,6,0,0,0,0, ,4,3,1,8,12.50,2,1,9,12,8.33,0,0,0,0, ,4,1,6,50.00,16,0,45,61,26.23
11821,POL,12,Lomacz Grzegorz ,S,0,0,0, ,0,0,0,0,0, ,0,0,0,0, ,0,0,0,0, ,0,0,0,0, ,0,0,0, ,0,0,0,0, 
11821,POL,13,Kubiak Michal ,OH,4,2,0,-10.34,6,4,4,7,15,0.00,2,3,1,6,-16.67,0,2,6,8,-25.00,3,3,8,14,0.00,3,2,5,20.00,0,0,2,2,0.00
11821,POL,14,Sliwka Aleksander ,OH,1,0,0,-20.00,1,1,1,1,3,0.00,0,1,0,1,-100.00,0,0,1,1,0.00,0,0,1,1,0.00,0,0,0, ,0,0,1,1,0.00
11821,POL,15,Kochanowski Jakub ,MB,2,0,0,12.50,2,2,0,0,2,100.00,0,1,2,3,-33.33,0,0,3,3,0.00,0,0,0,0, ,1,0,1,100.00,0,0,0,0, 
11821,POL,16,Semeniuk Kamil ,OH,0,0,0, ,0,0,0,0,0, ,0,0,0,0, ,0,0,0,0, ,0,0,0,0, ,0,0,0, ,0,0,0,0, 
11821,POL,17,Zatorski Pawel ,L,0,0,0, ,0,0,0,0,0, ,0,0,0,0, ,0,0,0,0, ,7,0,8,15,46.67,7,2,10,50.00,0,0,3,3,0.00
11821,POL,20,Bieniek Mateusz ,MB,2,2,1,3.85,5,2,1,3,6,16.67,2,1,5,8,12.50,1,2,9,12,-8.33,1,0,0,1,100.00,2,0,2,100.00,0,0,1,1,0.00
11821,POL,21,Fornal Tomasz ,OH,0,0,0, ,0,0,0,0,0, ,0,0,0,0, ,0,0,0,0, ,0,0,0,0, ,0,0,0, ,0,0,0,0, 
11821,SLO,1,Å tern TonÄek ,O,7,2,3,0.00,12,7,4,10,21,14.29,2,5,2,9,-33.33,3,3,8,14,0.00,0,0,0,0, ,2,0,2,100.00,0,0,2,2,0.00
11821,SLO,2,Pajenk Alen ,MB,7,0,2,10.71,9,7,1,2,10,60.00,0,2,3,5,-40.00,2,3,8,13,-7.69,0,0,1,1,0.00,2,0,2,100.00,0,0,0,0, 
11821,SLO,4,Kozamernik Jan ,MB,2,1,0,0.00,3,2,1,1,4,25.00,1,1,0,2,0.00,0,1,5,6,-16.67,0,0,1,1,0.00,0,0,0, ,0,0,1,1,0.00
11821,SLO,5,Å ket Alen ,O,0,0,0, ,0,0,0,0,0, ,0,0,0,0, ,0,0,0,0, ,0,0,0,0, ,0,0,0, ,0,0,0,0, 
11821,SLO,6,Gasparini Mitja ,O,0,0,0,-40.00,0,0,1,1,2,-50.00,0,0,0,0, ,0,1,2,3,-33.33,0,0,0,0, ,1,0,1,100.00,0,0,0,0, 
11821,SLO,9,Vincic Dejan ,S,0,2,0,16.67,2,0,0,0,0, ,2,1,1,4,25.00,0,0,2,2,0.00,0,0,0,0, ,0,0,0, ,4,0,6,10,40.00
11821,SLO,11,Å tern Å½iga ,OH,0,0,0, ,0,0,0,0,0, ,0,0,0,0, ,0,0,0,0, ,0,0,0,0, ,0,0,0, ,0,0,0,0, 
11821,SLO,12,Klobucar Jan ,L,0,0,0, ,0,0,0,0,0, ,0,0,0,0, ,0,0,0,0, ,0,0,0,0, ,0,0,0, ,0,0,0,0, 
11821,SLO,13,KovaÄiÄ Jani ,L,0,0,0, ,0,0,0,0,0, ,0,0,0,0, ,0,0,0,0, ,6,4,18,28,7.14,13,4,19,47.37,0,0,3,3,0.00
11821,SLO,15,VideÄnik Matic ,MB,0,0,0, ,0,0,0,0,0, ,0,0,0,0, ,0,0,0,0, ,0,0,0,0, ,0,0,0, ,0,0,0,0, 
11821,SLO,16,Ropret Gregor ,S,0,0,0,-20.00,0,0,0,0,0, ,0,2,1,3,-66.67,0,0,7,7,0.00,0,0,0,0, ,4,0,5,80.00,15,0,46,61,24.59
11821,SLO,17,Urnaut Tine ,OH,13,0,0,16.67,13,13,3,4,20,50.00,0,1,1,2,-50.00,0,3,11,14,-21.43,1,2,13,16,-6.25,3,3,8,0.00,0,0,1,1,0.00
11821,SLO,18,Äebulj Klemen ,OH,9,1,0,-2.63,10,9,8,9,26,3.85,1,0,3,4,25.00,0,3,5,8,-37.50,9,0,8,17,52.94,2,1,4,25.00,0,0,5,5,0.00
11821,SLO,19,MoÅ¾iÄ Rok ,OH,0,0,0, ,0,0,0,0,0, ,0,0,0,0, ,0,0,0,0, ,0,0,0,0, ,0,0,0, ,0,0,0,0, 
11822,FRA,1,Chinenyeze BarthÃ©lÃ©my ,MB,4,1,0,0.00,5,4,2,0,6,33.33,1,3,5,9,-22.22,0,0,9,9,0.00,0,0,0,0, ,1,1,2,0.00,0,0,1,1,0.00
11822,FRA,2,Grebennikov Jenia ,L,0,0,0, ,0,0,0,0,0, ,0,0,0,0, ,0,0,0,0, ,6,0,4,10,60.00,6,1,8,62.50,1,0,7,8,12.50
11822,FRA,4,Patry Jean ,O,0,0,0, ,0,0,0,0,0, ,0,0,0,0, ,0,0,0,0, ,0,0,0,0, ,0,0,0, ,0,0,0,0, 
11822,FRA,6,Toniutti Benjamin ,S,0,0,0, ,0,0,0,0,0, ,0,0,0,0, ,0,0,0,0, ,0,0,0,0, ,0,0,0, ,0,0,0,0, 
11822,FRA,7,Tillie Kevin ,OH,0,0,0,-33.33,0,0,0,0,0, ,0,0,0,0, ,0,1,2,3,-33.33,0,0,0,0, ,0,1,1,-100.00,0,0,0,0, 
11822,FRA,9,Ngapeth Earvin ,OH,14,1,3,17.95,18,14,3,0,17,64.71,1,4,1,6,-50.00,3,4,9,16,-6.25,4,2,14,20,10.00,3,1,4,50.00,0,0,7,7,0.00
11822,FRA,11,Brizard Antoine ,S,4,3,1,20.83,8,4,0,1,5,80.00,3,0,3,6,50.00,1,3,9,13,-15.38,0,0,1,1,0.00,2,0,2,100.00,14,0,34,48,29.17
11822,FRA,12,Boyer Stephen ,O,13,1,1,11.90,15,13,3,8,24,41.67,1,5,2,8,-50.00,1,2,7,10,-10.00,0,0,2,2,0.00,7,0,8,87.50,0,0,3,3,0.00
11822,FRA,14,Le Goff Nicolas ,MB,3,3,0,11.11,6,3,1,4,8,25.00,3,1,3,7,28.57,0,1,11,12,-8.33,0,0,0,0, ,3,0,3,100.00,0,0,2,2,0.00
11822,FRA,16,Bultor Daryl ,MB,0,0,0, ,0,0,0,0,0, ,0,0,0,0, ,0,0,0,0, ,0,0,0,0, ,0,0,0, ,0,0,0,0, 
11822,FRA,17,Clevenot Trevor ,OH,6,2,0,10.00,8,6,1,8,15,33.33,2,3,1,6,-16.67,0,1,8,9,-11.11,7,1,7,15,40.00,8,1,9,77.78,0,0,2,2,0.00
11822,FRA,19,Louati Yacine ,OH,0,0,0,0.00,0,0,0,0,0, ,0,0,0,0, ,0,0,1,1,0.00,0,0,0,0, ,0,1,1,-100.00,0,0,0,0, 
11822,FRA,20,Diez Benjamin ,L,0,0,0, ,0,0,0,0,0, ,0,0,0,0, ,0,0,0,0, ,0,0,0,0, ,0,0,0, ,0,0,0,0, 
11822,FRA,24,Gueye Mousse ,MB,0,0,0, ,0,0,0,0,0, ,0,0,0,0, ,0,0,0,0, ,0,0,0,0, ,0,0,0, ,0,0,0,0, 
11822,SLO,1,Å tern TonÄek ,O,11,1,0,2.70,12,11,1,6,18,55.56,1,8,1,10,-70.00,0,2,7,9,-22.22,0,0,0,0, ,3,1,4,50.00,0,0,0,0, 
11822,SLO,2,Pajenk Alen ,MB,3,1,1,-7.14,5,3,1,3,7,28.57,1,3,4,8,-25.00,1,3,9,13,-15.38,1,0,1,2,50.00,1,0,1,100.00,0,0,0,0, 
11822,SLO,4,Kozamernik Jan ,MB,0,1,0,-35.29,1,0,1,1,2,-50.00,1,5,2,8,-50.00,0,1,6,7,-14.29,0,0,0,0, ,3,0,3,100.00,0,0,3,3,0.00
11822,SLO,5,Å ket Alen ,O,0,0,0, ,0,0,0,0,0, ,0,0,0,0, ,0,0,0,0, ,0,0,0,0, ,0,0,0, ,0,0,0,0, 
11822,SLO,6,Gasparini Mitja ,O,0,0,0, ,0,0,0,0,0, ,0,0,0,0, ,0,0,0,0, ,0,0,0,0, ,0,0,0, ,0,0,0,0, 
11822,SLO,9,Vincic Dejan ,S,0,0,0, ,0,0,0,0,0, ,0,0,0,0, ,0,0,0,0, ,0,0,0,0, ,0,0,0, ,0,0,0,0, 
11822,SLO,10,Å talekar SaÅ¡o ,MB,0,0,0, ,0,0,0,0,0, ,0,0,0,0, ,0,0,0,0, ,0,0,0,0, ,1,0,1,100.00,0,0,0,0, 
11822,SLO,11,Å tern Å½iga ,OH,0,0,0, ,0,0,0,0,0, ,0,0,0,0, ,0,0,0,0, ,0,0,0,0, ,0,0,0, ,0,0,0,0, 
11822,SLO,12,Klobucar Jan ,L,0,0,0, ,0,0,0,0,0, ,0,0,0,0, ,0,0,0,0, ,0,0,0,0, ,0,0,0, ,0,0,0,0, 
11822,SLO,13,KovaÄiÄ Jani ,L,0,0,0, ,0,0,0,0,0, ,0,0,0,0, ,0,0,0,0, ,4,1,10,15,20.00,5,0,5,100.00,0,0,5,5,0.00
11822,SLO,16,Ropret Gregor ,S,0,1,1,-18.75,2,0,0,1,1,0.00,1,3,1,5,-40.00,1,2,7,10,-10.00,0,0,0,0, ,4,0,5,80.00,17,0,48,65,26.15
11822,SLO,17,Urnaut Tine ,OH,8,2,0,2.94,10,8,4,6,18,22.22,2,3,2,7,-14.29,0,2,7,9,-22.22,3,2,12,17,5.88,1,1,2,0.00,0,0,5,5,0.00
11822,SLO,18,Äebulj Klemen ,OH,8,0,1,2.50,9,8,6,12,26,7.69,0,2,2,4,-50.00,1,0,9,10,10.00,8,2,14,24,25.00,8,1,11,63.64,0,0,0,0, 
11822,SLO,19,MoÅ¾iÄ Rok ,OH,1,0,0,-33.33,1,1,2,2,5,-20.00,0,0,0,0, ,0,1,0,1,-100.00,0,0,3,3,0.00,0,0,0, ,0,0,1,1,0.00
11823,BRA,1,Rezende Bruno Mossa ,S,0,0,1,-15.00,1,0,0,0,0, ,0,4,1,5,-80.00,1,0,14,15,6.67,0,0,0,0, ,11,4,15,46.67,22,0,63,85,25.88
11823,BRA,5,Borges Almeida Silva Mauricio ,OH,0,0,0, ,0,0,0,0,0, ,0,0,0,0, ,0,0,0,0, ,0,0,0,0, ,0,0,0, ,0,0,0,0, 
11823,BRA,6,Gil Kreling Fernando ,S,0,0,0, ,0,0,0,0,0, ,0,0,0,0, ,0,0,0,0, ,0,0,0,0, ,0,0,0, ,0,0,0,0, 
11823,BRA,8,De Souza Wallace ,O,18,3,1,12.90,22,18,7,6,31,35.48,3,3,6,12,0.00,1,4,14,19,-15.79,1,0,0,1,100.00,4,2,6,33.33,0,0,1,1,0.00
11823,BRA,9,Leal Hidalgo Yoandy ,OH,16,1,0,18.00,17,16,4,15,35,34.29,1,1,0,2,0.00,0,3,10,13,-23.08,5,2,23,30,10.00,6,3,9,33.33,0,0,3,3,0.00
11823,BRA,12,Santos Isac ,MB,0,0,0,-100.00,0,0,0,0,0, ,0,0,0,0, ,0,1,0,1,-100.00,0,0,0,0, ,0,0,0, ,0,0,0,0, 
11823,BRA,13,De Souza Mauricio Luiz ,MB,3,4,1,14.29,8,3,0,2,5,60.00,4,2,6,12,16.67,1,2,8,11,-9.09,0,0,0,0, ,2,1,3,33.33,0,0,1,1,0.00
11823,BRA,14,Correia De Souza Douglas ,OH,1,0,0,50.00,1,1,0,0,1,100.00,0,0,0,0, ,0,0,1,1,0.00,0,0,0,0, ,0,0,0, ,0,0,0,0, 
11823,BRA,15,Nascimento Maique Reis ,L,0,0,0, ,0,0,0,0,0, ,0,0,0,0, ,0,0,0,0, ,0,0,0,0, ,0,0,0, ,0,0,0,0, 
11823,BRA,16,Saatkamp Lucas ,MB,6,0,1,3.33,7,6,1,2,9,55.56,0,2,1,3,-66.67,1,3,14,18,-11.11,0,0,0,0, ,0,0,0, ,0,0,0,0, 
11823,BRA,17,Hoss Thales ,L,0,0,0, ,0,0,0,0,0, ,0,0,0,0, ,0,0,0,0, ,7,1,5,13,46.15,8,1,10,70.00,0,0,7,7,0.00
11823,BRA,18,Souza Ricardo Lucarelli ,OH,10,1,2,15.91,13,10,1,10,21,42.86,1,1,3,5,0.00,2,4,12,18,-11.11,4,0,14,18,22.22,12,4,19,42.11,0,0,6,6,0.00
11823,BRA,21,Souza Alan ,O,0,0,0, ,0,0,0,0,0, ,0,0,0,0, ,0,0,0,0, ,0,0,0,0, ,0,0,0, ,0,0,0,0, 
11823,BRA,23,Resende Gualberto Flavio ,MB,0,0,0, ,0,0,0,0,0, ,0,0,0,0, ,0,0,0,0, ,0,0,0,0, ,0,0,0, ,0,0,0,0, 
11823,POL,1,Nowakowski Piotr ,MB,2,1,0,-15.79,3,2,0,1,3,66.67,1,5,1,7,-57.14,0,1,8,9,-11.11,0,0,0,0, ,0,1,1,-100.00,0,0,0,0, 
11823,POL,5,Kaczmarek Lukasz ,O,0,0,0,0.00,0,0,0,1,1,0.00,0,0,0,0, ,0,0,1,1,0.00,0,0,0,0, ,0,0,0, ,0,0,0,0, 
11823,POL,6,Kurek Bartosz ,O,15,2,0,21.95,17,15,3,8,26,46.15,2,1,2,5,20.00,0,4,6,10,-40.00,0,0,0,0, ,5,1,6,66.67,0,0,5,5,0.00
11823,POL,9,Leon Venero Wilfredo ,OH,5,2,1,0.00,8,5,4,15,24,4.17,2,1,1,4,25.00,1,3,8,12,-16.67,5,2,15,22,13.64,5,3,8,25.00,0,0,1,1,0.00
11823,POL,10,Wojtaszek Damian ,L,0,0,0, ,0,0,0,0,0, ,0,0,0,0, ,0,0,0,0, ,0,0,0,0, ,0,0,0, ,0,0,0,0, 
11823,POL,11,Drzyzga Fabian ,S,0,0,1,-22.22,1,0,0,0,0, ,0,2,0,2,-100.00,1,3,12,16,-12.50,0,0,1,1,0.00,2,2,7,0.00,24,0,59,83,28.92
11823,POL,12,Lomacz Grzegorz ,S,0,0,0,0.00,0,0,0,0,0, ,0,0,0,0, ,0,0,1,1,0.00,0,0,0,0, ,0,0,0, ,0,0,2,2,0.00
11823,POL,13,Kubiak Michal ,OH,14,1,0,13.33,15,14,5,5,24,37.50,1,1,2,4,0.00,0,3,14,17,-17.65,8,1,15,24,29.17,8,1,10,70.00,0,1,4,5,-20.00
11823,POL,14,Sliwka Aleksander ,OH,0,0,0, ,0,0,0,0,0, ,0,0,0,0, ,0,0,0,0, ,1,1,2,4,0.00,0,0,0, ,0,0,0,0, 
11823,POL,16,Semeniuk Kamil ,OH,1,0,0,-54.55,1,1,5,1,7,-57.14,0,2,1,3,-66.67,0,0,1,1,0.00,1,0,1,2,50.00,0,0,0, ,0,0,1,1,0.00
11823,POL,17,Zatorski Pawel ,L,0,0,0, ,0,0,0,0,0, ,0,0,0,0, ,0,0,0,0, ,6,2,17,25,16.00,9,5,16,25.00,0,0,5,5,0.00
11823,POL,20,Bieniek Mateusz ,MB,7,1,1,-4.65,9,7,1,8,16,37.50,1,7,7,15,-40.00,1,3,8,12,-16.67,0,0,1,1,0.00,2,0,2,100.00,0,0,0,0, 
11823,POL,21,Fornal Tomasz ,OH,0,0,0, ,0,0,0,0,0, ,0,0,0,0, ,0,0,0,0, ,0,0,0,0, ,0,0,0, ,0,0,0,0, 
11823,POL,99,Huber Norbert ,MB,0,0,0, ,0,0,0,0,0, ,0,0,0,0, ,0,0,0,0, ,0,0,0,0, ,0,0,0, ,0,0,0,0, 
